target_id,rank,funny,somewhat_funny,unfunny,count,score,precision,contest,caption
692,1,36,28,71,135,1.7407407407407407,0.07357487956897416,652,I wish we'd noticed that before eating Bob.
8335,2,39,39,85,163,1.7177914110429449,0.0648404741682024,652,I wish we’d seen that before we ate Dave.
9705,3,32,46,80,158,1.6962025316455696,0.06266724668519122,652,I do not see a lifesaver.
6049,4,31,27,70,128,1.6953125,0.07404127532346799,652,Think there are any Life Savers?
4918,5,34,25,82,141,1.6595744680851063,0.07105357599734435,652,See any Lifesavers?
3452,6,36,32,90,158,1.6582278481012658,0.06584386814337452,652,I really don't have any room left after we ate John.
6323,7,28,49,83,160,1.65625,0.06016674615406167,652,"I see two palm trees, a tire, and some driftwood. Why do you ask?"
2079,8,27,37,76,140,1.65,0.06641997866824279,652,Over there they call it macarooned.
6217,9,30,30,79,139,1.6474820143884892,0.06915136368293444,652,Oldest shark trick in the book
7138,10,28,35,81,144,1.6319444444444444,0.06592428123557756,652,If only we had a Life Saver.
811,11,33,31,91,155,1.6258064516129032,0.06546433490917385,652,Looks desserted to me.
277,12,27,49,90,166,1.6204819277108433,0.05829836059415217,652,It looks totally desserted.
2015,13,28,36,86,150,1.6133333333333333,0.06400969352391948,652,Is it just me or are the sharks getting smarter?
256,14,29,38,90,157,1.6114649681528663,0.062378205044168196,652,If you say 'desserted island' one more time....
556,15,34,38,103,175,1.6057142857142856,0.06004767829631597,652,Looks completely desserted.
4711,16,25,41,86,152,1.5986842105263157,0.061397024919501574,652,It appears desserted.
5394,17,25,39,85,149,1.5973154362416107,0.062390454033545144,652,Over there we’d be macarooned.
5671,18,30,35,96,161,1.5900621118012421,0.061975782743711516,652,So dessert island wasn’t a typo after all.
8800,19,22,39,80,141,1.5886524822695036,0.06291703579068617,652,The least they could do is throw us a Life Saver.
3886,20,24,36,83,143,1.5874125874125875,0.06380115319866944,652,It looks like the sharks have upped their game
3485,21,17,50,77,144,1.5833333333333333,0.057886231962495635,652,It's a trick.  Once you get over there they try to sell you a timeshare.
7204,22,21,34,76,131,1.5801526717557253,0.06587787280165998,652,"Chances are, one of us isn't real either..."
7455,23,21,38,79,138,1.5797101449275361,0.06324521382789118,652,And I thought we had wrecked near the Sandwich Islands.
7184,24,33,28,102,163,1.5766871165644172,0.06329565456254463,652,"After eating Johnson, I don't have room for dessert.  How about you?"
3493,25,20,43,81,144,1.5763888888888888,0.06041479670051309,652,It's called the Isle of Just Desserts.
10002,26,21,43,84,148,1.5743243243243243,0.05994667009739089,652,Too bad there's no life savers.
5482,27,22,38,84,144,1.5694444444444444,0.06205868104420653,652,Looks like it's desserted.
9948,28,22,44,89,155,1.5677419354838709,0.05862504661304794,652,The Sandwich Islands must be nearby.
5651,29,24,22,78,124,1.564516129032258,0.07173429083791255,652,"Ronald, I swear, if you call that a ""desserted"" island one more time..."
9751,30,20,40,82,142,1.5633802816901408,0.061174850018101606,652,I've been there. It's a miniature golf course.
7440,31,22,42,89,153,1.5620915032679739,0.059256708734579513,652,I could have sworn these were the Sandwich Islands...
8240,31,21,44,88,153,1.5620915032679739,0.058526559936914864,652,Looks like we're macarooned.
2761,33,22,33,82,137,1.562043795620438,0.06458683453969548,652,It’s the Isle of Just Desserts.
3352,34,19,41,81,141,1.5602836879432624,0.06070240187453459,652,'Looks desserted.'
3562,35,17,34,71,122,1.5573770491803278,0.06589475698788119,652,"Well, now that we've polished off Mary Ann, Ginger, The Howells, and the Professor, guess we could swim over there for a little dessert..."
3089,36,17,37,74,128,1.5546875,0.0635333799886755,652,Remember to wait a half hour before you swim back.
6908,37,29,22,94,145,1.5517241379310345,0.06704707164639027,652,Give me that dang lamp before you waste the next two wishes!
7062,38,22,32,84,138,1.5507246376811594,0.06429105753633692,652,"A boat, Kevin. You should have wished for a boat."
7424,39,24,42,98,164,1.548780487804878,0.057573819823530124,652,I thought you said these were the sandwich islands!
2834,40,21,46,94,161,1.546583850931677,0.05638591967691083,652,Do you think they have lifesavers over there?
937,41,18,36,78,132,1.5454545454545454,0.06304373600163798,652,I thought you said we were going to the Sandwich Islands.
6683,41,22,40,92,154,1.5454545454545454,0.05905841630136113,652,It’s obviously desserted.
5263,43,20,40,87,147,1.5442176870748299,0.05968832517537138,652,It looks like a desserted island.
1731,44,22,51,102,175,1.542857142857143,0.05358374242714147,652,"according to Yelp, the buttercream alone is worth the trip"
8122,44,20,36,84,140,1.542857142857143,0.06197455680191915,652,Do you suppose it has life savers?
9154,46,20,35,84,139,1.539568345323741,0.06233407716100813,652,"Weird, no Life Savers..."
6472,47,20,37,86,143,1.5384615384615385,0.06099185986898437,652,We could use Life Savers.
9361,48,20,41,90,151,1.5364238410596027,0.05851347229793155,652,I've read enough German fairy tales to know not to fall for it.
6952,49,25,25,90,140,1.5357142857142858,0.06602088981258784,652,Great. Now my appetite is spoiled for my dinner mirage.
7952,50,21,28,82,131,1.534351145038168,0.0661833517212406,652,It’s one of the Greek islands- Dextrose.
1817,51,27,29,100,156,1.5320512820512822,0.061963910488685076,652,I guess we didn’t have to eat Danny. Or our raft.
543,52,22,32,89,143,1.5314685314685315,0.06261339230477875,652,"If  I make it, i’ll throw you a Life Saver."
1960,53,14,45,79,138,1.5289855072463767,0.05744298290792281,652,It's a well-known shark trick.
6805,54,23,34,95,152,1.5263157894736843,0.06045846136651394,652,Of course they forgot the Life Savers.
7753,54,22,26,85,133,1.5263157894736843,0.0662944846015677,652,I'm staying put.  That island is clearly desserted.
6686,56,23,25,87,135,1.525925925925926,0.06635884958842105,652,When was that island desserted?
7782,57,17,40,84,141,1.524822695035461,0.05919209561034709,652,"Oh, you see that too? We probably should've talked about that before we ate Steve."
949,58,24,37,101,162,1.5246913580246915,0.05821819277325435,652,Seriously?  A dessert island?
8356,59,22,34,93,149,1.523489932885906,0.060669142412374144,652,You're not thinking about desserting me too?
4831,60,19,34,85,138,1.5217391304347827,0.06189759196338015,652,Maybe we are the illusion
4116,61,17,51,95,163,1.521472392638037,0.053178472705772556,652,What exactly was your third wish?
8319,62,19,48,98,165,1.5212121212121212,0.05409189765173081,652,I am seeing naked ladies; what are you seeing?
8657,62,22,42,101,165,1.5212121212121212,0.05610403623258753,652,Do you think the whole island is desserted?
6558,64,20,34,88,142,1.5211267605633803,0.06138148361461858,652,You said the Jones’s weren’t going to decorate this year.
626,65,23,30,93,146,1.5205479452054795,0.062402822388564615,652,"All that, and not a life saver to be seen  !"
3911,66,20,33,88,141,1.5177304964539007,0.061723668345174273,652,I think that’s what they call a dessert island.
2327,67,18,39,88,145,1.5172413793103448,0.0588063321484436,652,"Last year there were 2 rows of chocolate chips but, you know - climate change."
1321,68,17,43,89,149,1.516778523489933,0.056825146734842534,652,"Dude, what was in that coconut?"
8398,69,21,46,104,171,1.5146198830409356,0.053982584016546147,652,You do realize that was our third wish.
8132,70,18,40,90,148,1.5135135135135136,0.05791505791505791,652,"You should be pleased to know, it takes my mind off of eating you."""
4957,71,24,38,106,168,1.5119047619047619,0.05663056887836009,652,So this is hell.
316,72,14,42,81,137,1.510948905109489,0.05779398525599222,652,Let's swim to the Sandwich Islands first.
393,73,25,24,97,146,1.5068493150684932,0.06391906737849205,652,"I've got a bad feeling about this, Gretel."
3986,73,18,38,90,146,1.5068493150684932,0.05851780921659048,652,Seems like the First Class passengers are holding up okay.
5101,73,22,30,94,146,1.5068493150684932,0.06166220269068828,652,"You know, if it weren’t for autocorrect, we would be on dessert island right now."
9515,73,19,36,91,146,1.5068493150684932,0.05931953562527983,652,Do you think there’s a Lifesaver over there?
8971,77,20,38,96,154,1.5064935064935066,0.05771793562010223,652,You think they’ve got any Lifesavers?
6533,78,20,40,98,158,1.5063291139240507,0.05660931588607063,652,Definitely desserted.
238,79,16,30,77,123,1.5040650406504066,0.06466471388546897,652,"Clever, clever sharks."
989,80,18,29,82,129,1.503875968992248,0.06429028067983865,652,That island is obviously desserted.
5499,81,18,33,86,137,1.5036496350364963,0.06140274488450616,652,That's why they call it Statin Island!
2554,82,17,36,86,139,1.5035971223021583,0.05986648049932558,652,It's the island of just desserts!
6674,83,19,35,91,145,1.5034482758620689,0.05963180283290888,652,That must be the desserted  island.
8453,84,19,41,97,157,1.5031847133757963,0.056160716843876725,652,Figures! We get the desert island and they get the dessert island.
9967,85,16,31,79,126,1.5,0.06349603162203156,652,Nobody over there. It’s desserted.
9847,85,13,42,81,136,1.5,0.05716619504750295,652,It seems to be desserted.
8749,85,20,31,91,142,1.5,0.061407263924807755,652,Reminds me of the Republican tax plan
6892,85,23,27,96,146,1.5,0.062426149093904384,652,I dont see any lifesavers over there...
5635,85,15,39,84,138,1.5,0.05840903491929233,652,Even my delusions are just out of reach.
5111,85,18,27,81,126,1.5,0.06546536707079771,652,And thus concludes the tale of Baskin Robinson Crusoe.
7872,85,15,33,78,126,1.5,0.06248809410409238,652,Your mother goes to such great lengths to get us to visit.
4571,92,22,28,95,145,1.4965517241379311,0.06199442096626115,652,How about that?  A desserted island!
2540,93,14,43,86,143,1.4965034965034965,0.05603017108938987,652,It's the gummy sharks that scare me.
4978,93,22,27,94,143,1.4965034965034965,0.06266836939176398,652,It looks as if its desserted.
5731,95,17,33,85,135,1.4962962962962962,0.061196901103788906,652,Well I don’t think it’s one of the Sandwich Islands.
1026,96,13,32,72,117,1.4957264957264957,0.06380222400346504,652,"Yeah, but we've got the nicer view."
2929,97,25,30,107,162,1.4938271604938271,0.05890321946305019,652,They were just a scone's throw from a desserted island.
2580,98,16,45,95,156,1.4935897435897436,0.054185292239711746,652,"True, but we've got shade."
1836,99,20,31,93,144,1.4930555555555556,0.06074879793735113,652,"Yeah, I don't see it either."
9505,100,20,30,92,142,1.4929577464788732,0.06140439998040282,652,"Alas, here we are, but for a simple spelling mistake."
38,101,21,25,90,136,1.4926470588235294,0.06433531739415042,652,"All that candy, and not one lifesaver."
315,102,17,26,79,122,1.4918032786885247,0.06609668215063094,652,Who knew sharks could bake?
1564,103,19,40,100,159,1.490566037735849,0.05562673470757317,652,Yesterday it looked like a roasted chicken.
2924,104,18,39,96,153,1.4901960784313726,0.05649860272893429,652,"Frankly, I wish it were Sandwich Island."
9667,105,19,36,96,151,1.490066225165563,0.0578248475574651,652,"I yearn for the simple old days, when there was only pie-in-the-sky."
7529,106,17,36,90,143,1.4895104895104896,0.058601795863214484,652,"Trust me, if we had chosen that island all we would be thinking about is the simple beauty of this one."
8060,107,21,24,90,135,1.488888888888889,0.06470297545125864,652,"Of course you don't think it's real, you've been nothing but negative since we washed up here."
2569,108,18,45,103,166,1.4879518072289157,0.053184772879511906,652,Looking back we had it pretty good there
4710,109,21,37,104,162,1.4876543209876543,0.05623303572866012,652,It looks pretty desserted.
4583,110,15,28,76,119,1.4873949579831933,0.06522074337617927,652,"No dinner, no dessert."
7129,111,20,33,97,150,1.4866666666666666,0.05887587266278628,652,"Ooh, that reminds me. We're also out of coffee."
7182,112,19,34,95,148,1.4864864864864864,0.058703343998972896,652,I can't believe they still have their candy canes up.
3285,113,22,26,96,144,1.4861111111111112,0.062318977248680775,652,That island is completely desserted.
4524,113,13,44,87,144,1.4861111111111112,0.05485917472215307,652,So tell me again. When the ship sank why did we swim here?
3931,115,23,23,96,142,1.4859154929577465,0.06378961923558826,652,That island looks desserted.
7902,116,20,27,91,138,1.4855072463768115,0.06276157133291468,652,"As mirages go, it's particularly cruel."
1796,117,15,30,79,124,1.4838709677419355,0.0632246824672488,652,Looks like that island is desserted.
8358,118,18,38,97,153,1.4836601307189543,0.05648865316423111,652,"If you knew how to spell, we'd be on dessert island."
3458,119,14,31,77,122,1.4836065573770492,0.06293374791094213,652,"That one looks both deserted and desserted"""
803,120,19,32,94,145,1.4827586206896552,0.05961518381558593,652,Remember when this one looked like that?
5696,120,20,30,95,145,1.4827586206896552,0.060413207016174246,652,Looks like a desserted island to me.
6338,120,16,24,76,116,1.4827586206896552,0.06760272722855994,652,I think it's desserted.
2126,123,20,29,94,143,1.4825174825174825,0.06105957846112577,652,Dear Editor:  I am sorry that you have to read 3000 captions about a desserted island.
1169,124,15,38,88,141,1.4822695035460993,0.05747369503535054,652,I'm holding out for Taco Tuesday.
6054,124,20,28,93,141,1.4822695035460993,0.061723668345174273,652,So *that's* why they call it a desserted island
6335,126,19,28,90,137,1.4817518248175183,0.06225181705806762,652,The sharks have sure upped their game.
3643,127,10,45,80,135,1.4814814814814814,0.054485737735368585,652,"Hmm, I guess Amazon DOES deliver everywhere."
6108,128,17,30,86,133,1.481203007518797,0.06187020693514077,652,It's a new mirage; yesterday it was two-for-one beers.
9181,128,15,34,84,133,1.481203007518797,0.060000668105377374,652,That's what sharks call phishing.
3716,130,16,19,71,106,1.4811320754716981,0.07247533530380061,652,But what if we're the mirage?
928,131,21,33,102,156,1.4807692307692308,0.057857497171962306,652,So that's what a desserted island looks like.
7887,131,19,37,100,156,1.4807692307692308,0.05640978644815136,652,I'd say it looks desserted.
9779,131,17,41,98,156,1.4807692307692308,0.05492392953211247,652,"It's not the swim over, it's the swim back..."
1562,134,14,33,80,127,1.4803149606299213,0.061080544025828014,652,"We can die healthy here, or swim over and die happy there."
2161,135,24,24,102,150,1.48,0.06182894784764098,652,"Seriously, Frank, if ""marooned on a dessert island"" wasn't funny six months ago, it's not funny now."
7705,135,14,44,92,150,1.48,0.05411066628509165,652,I'll  bet it's crawling with ants.
1767,135,21,30,99,150,1.48,0.05961847378210367,652,It's desserted.
5953,138,20,31,97,148,1.4797297297297298,0.059468129371754955,652,Now do you see why spelling matters?
7013,139,17,34,91,142,1.4788732394366197,0.05888986473180721,652,The sharks have really upped their game.
6739,140,15,26,76,117,1.4786324786324787,0.06604293832103794,652,We can work it off on the way back.
7578,141,16,35,89,140,1.4785714285714286,0.05864858428056738,652,"Yeah,but we have to wait an hour to swim back."
1871,142,15,36,87,138,1.4782608695652173,0.0583794981108704,652,"Adam, somehow this feels like a test."
7918,143,24,28,107,159,1.4779874213836477,0.05907527052469913,652,If only there was a sugar plum ferry.
140,144,22,31,104,157,1.4777070063694266,0.0582742081041054,652,I wish this island was desserted.
8632,145,16,41,96,153,1.477124183006536,0.0549298011217779,652,"So, you choose to believe THIS, but not global warming?!?"
441,146,19,24,87,130,1.476923076923077,0.06480592062679748,652,"Did your note in a bottle say ""Deserted, send help"" or ""Help, send dessert"""
4045,147,21,29,99,149,1.476510067114094,0.05991702695800026,652,"Sure, it looks good but it's just eye candy."
398,148,13,44,90,147,1.4761904761904763,0.054036001119198276,652,Is this what you meant by getting our 'just desserts'?
2398,148,15,30,81,126,1.4761904761904763,0.062451795469542874,652,"""I presume it's our just desert."""
5863,150,19,30,94,143,1.4755244755244756,0.06023049707347353,652,"Yeah, but we’d have to wait an hour before we swam back."
2494,151,15,36,88,139,1.474820143884892,0.058060020978763734,652,That island's been desserted for years.
9504,152,23,28,105,156,1.4743589743589745,0.05925419994238444,652,"Yeah, it's close, but the water's infested with Swedish Fish."
493,153,14,44,94,152,1.4736842105263157,0.053581528245657324,652,Why don't you swim over there and see if you can rustle us up a lifesaver.
6496,153,20,32,100,152,1.4736842105263157,0.058256419591185236,652,"As far as mirages go, this is the best one yet."
2247,155,18,34,96,148,1.472972972972973,0.057882873940405206,652,"Location, location, location"
6353,156,21,27,98,146,1.4726027397260273,0.06085146545744457,652,Miami sure went under quick.
2142,156,17,35,94,146,1.4726027397260273,0.05766287890107748,652,You don't say. I see naked women.
5601,158,18,31,93,142,1.471830985915493,0.05971134070303303,652,"Because I'm your dentist, that's why."
5453,159,14,47,98,159,1.471698113207547,0.05188226887519477,652,"The Airbnb review said, ""Sweet view."""
2163,160,16,33,89,138,1.4710144927536233,0.059255964517961425,652,Honey.. Why does it seem like the Robinsons are always trying to out do us?
3209,160,17,31,90,138,1.4710144927536233,0.060141964166053795,652,Dont do it. You’ll spoil your dinner.
9956,162,16,41,98,155,1.4709677419354839,0.05439207954747969,652,"Well, we are out of coconuts..."
3276,163,17,38,98,153,1.4705882352941178,0.05568692858523704,652,Remember to wait an hour before swimming back.
2261,164,20,23,91,134,1.4701492537313432,0.06416709833337174,652,"We could swim for it, though, at best, we'd be macarooned."
3800,165,25,27,112,164,1.4695121951219512,0.058296289042792195,652,"I know it's been really foggy since we got here, but I'm just saying that, well, we may have been a little premature, you know, eating my leg."
1419,166,27,22,113,162,1.4691358024691359,0.06014375814456751,652,"Nope, that’s a dessert island."
8035,167,18,39,103,160,1.46875,0.054601094138598316,652,You can't swim it. The waters are infested with gummy fish.
5527,168,18,31,94,143,1.4685314685314685,0.05938404390873011,652,"Don't learn to swim, you said. We'll never need to, you said."
6720,169,18,38,102,158,1.4683544303797469,0.05511115919164957,652,"What, and spoil dinner?"
838,170,21,23,95,139,1.4676258992805755,0.06319455758670213,652,"And stare at a tree? No, thank you."
7798,170,16,33,90,139,1.4676258992805755,0.058925631399268444,652,Are they EVER going to take down the Christmas decorations?
4349,172,18,36,100,154,1.4675324675324675,0.05616921755432176,652,This whole trip has been one bad decision after another.
5884,173,13,38,86,137,1.467153284671533,0.05679569391234566,652,I would have preferred a main course island.
6253,174,20,31,101,152,1.4671052631578947,0.05823427400628668,652,You had to eat the lifesavers
4186,175,20,37,108,165,1.4666666666666666,0.05473400932052741,652,"C'mon, Hansel, what's the worst that could happen?"
496,176,23,30,110,163,1.4662576687116564,0.05725565603826504,652,Why don't you swim over there and see if you can rustle us up some lifesavers.
8365,177,16,30,87,133,1.4661654135338347,0.060893394459277744,652,Dessert Island?  I thought that was a typo.
6142,178,17,34,95,146,1.4657534246575343,0.05763762446982604,652,Hmm … looks quite desserted.
5657,179,16,35,93,144,1.4652777777777777,0.05739183133721185,652,That genie gave you ONE wish and that's all you could think of?
8926,179,15,37,92,144,1.4652777777777777,0.05653934211780214,652,Legend has it that the good ship Lollipop went down near here.
2094,181,17,32,93,142,1.4647887323943662,0.05884206450905114,652,Maybe we should have waited before eating Phillip.
5430,182,12,47,94,153,1.4640522875816993,0.05165488379811643,652,I always wanted to be on a dessert island.
4374,183,12,33,78,123,1.4634146341463414,0.06031226543994929,652,Is it my imagination or is that a dessert island?
9441,184,19,31,99,149,1.4630872483221478,0.058336802035189574,652,I thought Dessert Island was a typo when I first saw it on the map....
8842,184,16,37,96,149,1.4630872483221478,0.05595621776881711,652,"It's an illusion, Dwayne.  It's really nothing but kale and quinoa."
9754,186,17,27,88,132,1.4621212121212122,0.06215843798108821,652,Do they deliver?
4128,187,18,31,96,145,1.4620689655172414,0.058738893671959704,652,"No, I don't see anything."
7018,187,19,29,97,145,1.4620689655172414,0.05954866136546492,652,"Yeah, but we have a tree."
6830,189,13,47,98,158,1.4620253164556962,0.05129624745311171,652,"I know, but look on the bright side, we have a tree."
2000,190,16,34,93,143,1.4615384615384615,0.05767178465523402,652,These sharks don't give up.
3531,190,22,28,106,156,1.4615384615384615,0.0585067954206178,652,"You go ahead, I don't want to spoil my dinner."
8143,190,16,34,93,143,1.4615384615384615,0.05767178465523402,652,Think we can make it? Looks like a piece of cake.
4400,193,21,35,111,167,1.4610778443113772,0.054881146047375325,652,Eye candy.
7634,194,17,31,93,141,1.4609929078014185,0.05913744272765056,652,Looks like just another desserted island to me.
5369,195,23,24,105,152,1.4605263157894737,0.06041103179824511,652,I told you this place wasn’t desserted.
2809,196,13,38,88,139,1.460431654676259,0.056175495312701336,652,"Oh, I get it. Desserted island."
3268,197,19,20,87,126,1.4603174603174602,0.06633325546852921,652,I'm waiting for pie in the sky.
374,198,19,30,99,148,1.4594594594594594,0.05861863494474509,652,Obviously DESSERTED!
7151,198,16,36,96,148,1.4594594594594594,0.05621706478208895,652,C'mon. We'll burn it off in the swim back.
8121,198,17,34,97,148,1.4594594594594594,0.05702882636062941,652,Beware the gummy sharks.
5952,201,21,31,107,159,1.4591194968553458,0.056952107787027764,652,Those humpback whales are getting really sarcastic.
4102,202,16,35,95,146,1.4589041095890412,0.056780837587384225,652,If the sharks don’t get us the refined sugar will.
7968,202,19,29,98,146,1.4589041095890412,0.059224010764162095,652,what if we're their mirage?
4888,204,19,40,111,170,1.4588235294117646,0.05283859032396379,652,"So help me God, Carl, you say ""dessert island"" one more time and I will kill you."
3278,205,18,25,90,133,1.4586466165413534,0.06270219351231986,652,I’ve never heard of anyone being stranded on a dessert island.
6411,206,15,42,100,157,1.4585987261146496,0.05307038970329157,652,It looks so desserted.
297,207,20,26,98,144,1.4583333333333333,0.06065157090804041,652,Wanna sit on the other side and look at the island of naked models again?
808,207,16,34,94,144,1.4583333333333333,0.05735950370350728,652,I’m gonna wait for one with a bar.
5298,209,15,24,79,118,1.4576271186440677,0.06553147785809943,652,Clearly it's a dessert island.
7036,210,21,28,104,153,1.457516339869281,0.05864169426446523,652,"Hey, do you think there are lifesavers over there?"
2560,211,15,29,85,129,1.4573643410852712,0.06128445077845696,652,You really don't see it?
6524,212,18,33,100,151,1.4569536423841059,0.05695364238410597,652,Huh...I thought we were in the Sandwich Islands.
6120,213,18,27,93,138,1.4565217391304348,0.060952249232412596,652,No one’s over there - it’s desserted.
2987,213,19,25,94,138,1.4565217391304348,0.06181394025045756,652,It's oddly desserted over there.
1220,213,18,27,93,138,1.4565217391304348,0.060952249232412596,652,Ok. Cool. Now lets imagine our sailboat.
3793,216,15,38,96,149,1.4563758389261745,0.05510672780146842,652,"I've heard of mirages,but this takes the cake."
5240,217,17,38,103,158,1.4556962025316456,0.05431841994102186,652,At least we don't have ants.
4063,218,20,26,99,145,1.4551724137931035,0.060314716077904215,652,But then we'd get fat and it would be harder to meet people.
3823,219,12,41,90,143,1.4545454545454546,0.054110349699251346,652,"As hallucinations go, it's not bad."
4442,219,13,39,91,143,1.4545454545454546,0.055012934850040544,652,Look!  A desserted  island.
9559,219,17,26,89,132,1.4545454545454546,0.062119660559602975,652,"I wish I could swim."" ""I wish you could spell."
7653,222,21,32,110,163,1.4539877300613497,0.0558631254220801,652,Do you think they're looking at us as a source of protein?
2355,223,20,29,103,152,1.4539473684210527,0.05817517789904956,652,"Once more: THIS is a desert island, and THAT is a dessert island. Understand?"
1794,223,16,37,99,152,1.4539473684210527,0.055098074563666555,652,Chill...it's an old cannibal trick.
8674,225,14,31,85,130,1.4538461538461538,0.05992595158534803,652,Offshore baking.
4563,226,15,38,97,150,1.4533333333333334,0.05482260728885302,652,It certainly looks desserted.
4756,227,20,42,119,181,1.4530386740331491,0.05103316508798506,652,Cane mutiny survivors?
6887,228,15,27,84,126,1.4523809523809523,0.062342772758297686,652,The sharks are getting a lot more creative.
5769,229,16,29,90,135,1.451851851851852,0.06014403066290251,652,I swam over once. They’re plastic.
3565,230,9,51,93,153,1.4509803921568627,0.049019607843137254,652,I'm glad we made the healthy choice.
3129,231,15,34,93,142,1.4507042253521127,0.05704530563761072,652,If the sharks don't get us the sugar will.
2063,231,14,36,92,142,1.4507042253521127,0.05616294841282262,652,I think these are carb infested waters.
6900,233,21,30,109,160,1.45,0.05663521139548542,652,*This* close to being macarooned
9163,233,16,31,93,140,1.45,0.058523280036830376,652,"I thought you said, ‘Swim for the desert island.’"
5143,233,16,31,93,140,1.45,0.058523280036830376,652,Do you think they have a root beer float that could take us there?
4080,236,17,33,99,149,1.4496644295302012,0.05669109335931088,652,"Do me one favor, will you - stop saying 'dessert' island."
4590,236,13,41,95,149,1.4496644295302012,0.05339570375980902,652,It's the lost city of Fatlantis.
4266,238,13,32,84,129,1.449612403100775,0.05922754569742685,652,"If we were stuck on that island,I'd hate myself. But since we're stuck on this island,I hate you."
296,239,16,30,92,138,1.4492753623188406,0.05914914151835688,652,"If you want coffee with dessert, the next island is Java."
7090,239,14,34,90,138,1.4492753623188406,0.0573327820427774,652,The swimming will cancel out the calories.
1480,241,22,31,114,167,1.4491017964071857,0.05547616587780237,652,Another cartoonist who can’t spell.
6997,242,17,32,98,147,1.4489795918367347,0.05725988787959637,652,You think we're the main course?
9099,243,19,41,116,176,1.4488636363636365,0.051452844609583506,652,But these are gummy shark infested waters.
1305,244,15,27,85,127,1.4488188976377954,0.06195242460389317,652,I liked the mirage with the girls better.
2823,245,15,40,101,156,1.4487179487179487,0.053260034252166216,652,I've tried swimming over there several times but it's all just a gimmick to try to get you to sign up for cable TV.
8202,245,18,34,104,156,1.4487179487179487,0.05554070765085997,652,"Swim to the one with the tree you said. We need shade, you said."
5381,247,16,29,91,136,1.4485294117647058,0.05979253614969951,652,"If we must be stranded, why not on a dessert island instead?"
2182,248,18,29,98,145,1.4482758620689655,0.05866574783988436,652,How 'bout we go for a quick swim and then grab some dessert?
4429,248,19,27,99,145,1.4482758620689655,0.059476511416070146,652,We need to stop smoking whatever this tree is made of.
5191,248,14,37,94,145,1.4482758620689655,0.05530396194813522,652,Don't be fooled. Those are antennae.
6851,251,16,37,101,154,1.448051948051948,0.05453868374029804,652,How come you never invite me to your place?
5540,252,18,37,108,163,1.4478527607361964,0.05375639847891581,652,I liked it better when it was a Starbucks.
9704,253,14,32,88,134,1.4477611940298507,0.05856853392095196,652,At least we have somewhere to go for our vacation.
3132,254,17,29,95,141,1.446808510638298,0.059058410386457566,652,"I don’t know, I’m actually in the mood for pizza."
1109,254,16,31,94,141,1.446808510638298,0.05819431857820419,652,Remember when our island used to look like that.
1606,256,16,35,99,150,1.4466666666666668,0.05559253057408096,652,I blame spell-check.
3633,257,12,34,84,130,1.4461538461538461,0.057850112147142016,652,Yesterday it looked  like pizza.
6921,257,16,26,88,130,1.4461538461538461,0.06183589421156908,652,"Tempting, but we should probably hit the sandwich isles first."
6689,259,16,34,98,148,1.445945945945946,0.05613966884540453,652,The Lord works in misspelled ways.
6375,260,17,27,93,137,1.4452554744525548,0.06034083459109208,652,Let's wait until they try barbecue and a bucket of beer on ice.
1615,261,12,41,93,146,1.4452054794520548,0.05326453968000154,652,Nobody knows why their civilization died out.
6067,261,19,27,100,146,1.4452054794520548,0.059147479797108715,652,"Don't say: ""it's better than being macarooned on a dessert island"" ever again."
1280,263,13,43,99,155,1.4451612903225806,0.05189491450979696,652,"Frankly, I prefer yesterday’s steak dinner mirage."
9404,264,17,22,87,126,1.4444444444444444,0.0642964913561033,652,I hear their president wants to build a gingerbread wall.
8536,264,12,48,102,162,1.4444444444444444,0.049535841117809135,652,"As mirages go, it's pretty sweet!"
7999,264,16,32,96,144,1.4444444444444444,0.05727713284842925,652,"Yeah that’d be sweet, but I would kill for some toilet paper"
4142,264,15,34,95,144,1.4444444444444444,0.05642291068539017,652,"In retrospect, life was sweeter over there."
6802,264,18,32,103,153,1.4444444444444444,0.056324231597882655,652,And that's what became of the cane mutiny.
7353,264,18,32,103,153,1.4444444444444444,0.056324231597882655,652,"If it makes you feel any better, we are also surrounded by undrinkable water."
4499,270,17,33,101,151,1.4437086092715232,0.0560949696047552,652,Pretty sure it's a meringue...
3765,271,17,24,90,131,1.4427480916030535,0.06240464749197722,652,Tomorrow we'll fantasize Hillary won.
4110,272,19,31,106,156,1.4423076923076923,0.0562403449045818,652,"If you start singing “Candyman” again, I swear I’ll kill you."
9902,273,14,29,86,129,1.441860465116279,0.06018682229949431,652,"Judging by that desserted isle, I guess we're somewhere near the Tropic of Candicorn."
2789,273,14,29,86,129,1.441860465116279,0.06018682229949431,652,It's just the tip of an icing berg.
1467,275,15,34,96,145,1.4413793103448276,0.05611620918958227,652,This is like one of those New Yorker cartoons.
8784,276,10,40,86,136,1.4411764705882353,0.05399578967927549,652,Maybe. But we've got the fiber.
9724,276,19,37,114,170,1.4411764705882353,0.05273968696136279,652,Wow...a floating typo!
8489,278,18,31,103,152,1.4407894736842106,0.056576515547534664,652,Why didn't we end up on that desserted island?
8588,278,17,33,102,152,1.4407894736842106,0.05580110873235187,652,"If we swim over, we can't swim back for 2 hours."
6281,280,16,31,96,143,1.4405594405594406,0.0575462486185479,652,"We stay put.  No one has ever been rescued from a dessert island."""
6490,280,13,37,93,143,1.4405594405594406,0.05491895448157331,652,I'm saving myself for entree island.
6681,280,15,33,95,143,1.4405594405594406,0.056684016034753495,652,"Sure you'd make it, it's a piece of cake."
6110,283,21,32,115,168,1.4404761904761905,0.054523351921805595,652,"You know Thomas, they're looking at us and thinking the same thing."
175,284,12,35,87,134,1.4402985074626866,0.056564568827334266,652,Do you suppose they see us the same way we see them?
8,285,15,28,89,132,1.4393939393939394,0.060127068543905614,652,"We came that close to being stranded on a dessert island."""
8643,286,12,30,81,123,1.4390243902439024,0.06015035302584929,652,The starvation I can deal with. It's the pun that's killing me.
572,287,14,33,92,139,1.4388489208633093,0.05695786609805594,652,But can we really trust our eyes after the mermaid incident?
3226,288,18,32,105,155,1.4387096774193548,0.05574184238692594,652,The Jones's love to rub it in.
899,289,12,33,85,130,1.4384615384615385,0.05779061391876256,652,Maybe they deliver.
8250,290,13,41,99,153,1.4379084967320261,0.05231982150203932,652,So god DOES have a sense of humor.
5316,291,16,31,97,144,1.4375,0.057227064127795935,652,I might as well put that island right on my thighs.
3113,291,18,34,108,160,1.4375,0.05443210241746047,652,I never realized how clever sharks are.
2384,291,13,30,85,128,1.4375,0.059473990212621716,652,"Yes, that island is most definitely desserted."
1399,294,20,36,118,174,1.4367816091954022,0.052448074653759856,652,I thought hell would have flames.
2078,295,9,40,84,133,1.4360902255639099,0.05374278574532682,652,But the 2 mile swim to Kale Cove would be better for your core.
163,296,17,34,105,156,1.435897435897436,0.05470387019534946,652,How much insulin do we have left?
4872,297,15,31,94,140,1.4357142857142857,0.05753654210911556,652,All we need is an ice cream float
7166,297,18,25,97,140,1.4357142857142857,0.06015628351743857,652,You can have your island and eat it too
8382,299,17,37,109,163,1.4355828220858895,0.052963963071386004,652,"I don't think we should go, it looks desserted."
9503,300,20,27,107,154,1.4350649350649352,0.05748109647107687,652,I swear! If you say that's the way the cookie crumbles ONE more time...
3910,301,14,42,105,161,1.434782608695652,0.05121399560604239,652,"No, no. I’d much rather be here with you."
1993,302,20,29,110,159,1.4339622641509433,0.056097301571418345,652,Nice eh? Last night I saw the sharks building it.
3087,303,16,30,97,143,1.4335664335664335,0.0574923635484602,652,This whole time I thought you were saying 'desert' island.
8080,303,15,32,96,143,1.4335664335664335,0.05662931052157336,652,"I went there once, too touristy."
9066,305,10,32,78,120,1.4333333333333333,0.05885620007766131,652,Yes but it certainly looks desserted
3319,306,15,38,104,157,1.4331210191082802,0.05290351670625326,652,"Frankly, I liked the pizza mirage better."
5930,306,14,40,103,157,1.4331210191082802,0.05212602768829321,652,"The better hallucination would be a boat, dear."
4009,308,15,25,87,127,1.4330708661417322,0.06183317054797768,652,Now that’s what I call a dessert island.
1506,309,12,37,92,141,1.4326241134751774,0.05448939974713569,652,I'm pretty sure it's a dessert island.
6053,309,16,29,96,141,1.4326241134751774,0.058089269019140057,652,Dougs not coming back is he?
5958,311,16,32,100,148,1.4324324324324325,0.05604000272091954,652,"We can swim over if you want, but it looks desserted!"
8482,311,14,36,98,148,1.4324324324324325,0.054374852443443006,652,A dessert island just seems wrong somehow.
8626,313,11,45,99,155,1.4322580645161291,0.05015213957755869,652,I say we're headed for a period of global icing.
9707,314,14,42,106,162,1.4320987654320987,0.05096758978193974,652,"See, that island probably has ants."
1939,315,13,31,88,132,1.4318181818181819,0.05810762169918207,652,"I don’t know, Gretel. It looks like a  trap."
507,316,14,32,93,139,1.4316546762589928,0.05689857271608434,652,You couldn't have aimed for the desserted island?
4344,316,11,38,90,139,1.4316546762589928,0.05408007334926239,652,The swim back will work off the calories.
1166,318,14,38,101,153,1.4313725490196079,0.05308240917615779,652,This is my favorite hallucination.
355,319,18,33,109,160,1.43125,0.05438469063506473,652,One more ‘desserted island’ joke and I swear I’ll eat you.
4845,319,15,39,106,160,1.43125,0.05217130934592234,652,Empty calories vs. no calories is looking pretty good.
6465,321,11,31,81,123,1.4308943089430894,0.058958598427509584,652,"Sharks? No, it’s the high fructose corn syrup that scares me."
9818,321,8,37,78,123,1.4308943089430894,0.055464189028254306,652,"Well, you gotta decide before high tide."
4936,323,13,33,91,137,1.4306569343065694,0.0565537589858253,652,"On the way there, you're all hopes and dreams, but on the way back, you're just shark bait..."
4348,323,18,23,96,137,1.4306569343065694,0.06111496289948715,652,Hey look — a desserted island.
1499,323,15,29,93,137,1.4306569343065694,0.0584209899722554,652,Really? In my mirage it's all gouda and brie and manchego.
3526,323,14,31,92,137,1.4306569343065694,0.05749495510375315,652,And your second wish?
614,327,13,36,95,144,1.4305555555555556,0.05456330285842935,652,"Look, a dessert island!"
6519,327,14,34,96,144,1.4305555555555556,0.05544618215842983,652,Ahhh. “Desserted island.”
6578,327,16,30,98,144,1.4305555555555556,0.05717105307929859,652,It's called a dessert island.
2727,330,16,33,102,151,1.4304635761589404,0.0552017641964893,652,"I wouldn't worry... last week, I thought I saw Chutes and Ladders..."
3764,331,14,30,91,135,1.4296296296296296,0.05810794242610133,652,This one’s empty. That one’s desserted.
5517,332,14,33,95,142,1.4295774647887325,0.05600302455902387,652,When we're done we have to wait an hour before we swim back.
2525,332,15,31,96,142,1.4295774647887325,0.056887862331306466,652,"One of these days, we're just going to forget that we're dentists."
2080,334,13,38,98,149,1.429530201342282,0.05324158680984271,652,I wish we'd skipped appetizer island now.
6924,334,13,38,98,149,1.429530201342282,0.05324158680984271,652,I prefer to eat local.
9107,334,19,26,104,149,1.429530201342282,0.058127746347447926,652,"Did you type ""deserted"" or ""desserted"" island into the booking website?"
8807,337,12,43,101,156,1.4294871794871795,0.05072850544268243,652,I wonder if they deliver?
4264,338,21,34,122,177,1.4293785310734464,0.052348305939848946,652,These hallucinations are getting better.
1139,339,17,32,105,154,1.4285714285714286,0.05516920970164322,652,Really? My hallucination is a lot of naked women.
6499,339,16,34,104,154,1.4285714285714286,0.0543944782241752,652,That’s a desserted island!
4743,341,19,33,114,166,1.427710843373494,0.05358029604388623,652,Now do you believe me about rising sea levels?  Look what’s become of Big Rock-candy mountain.
6792,342,20,28,111,159,1.4276729559748427,0.05604818935560563,652,How about we take the Life Savers.
1334,343,18,29,105,152,1.4276315789473684,0.05647509659792605,652,That was The Big Rock Candy Mountain before climate change.
6220,343,18,29,105,152,1.4276315789473684,0.05647509659792605,652,"Of COURSE I'd swim across, but all the lifesavers are over there"
5180,345,12,35,91,138,1.4275362318840579,0.0552804426675778,652,That island looks totally desserted.
7810,346,12,32,87,131,1.4274809160305344,0.05737508768757895,652,I’ve noticed my energy and attention levels have really improved since we got off that god-forsaken thing.
9452,346,13,30,88,131,1.4274809160305344,0.05838955813545496,652,There’s the proof. Global sweetening.
8705,348,17,39,115,171,1.4269005847953216,0.051075888455228424,652,"Of course, I requested a desserted island! Damned spell check!"
3776,349,15,37,105,157,1.4267515923566878,0.05284941557335756,652,Meh. I’m waiting for a mirage with liquor.
5515,349,12,43,102,157,1.4267515923566878,0.05047853776072686,652,"Don’t try to sugarcoat it, we picked the wrong island."
5095,351,14,36,100,150,1.4266666666666667,0.05380108085594294,652,"No,” you said, “Why would we need swimming lessons?” you said"
714,351,17,30,103,150,1.4266666666666667,0.056240667466759646,652,"I don't know, I heard that neighborhood is a little unsavory."
338,353,15,31,97,143,1.4265734265734267,0.05656846457027379,652,Looks like a dessert island.
2442,353,12,37,94,143,1.4265734265734267,0.05389352479769454,652,The irony is not lost on me that the dessert island is deserted.
5067,353,18,25,100,143,1.4265734265734267,0.05912250292872357,652,Here we are on a desert island because you couldn't spell.
1729,356,16,26,94,136,1.4264705882352942,0.05962149396494368,652,It’s just desserts.
3942,356,18,22,96,136,1.4264705882352942,0.061421392579125815,652,"See, I told you the mushroom was edible."
5681,358,19,17,93,129,1.426356589147287,0.06490078313814089,652,You don't suppose there's a roll of LIFE SAVERS?
9627,359,18,36,115,169,1.4260355029585798,0.05218710640893494,652,"Oh, that's a dessert island."
9485,360,16,37,109,162,1.4259259259259258,0.05239860932602944,652,Not until you finish your fronds.
9101,361,15,33,100,148,1.4256756756756757,0.05515461246008361,652,"What do you mean ""we have to have dinner first."""
8168,361,11,41,96,148,1.4256756756756757,0.051713795279335964,652,What I wouldn’t give for a Lifesaver...
8869,361,15,33,100,148,1.4256756756756757,0.05515461246008361,652,You want to head over there after dinner?
4206,364,18,24,99,141,1.425531914893617,0.05974790212914586,652,"No, that one's desserted."
7421,365,12,33,89,134,1.4253731343283582,0.05643116163964509,652,"Desert, dessert, potato, potahto."
1601,366,23,25,119,167,1.4251497005988023,0.05596075079350922,652,"Even here, my hallucinations are 100% carbs."
9757,367,16,36,108,160,1.425,0.05286597507617464,652,What a cruel way to explain what a homonym is.
2099,368,18,26,102,146,1.4246575342465753,0.05818512994772909,652,These sharks are really bringing their A game.
3608,369,18,23,98,139,1.4244604316546763,0.0603904313474446,652,"Just our luck. You can't swim and I've got diabetes"""
7451,369,16,27,96,139,1.4244604316546763,0.0586385143844879,652,What would Gilligan do?
1408,369,13,33,93,139,1.4244604316546763,0.055907800221023346,652,Now if we can just get past the gummi sharks...
4674,372,17,22,93,132,1.4242424242424243,0.061893564593582306,652,"You know, maybe we're the mirage."
6876,372,13,30,89,132,1.4242424242424243,0.058035951392944485,652,I always wanted to be shipwrecked on a dessert island ...
1366,374,16,35,107,158,1.4240506329113924,0.05334441268197727,652,"...So Monopoly and Chutes and Ladders were mirages, but Candyland is a go?"
5158,374,18,31,109,158,1.4240506329113924,0.05483500409913354,652,...and I was just about to eat you.
1555,376,7,39,79,125,1.424,0.053598266702836454,652,"Our island isn't much, but it's got a sweet view."""
6294,377,19,20,98,137,1.4233576642335766,0.061923708703318564,652,That's all there's left of the Good Ship Lollipop.
788,377,15,28,94,137,1.4233576642335766,0.0583538933726821,652,That's a completely desserted island.
2768,377,13,32,92,137,1.4233576642335766,0.05648444438815701,652,You start with one and pretty soon you've eaten a whole archipelago.
8773,380,18,33,112,163,1.4233128834355828,0.053574569115551626,652,"Nice to finally see the difference between desert island and a dessert
island"
6514,381,19,28,109,156,1.4230769230769231,0.05609166367976676,652,I told you we should have gone with the all-inclusive.
4663,382,15,33,101,149,1.4228187919463087,0.054857637806353124,652,"I don't know, Gretel. It looks like another trap."
4951,382,13,37,99,149,1.4228187919463087,0.05317867037223302,652,"No, that's a D-E-S-S-E-R-T island."
7106,384,19,33,116,168,1.4226190476190477,0.05306208454971435,652,"I can't remember what I've been hallucinating longer, you or that island in the distance."
5705,385,20,28,113,161,1.4223602484472049,0.05547630541207233,652,"All in all, I'd rather be on the desserted island."
9601,386,17,31,106,154,1.422077922077922,0.05511173264832247,652,That's how you decided to spend our one wish?
9595,387,13,28,87,128,1.421875,0.059328359219492706,652,It’s always sweeter on the other isle
1069,388,18,26,103,147,1.4217687074829932,0.05786011852255213,652,"When you said 'candy aisle,' I pictured something different."
2260,388,9,44,94,147,1.4217687074829932,0.05009093405401622,652,I told you Amazon delivers EVERYWHERE!
9620,390,13,38,101,152,1.4210526315789473,0.05241328029213941,652,Hope we're not the main course.
5198,390,16,32,104,152,1.4210526315789473,0.054850406363165606,652,Castaway calories don't count.
5013,392,11,39,95,145,1.4206896551724137,0.05240295310370055,652,Let's have our cake and islet too.
8624,392,13,35,97,145,1.4206896551724137,0.05420000346139004,652,"I’m just never enough for you, am I?"
9561,394,12,34,92,138,1.4202898550724639,0.055207593381370254,652,"If you say that's ""a sweet view"" one more time, you've moving over there."
5938,395,17,37,115,169,1.4201183431952662,0.05145515574489027,652,"You go, I'm a salty person."
9393,396,14,27,90,131,1.4198473282442747,0.05931117466546743,652,Looks pretty sweet over there.
9214,397,11,38,94,143,1.4195804195804196,0.05290030784351524,652,Another mirage.  Yesterday it was Bud Light.
9867,398,14,37,104,155,1.4193548387096775,0.052480145859369075,652,I really was hoping for something salty.
2040,399,15,27,94,136,1.4191176470588236,0.05862917237947629,652,"For the millionth time; yes, that is a desserted island!"
9051,400,17,28,103,148,1.4189189189189189,0.05673398890204861,652,Too bad we weren’t macarooned on that island.
3054,400,14,34,100,148,1.4189189189189189,0.05424905074437773,652,That genie is a stickler for pronunciation.
9947,402,12,25,80,117,1.4188034188034189,0.06218266475433432,652,It's kind of ironic really. I've been misspelling desert for years.
1239,403,13,41,106,160,1.41875,0.05052544271587554,652,Let's wait for the roast beef mirage.
5926,404,14,26,89,129,1.4186046511627908,0.05997584544745654,652,Well the AirBNB description did say it was private with tantalizing views.
6328,405,15,29,97,141,1.4184397163120568,0.05707850968944634,652,"I told you, ""dessert islands"" are just a typ'o mirage."
9543,405,15,29,97,141,1.4184397163120568,0.05707850968944634,652,That's Brexit Island. It's further away than it looks.
3364,407,11,42,100,153,1.4183006535947713,0.05046599079357676,652,The bright side is—no ants.
4907,408,15,26,93,134,1.4179104477611941,0.05926504139067802,652,Last of the polar icing.
2978,409,15,31,100,146,1.417808219178082,0.05562956068681201,652,Just a consonant away.
6583,410,16,34,108,158,1.4177215189873418,0.05328459207343426,652,Look!  We've been completely desserted.
1681,411,13,32,94,139,1.4172661870503598,0.055833959064655735,652,"We may be stranded, but we're not desserted."
4456,411,16,26,97,139,1.4172661870503598,0.05856811614265555,652,"No, I said DESSERT island!"
7101,411,14,30,95,139,1.4172661870503598,0.05675998061476911,652,I'm suspicious because an hour ago it was covered with scantily-clad women.
2156,414,14,35,102,151,1.4172185430463575,0.05345263909673005,652,Beats an island of kale.
4232,414,16,31,104,151,1.4172185430463575,0.05507980635320332,652,I see hot women in bikinis.  what do you see?
8461,414,12,39,100,151,1.4172185430463575,0.0517743583726942,652,I hear it’s pretty sweet there.
1673,417,13,29,90,132,1.4166666666666667,0.05795663373007905,652,Think we can make it past the Swedish fish?”
1921,417,17,26,101,144,1.4166666666666667,0.057886231962495635,652,I think it's one of those desserted islands.
3554,417,13,29,90,132,1.4166666666666667,0.05795663373007905,652,Amazing what a difference one little letter makes.
8730,417,12,36,96,144,1.4166666666666667,0.05352747299462553,652,Remember to wait at least one hour before you swim back.
9065,421,16,30,103,149,1.4161073825503356,0.055612506456572626,652,"You can try to swim it, but watch for the Swedish fish."
6251,422,15,39,112,166,1.4156626506024097,0.05066886576544505,652,We'll be ok.  The Good Ship Lollypop comes once a week or so
1714,423,19,26,109,154,1.4155844155844155,0.056570117048513315,652,Is it bait or are we?
3377,423,13,38,103,154,1.4155844155844155,0.051873726644042176,652,Would you call it home sweet home?
6522,423,18,28,108,154,1.4155844155844155,0.0558148340950583,652,If we were on that island I would probably stop dreaming about eating you.
6642,423,17,30,107,154,1.4155844155844155,0.05504918952387281,652,"You're seeing things, John. That island is clearly desserted."
113,427,15,24,91,130,1.4153846153846155,0.060592006243284376,652,"It's a dessert island"""
25,428,17,32,110,159,1.4150943396226414,0.05375916211716763,652,Do you think they deliver?
9871,429,13,35,99,147,1.4149659863945578,0.0536119980456653,652,Thanks for dinner.  Want to head over to my place for a bit of dessert?
9342,429,14,33,100,147,1.4149659863945578,0.05447416171511015,652,a desserted island???
5597,429,11,39,97,147,1.4149659863945578,0.051844675852177086,652,Frank's been over there for two hours.  Maybe you should go check on him.
6126,429,10,41,96,147,1.4149659863945578,0.05093802562037285,652,"You know, I had something completely different in mind when my agent booked me  on “Temptation Island.”"
6922,429,13,35,99,147,1.4149659863945578,0.0536119980456653,652,"If it was real, there would be more chocolate."
1425,434,17,22,96,135,1.4148148148148147,0.06075368277497684,652,They called it the Big Rock Candy Mountain before climate change.
2596,434,17,22,96,135,1.4148148148148147,0.06075368277497684,652,No one lives there.  It’s a desserted island.
2776,436,17,29,106,152,1.4144736842105263,0.055574629725244046,652,Don't spoil your appetite - wait for the main course mirage.
3956,436,15,33,104,152,1.4144736842105263,0.05398391165538699,652,It was the roof of the world's largest bakery before the sea began rising.
5830,436,16,31,105,152,1.4144736842105263,0.05478504443146234,652,They're trying to attract an Amazon HQ
7001,436,13,37,102,152,1.4144736842105263,0.05234487526143581,652,Make sure to wait an hour before you come back.
6509,440,14,30,96,140,1.4142857142857144,0.05643185622765291,652,It seems to me we're nowhere near the Sandwich Islands.
8274,440,12,34,94,140,1.4142857142857144,0.054580257891117305,652,Go for it if you  want.  I saw the sharks set it up last night.
4314,440,13,32,95,140,1.4142857142857144,0.05551377733842006,652,It never tastes as good as it looks.
2352,443,13,34,98,145,1.4137931034482758,0.05412682610561426,652,"I’m telling you, one cheat day won’t hurt."
5226,443,10,28,78,116,1.4137931034482758,0.060071129149596926,652,It could be worse. There could be a wall around it.
5806,443,14,32,99,145,1.4137931034482758,0.05500453385749608,652,It's just as well. I have absolutely no willpower.
4643,446,17,33,112,162,1.4135802469135803,0.053009325880924524,652,"Yeah, that island is definitely desserted."
6641,447,15,25,93,133,1.413533834586466,0.059549286437797666,652,"One letter makes a big difference , huh?"
9632,448,12,38,100,150,1.4133333333333333,0.051973721347077735,652,I think I’m gonna have to resort to candybalism.
4651,448,16,30,104,150,1.4133333333333333,0.055310121543127935,652,Maybe we should relocate to a dessert island.
8047,448,17,28,105,150,1.4133333333333333,0.05611323376645264,652,My palm tree doesn't spark joy anymore.
623,451,15,27,96,138,1.4130434782608696,0.05793463896312194,652,"Dude, how many more days of the medicinal marijuana do we have left?"
2659,451,11,35,92,138,1.4130434782608696,0.054159729510027135,652,Best mirage of the week.
6265,453,17,30,108,155,1.4129032258064516,0.05475856041923238,652,I kinda regret voting her off the island.
1884,454,13,33,97,143,1.4125874125874125,0.05465494973783437,652,It's teeming with gummy sharks. We'd never make it.
2136,454,16,27,100,143,1.4125874125874125,0.05729435137571423,652,So it's safe to say the Big Rock Candy Mountain was more impressive before climate change.
4931,454,13,33,97,143,1.4125874125874125,0.05465494973783437,652,"Dude, check out that island over there.....sweet..."
6007,454,15,29,99,143,1.4125874125874125,0.05642826989483438,652,"desserted island, deserted island --- i knew we should have spell-checked it!"
6639,454,16,27,100,143,1.4125874125874125,0.05729435137571423,652,Nobody goes there anymore since they switched to high fructose corn syrup.
8617,454,14,31,98,143,1.4125874125874125,0.05554868663690202,652,Boy that genie's a real stickler for pronunciation huh?
4965,460,12,30,89,131,1.4122137404580153,0.05721078969685138,652,You think the genie will come back? I’m starting to regret my choices.
8201,460,14,26,91,131,1.4122137404580153,0.05922798394281167,652,"So what if it's not a mirage, neither of us can swim.."
7606,462,13,35,100,148,1.412162162162162,0.053322289880432305,652,Pity about the sharks.
4501,462,13,35,100,148,1.412162162162162,0.053322289880432305,652,After you finish be sure to wait an hour before you try to swim back.
1905,464,17,29,107,153,1.411764705882353,0.055276622253218076,652,"That looks good, but the island of naked women is still my favorite mirage."
5846,464,12,32,92,136,1.411764705882353,0.05568995661213279,652,I'm starting to think we should have gone with the all inclusive.
158,464,12,32,92,136,1.411764705882353,0.05568995661213279,652,I think tooth decay is the least of our worries
1278,464,13,30,93,136,1.411764705882353,0.05665954226196035,652,I think tomorrow I'll sit on the other side of the island.
5155,468,14,30,97,141,1.4113475177304964,0.056107186811822404,652,I just assumed the travel agent meant ocean-view suites.
3969,469,14,23,87,124,1.4112903225806452,0.06167954456251675,652,This is where you end up for eternity when you cheat at Candyland.
2947,470,10,24,73,107,1.411214953271028,0.06361982479436777,652,"I know we agreed you would write the note. I just think  ""we are stranded next to a dessert island""  doesn't really pop."
1229,471,17,33,113,163,1.4110429447852761,0.052744176402119466,652,"That's probably our best hallucination so far."""
6735,472,13,34,99,146,1.4109589041095891,0.053829480131209265,652,"I've heard of the Sandwich Islands, but this is ridiculous!"
9302,473,12,29,88,129,1.4108527131782946,0.05783187329990998,652,That's a Desserted Island. Rookie mistake.
4150,474,20,29,119,168,1.4107142857142858,0.05361893151010933,652,It’s a piece of cake.
1935,475,20,22,109,151,1.4105960264900663,0.05813246894076153,652,Plans to eat you have been postponed.
7652,475,13,36,102,151,1.4105960264900663,0.05254790576126456,652,"What do you think, Hansel?"
1980,477,15,25,94,134,1.4104477611940298,0.05918373287602838,652,Desert. Dessert.  Do you see now why spelling matters?
4617,477,10,35,89,134,1.4104477611940298,0.0542366111033022,652,Not until we've had dinner.
982,477,11,33,90,134,1.4104477611940298,0.05526147694918125,652,"Well, here goes my beach body."
4498,480,18,35,120,173,1.4104046242774566,0.05115327822579655,652,Do you ever wonder if we’re the mirage?
192,481,19,26,111,156,1.4102564102564104,0.055968645121242645,652,Nah. That one’s way too desserted.
258,481,15,34,107,156,1.4102564102564104,0.05293049492449913,652,"Remember how you were soooo sure ""dessert island"" was just a typo on the map?"
3988,481,13,22,82,117,1.4102564102564104,0.0632570229385882,652,Don’t you think about desserting me!
9688,484,15,27,97,139,1.410071942446043,0.05759304271804222,652,I told you it looked desserted.
8928,485,16,34,111,161,1.4099378881987579,0.05247895887836,652,It would be a better spot for the hammock.
6801,486,18,23,103,144,1.4097222222222223,0.05864733540346584,652,Dude! It's just the acid! We're on your front porch! That's an Ice Cream Truck!!
8377,487,13,26,88,127,1.4094488188976377,0.05953023061888796,652,Still don't believe in Global Warming? That's all that's left of the Big Rock Candy Mountain.
8543,488,11,32,89,132,1.4090909090909092,0.055835240442236506,652,"The sharks are getting mighty cunning, George..."
7108,488,12,30,90,132,1.4090909090909092,0.05686153793423367,652,Do you ever regret picking the vegan island?
7929,490,19,27,113,159,1.4088050314465408,0.055156692124264224,652,Let’s desert the desert for the dessert
9623,490,14,37,108,159,1.4088050314465408,0.05142181644585138,652,"With a little luck, we could have been shipwrecked on a dessert island."
5414,492,16,24,97,137,1.4087591240875912,0.05911428020583265,652,So that’s what you meant by a desserted island.
371,493,14,39,111,164,1.4085365853658536,0.05029765091665162,652,It looks 'dessert-ed'.
745,494,12,34,96,142,1.408450704225352,0.053965632020418146,652,Those sharks are getting smarter by the day.
766,495,12,36,99,147,1.4081632653061225,0.052657547058458806,652,They're probably stale anyway.
5130,496,13,36,103,152,1.4078947368421053,0.052270897280421856,652,"Like, I don’t think those were normal mushrooms man!"
8084,497,14,38,110,162,1.4074074074074074,0.050725550544803606,652,So you can't swim and I'm diabetic...
7599,497,13,29,93,135,1.4074074074074074,0.056911767557240436,652,"Hey man, that's some powerful weed you got there."
5410,497,12,31,92,135,1.4074074074074074,0.0559320209448561,652,I guess spelling really does matter.
3283,497,13,40,109,162,1.4074074074074074,0.049963989452123415,652,Looks like the neighbors are having a party.
61,497,17,32,113,162,1.4074074074074074,0.052944548221493054,652,That’s one hell of a desserted island.
855,497,13,29,93,135,1.4074074074074074,0.056911767557240436,652,"Remember you thought Bikini Island sounded like paradise, too?"
0,497,16,23,96,135,1.4074074074074074,0.05975470061032852,652,I'm sorry. I thought I was signing us up for that desserted island...
2354,497,14,27,94,135,1.4074074074074074,0.05787493072136595,652,"Even though it cost us our teeth, I don’t regret one moment of the 8 years we spent on that island."
8046,505,15,27,98,140,1.4071428571428573,0.05725515686655509,652,So the fish gave you one wish.  Just one wish.
9969,505,14,29,97,140,1.4071428571428573,0.0563504930315168,652,"If it’s not a mirage, it’s a misspelling."
3965,505,12,33,95,140,1.4071428571428573,0.05449613031268741,652,Was that strawberry there yesterday?
3384,505,16,25,99,140,1.4071428571428573,0.05814574714226861,652,"It's called ""dessertification""."
2628,505,12,33,95,140,1.4071428571428573,0.05449613031268741,652,"Could be a trick, Hansel"
1226,505,11,35,94,140,1.4071428571428573,0.05354487180056181,652,They say that sugar is the real killer.
1099,511,17,27,106,150,1.4066666666666667,0.056041424968084036,652,"Finally, our just desserts."
4695,512,12,26,85,123,1.4065040650406504,0.059807098471559364,652,I can't wait for my cheat day.
5607,513,16,33,111,160,1.40625,0.05267742929000782,652,Great choice. Starve or gain back the weight I lost.
5346,514,17,33,115,165,1.406060606060606,0.052221152401023166,652,"Actually, you have to hand it to the sharks. It's tempting AND a pretty clever pun."
9148,514,15,37,113,165,1.406060606060606,0.050786111271450045,652,Life Savers??
7128,516,12,32,94,138,1.4057971014492754,0.0550407186619516,652,"Nice! Now do the one with roast beef, turkey and mashed potatoes."
9773,517,8,42,93,143,1.4055944055944056,0.04985723954897555,652,"It seems a little too ‘Hansel and Gretel’, don’t you think?"
8613,517,12,34,97,143,1.4055944055944056,0.05366299060248201,652,"I don't know, I'd feel kinda guilty, not having had dinner."
7059,517,10,38,95,143,1.4055944055944056,0.051795081310130234,652,"Boy, those sharks are clever."
3634,517,14,30,99,143,1.4055944055944056,0.05546803289175795,652,"It’s too risky: gluten, sugar, trans fats and sharks."
4921,517,11,36,96,143,1.4055944055944056,0.05273730656909335,652,"But remember, you have to wait an hour before you can come back."
4665,517,12,34,97,143,1.4055944055944056,0.05366299060248201,652,It's a piece of cake for anyone who can swim.
6664,517,16,26,101,143,1.4055944055944056,0.05721615842889326,652,I wish we had gotten stranded on the desserted island!
2916,524,16,28,104,148,1.4054054054054055,0.05577335567572832,652,"Maybe I'm hallucinating, but it looks desserted to me."
2154,525,14,34,105,153,1.4052287581699345,0.052817022006323364,652,"Well, here we die of starvation. There, diabetes"
2118,526,20,24,114,158,1.4050632911392404,0.056102248457542234,652,It's an old shark trick.
254,527,10,31,85,126,1.4047619047619047,0.05654448612875199,652,You distract the sharks. I'll cover you.
511,528,12,29,90,131,1.4045801526717556,0.05711669293958194,652,Hey...it's just desserts.
1272,528,12,29,90,131,1.4045801526717556,0.05711669293958194,652,I dunno. It feels like a trap.
3265,528,9,35,87,131,1.4045801526717556,0.05394438966255515,652,Why couldn't we have landed on the desserted island?
5479,528,12,29,90,131,1.4045801526717556,0.05711669293958194,652,"As hallucinations go, that's a pretty damned good one."
2286,532,13,31,97,141,1.4042553191489362,0.05511223089616413,652,I think we’ll burn all the calories on the way back
3868,532,11,35,95,141,1.4042553191489362,0.05324212382282164,652,Let's wait. Tomorrow's my cheat day.
3623,534,16,27,103,146,1.404109589041096,0.056323150827683834,652,"It’s not a mirage, it’s a typo."
8930,534,12,35,99,146,1.404109589041096,0.05286212324528574,652,"Yes, we can swim over, but we’ll need to wait at least a half hour before we swim back."
7137,536,13,35,103,151,1.403973509933775,0.0524699497280197,652,Don't fall for it. This island looked the same way from over there.
9886,537,11,41,104,156,1.4038461538461537,0.04962960087686117,652,"Yeah, but you should see the size of the ants."
2801,538,16,33,112,161,1.4037267080745341,0.0524099953036745,652,Wanna go out for dessert tonight?
5372,538,15,35,111,161,1.4037267080745341,0.05166398993668983,652,"Apparently, before global warming, that was Big Rock Candy Mountain."
1123,540,10,28,81,119,1.403361344537815,0.058854042180866956,652,And you said sharks aren't intelligent.
4345,541,11,30,88,129,1.4031007751937985,0.05667569308484402,652,"It's a trick, I tell ya.  It's how it lures its prey"
1588,542,18,18,98,134,1.4029850746268657,0.06187817406897964,652,"Next time you book your fantasy vacation, Ralph, try to remember that “dessert” has a double “s”."
9977,542,17,20,97,134,1.4029850746268657,0.06096464201056951,652,Who knew genies took spelling so seriously?
1664,544,14,28,97,139,1.4028776978417266,0.0565945475010009,652,"I’d swim over, but I know I’d regret it later."
9837,545,11,36,97,144,1.4027777777777777,0.05244548400191822,652,So where do you think the rescue boat will stop first?
3495,545,15,28,101,144,1.4027777777777777,0.056027039728115645,652,Those sharks are really clever!
3444,545,13,32,99,144,1.4027777777777777,0.05426581784554301,652,"Dying in a cliché is one thing, but I draw the line at puns."
2581,545,13,32,99,144,1.4027777777777777,0.05426581784554301,652,It's as if this weight loss program wants us to fail.
5698,549,15,30,104,149,1.4026845637583893,0.05464084130794347,652,The swim is not that far -- piece of cake.
8023,549,12,36,101,149,1.4026845637583893,0.05209162479840927,652,Only three and a half stars on Yelp though...
573,551,17,28,109,154,1.4025974025974026,0.0549088344141622,652,We should have paid for the upgrade.
7548,551,13,36,105,154,1.4025974025974026,0.051724755634293976,652,"Well, they gave me 2 choices, but I forgot how to spell dessert..."
9235,553,16,32,111,159,1.4025157232704402,0.05287641893991795,652,"I know we're starving today, it's just that I'll hate myself tomorrow."
447,554,20,26,118,164,1.4024390243902438,0.05451314329401901,652,What a difference an extra S makes.
4877,555,12,27,88,127,1.4015748031496063,0.05836997886890559,652,The irony is that the grass is greener on this side.
8378,556,9,35,88,132,1.4015151515151516,0.05362182896779585,652,"I love it, I really do. But, next time you come across a genie in a bottle, promise me you'll come get me."
208,557,12,31,94,137,1.4014598540145986,0.05527154366910861,652,It truly is a desserted island.
8722,557,16,23,98,137,1.4014598540145986,0.05902806423549124,652,Really? You couldn't have wished us off the island?
7376,559,15,27,100,142,1.4014084507042253,0.056590310177329774,652,You know we'll have to wait 30 minutes before we come home?
2097,560,16,27,104,147,1.401360544217687,0.05600619661122764,652,"Y'know what else has one ""s?"" Stranded."
4064,560,15,29,103,147,1.401360544217687,0.05516798073828635,652,Lent always seems to come at a difficult time
5796,560,14,31,102,147,1.401360544217687,0.054316831080470626,652,Don't even think about it - I saw the sharks building it last night.
4633,560,15,29,103,147,1.401360544217687,0.05516798073828635,652,That's what's left of The Big Rock Candy Mountain after climate change.
3920,564,11,39,102,152,1.4013157894736843,0.050494132417504015,652,"What do you think, Gretel?"
1845,565,16,31,110,157,1.4012738853503184,0.05335385084131237,652,This is the moment you're supposed to say - 'Life with you is sweet enough!'
2930,565,15,33,109,157,1.4012738853503184,0.052583020855299874,652,I say it's just desserts.
7277,567,16,33,113,162,1.4012345679012346,0.052145058877527774,652,But you'll probably burn it all off on the swim back
6697,568,15,41,121,177,1.4011299435028248,0.04824865974068689,652,Let's stay.  We can't just show up empty handed.
6869,569,16,28,106,150,1.4,0.05515891217963932,652,"One thing is certain, it will taste better than the kids."
7351,569,14,36,110,160,1.4,0.05108877462889241,652,I think we should try the desserted island for a change.
7369,569,14,30,101,145,1.4,0.054842162933723196,652,"Now, can you dream up a boat"
7910,569,12,26,87,125,1.4,0.05902432522055577,652,Just to think we could have been marooned on a dessert island.
9478,569,15,30,105,150,1.4,0.05434169793287828,652,Ask yourself why the frosting never melts.
9789,569,16,24,100,140,1.4,0.05806046392974222,652,"Wow,talk about eye candy!"
9880,569,14,32,104,150,1.4,0.05351200496725209,652,"No, Todd, the irony is not lost on me."
6421,569,13,28,94,135,1.4,0.056818156691285454,652,"I told you when you booked it-Dessert Island has two ""S's""."
9523,569,14,28,98,140,1.4,0.0562624886216321,652,"Wait,there was an option for a desserted island?!?!"
6135,569,15,26,99,140,1.4,0.05716854509971449,652,I've got a thousand bucks that says it's just a typo.
9311,569,15,34,111,160,1.4,0.051852475787401105,652,"You realize if we swim over there and eat those desserts, we have to wait 3 hours before we can return here."
4768,569,10,36,94,140,1.4,0.05248207250313244,652,"Funny, that’s just how I imagined a desserted island would look."
390,569,15,26,99,140,1.4,0.05716854509971449,652,"Technically speaking, a desert island is an island, islet or atoll that is not permanently populated by humans.  That one, however, is desserted."
2644,569,11,28,86,125,1.4,0.05792096951603469,652,"The artist forgot to draw shark fins, so I think it's safe to swim over."
3288,569,16,26,103,145,1.4,0.056561769035940665,652,"Oh, right.  Two esses."
5969,569,13,24,88,125,1.4,0.06010743070375286,652,You tell me what you see first.
224,569,14,24,92,130,1.4,0.05941475656396446,652,I always wondered what life was like on a desserted island.
3904,569,15,32,108,155,1.4,0.05305892259424582,652,I think it's called a dessert island.
4136,569,13,38,109,160,1.4,0.0503134826948056,652,...and we'd burn the calories on the swim back.
4646,569,9,40,96,145,1.4,0.05028653529707439,652,Yeh-- but we have the palm tree.
3533,569,12,38,105,155,1.4,0.050634846945340393,652,"Sure, it looks nice from here. But pretty soon you're thinking, man, what I really want is a tree."
250,590,20,29,124,173,1.3988439306358382,0.05232841964642929,652,"Well, you got your wish. Just you, me, and a desserted island."
7513,591,18,31,119,168,1.3988095238095237,0.05214249257391435,652,"Well, at least we have a pretty sweet view."
3545,592,12,39,107,158,1.3987341772151898,0.04994544586348932,652,Looks even more desserted than ours.
9315,592,13,37,108,158,1.3987341772151898,0.050746164560350665,652,Worst typo ever.
1967,594,11,39,103,153,1.3986928104575163,0.05023154957296615,652,I'm still full from your Steak Dinner Mirage.
4648,595,11,37,100,148,1.3986486486486487,0.05140055799400024,652,But then what would we have to look forward to?
609,595,14,31,103,148,1.3986486486486487,0.05401669512443618,652,"Nobody knows exactly, but they suspect the kids from Easter Island."
3079,595,15,29,104,148,1.3986486486486487,0.05486102455772697,652,"Lets go tonight if you're not busy."""
4166,595,16,27,105,148,1.3986486486486487,0.05569255496815312,652,The sharks are at it again.
6206,599,13,29,96,138,1.3985507246376812,0.05590097094007525,652,I’m certain the brochure said we’d be stranded together on a dessert island.
8110,599,16,23,99,138,1.3985507246376812,0.058670930795702604,652,We seem to be on the wrong desserted island.
2269,599,11,33,94,138,1.3985507246376812,0.05397541575985447,652,'Of course I'd have preferred the dessert island.'
1183,602,14,25,94,133,1.3984962406015038,0.0584019057530378,652,"Funny, I thought “desserted island” was just a misspelling."
5625,602,10,33,90,133,1.3984962406015038,0.05436081244219708,652,"See, now that’s a dessert-ed island!"
9553,602,15,23,95,133,1.3984962406015038,0.05936921560993926,652,Where are the cigarette trees?
2430,605,11,29,88,128,1.3984375,0.056926534960666214,652,Now do you wish we'd auditioned for 'Temptation Island' rather than 'Survivor'?
3875,605,15,21,92,128,1.3984375,0.06109628766856397,652,The last mirage had Hooters waitresses and chicken wings.
9587,605,11,29,88,128,1.3984375,0.056926534960666214,652,I don't know...what are the Yelp reviews?
769,608,11,42,108,161,1.3975155279503106,0.048486009304335394,652,I bet they have an ant problem.
7210,609,17,28,111,156,1.3974358974358974,0.054324551736578984,652,Spelling matters.
6224,609,17,28,111,156,1.3974358974358974,0.054324551736578984,652,So I guess we’ll get our just desserts.
341,611,12,36,103,151,1.3973509933774835,0.05153662637971846,652,Too bad we ate the lifesavers.
195,611,15,30,106,151,1.3973509933774835,0.054045578180405736,652,"Well, Mom's not here."
9793,613,11,36,99,146,1.3972602739726028,0.05187049391830312,652,"I‘m so happy we landed on this gluten-free, sugar free, non-dairy, low carb organic island!"
2489,613,10,38,98,146,1.3972602739726028,0.05095169112050315,652,We could make it - but we'd hate ourselves afterwards.
2910,613,12,34,100,146,1.3972602739726028,0.052773302441843466,652,Please swim over there and see if there are peanuts in anything.
3233,613,11,36,99,146,1.3972602739726028,0.05187049391830312,652,Our travel agent sucks.
3601,613,15,28,103,146,1.3972602739726028,0.05539351392073772,652,The sharks are upping the ante.
7917,613,15,28,103,146,1.3972602739726028,0.05539351392073772,652,The genie said to write my wish down. One stupid letter!
9183,613,15,28,103,146,1.3972602739726028,0.05539351392073772,652,Yes Dr. Atkins. This is hell.
5272,620,14,28,99,141,1.3971631205673758,0.05593402596632724,652,I liked it better when it was Easter Island and had the chocolate bunnies and eggs filled with jelly beans.
5758,620,12,32,97,141,1.3971631205673758,0.054092337864196004,652,It's amazing what you can do with discarded plastic when you've got time on your hands.
4962,620,14,28,99,141,1.3971631205673758,0.05593402596632724,652,Empty calories? Did you seriously just utter the phrase “empty calories “?
6994,620,14,28,99,141,1.3971631205673758,0.05593402596632724,652,I think it’s just another desserted island.
2296,624,12,30,94,136,1.3970588235294117,0.05550266609693397,652,"Yeah, but this island has free wi-fi."
7556,625,9,34,88,131,1.3969465648854962,0.05383625956144687,652,Save my spot.
7048,626,8,34,84,126,1.3968253968253967,0.05413606031058338,652,I thought you said swim for the 'deserted' isle.
9519,627,21,23,120,164,1.396341463414634,0.05512687367368383,652,It's always the island you're not on that's desserted.
430,628,17,27,110,154,1.396103896103896,0.054830983344030984,652,So there is a difference between desert island and dessert island.
1812,628,15,31,108,154,1.396103896103896,0.05326041549618417,652,"It looks perfectly safe to me, Gretel."
1959,630,15,29,105,149,1.395973154362416,0.054557228647929806,652,"Looks like we've been desserted!"""
194,631,14,29,101,144,1.3958333333333333,0.05506472669390202,652,Funny how we never hallucinate about kale or goji berries.
1695,631,15,27,102,144,1.3958333333333333,0.05593969273243484,652,I’m pretty certain the sharks built it.
9125,631,12,33,99,144,1.3958333333333333,0.05327169916216237,652,The commute keeps me fit
8085,634,16,21,97,134,1.3955223880597014,0.05994298034695962,652,"Okay, but be sure to wait an hour before swimming back."
6827,634,12,29,93,134,1.3955223880597014,0.05607385745906729,652,Go ahead- the sharks are harmless ever since their teeth rotted away.
752,634,9,35,90,134,1.3955223880597014,0.05298693177036818,652,I'm more of a Spice Islands guy.
5604,637,9,33,87,129,1.3953488372093024,0.05438455504031892,652,"Under the circumstances, I say screw tooth decay."
6898,637,12,27,90,129,1.3953488372093024,0.05762856860929945,652,Those sharks are such bastards.
7102,639,13,40,114,167,1.3952095808383234,0.04876224534537923,652,Those sharks are devious!
9300,639,9,48,110,167,1.3952095808383234,0.04570751692612579,652,I figure it’ll take us 20 minutes to swim there and no more than 2 minutes to swim back.
2847,641,12,25,87,124,1.3951612903225807,0.059301985327817774,652,Dessert island.  Desert island. What’s the difference?
8680,642,18,28,116,162,1.3950617283950617,0.05352251406319271,652,"Boy, talk about going a long way for a pun!"
2055,643,15,32,110,157,1.394904458598726,0.052503829513893555,652,What will those sharks think of next?
8388,643,15,32,110,157,1.394904458598726,0.052503829513893555,652,"This is what I would call bittersweet."""
4879,645,14,32,106,152,1.394736842105263,0.05293568469953006,652,We should eat dinner first.
7312,646,16,26,105,147,1.3945578231292517,0.055921240001751485,652,I've never seen an island so desserted
674,647,12,32,98,142,1.3943661971830985,0.05378282993495165,652,I guess that you’ve been right all along: these are our just desserts.
1199,647,13,30,99,142,1.3943661971830985,0.054703591442235106,652,Just our luck. We end up on the DESERT  island.
4656,647,10,36,96,142,1.3943661971830985,0.05189231690797626,652,"My agent said this casting call was for ""The Life of Pie."""
5081,647,17,22,103,142,1.3943661971830985,0.05824125170484545,652,Those sharks are very clever.
9209,647,13,30,99,142,1.3943661971830985,0.054703591442235106,652,That was the wreck of the Good Ship Lollipop
9421,652,15,24,98,137,1.3941605839416058,0.058017246434231,652,"Ok, I’m turning off AutoCorrect before I book our next trip."
9693,652,13,28,96,137,1.3941605839416058,0.056136587622501066,652,It's glucoser than it looks.
9823,652,12,30,95,137,1.3941605839416058,0.0551722236541447,652,So Jerry... Could a dead body hypothetically... just hypothetically... act as a raft for a couple miles? Asking for a friend.
5669,655,13,26,93,132,1.393939393939394,0.05767246586694289,652,"Personally, I prefer the nude car wash hallucination."
651,655,13,26,93,132,1.393939393939394,0.05767246586694289,652,"When you’re granted a wish, make sure you spellcheck."
5415,655,12,28,92,132,1.393939393939394,0.0566608586077705,652,That was the best Nutcracker performed by sharks I've ever seen.
3879,658,10,43,107,160,1.39375,0.04782771344059818,652,You go ahead. I'm doing Paleo.
2173,659,9,43,103,155,1.3935483870967742,0.04799872065180666,652,I'm holding out for the chocolate mirage.
5917,660,16,27,107,150,1.3933333333333333,0.05507502848040864,652,"Well the staging is completed. The ""For Sale"" sign goes up tomorrow."
3614,660,12,35,103,150,1.3933333333333333,0.05172346592858914,652,"Since the cupcake ate Jack, we probably shouldn’t risk it."
4030,660,12,35,103,150,1.3933333333333333,0.05172346592858914,652,"Well yeah, but we have a tree."
4930,660,14,31,105,150,1.3933333333333333,0.053425535513384165,652,Must be a really unusual microclimate
4012,664,15,27,103,145,1.393103448275862,0.055619595802000966,652,"Well, now we know why the desert island was so much cheaper than the dessert island."
9215,664,15,27,103,145,1.393103448275862,0.055619595802000966,652,"Once again, spellcheck ruins a dessert island booking."
2627,664,13,31,101,145,1.393103448275862,0.05386992255379536,652,"To think, we could have landed on the dessert island."
810,667,15,25,100,140,1.3928571428571428,0.05707537124916552,652,They could have at least stranded us on the desserted island !
1082,667,15,25,100,140,1.3928571428571428,0.05707537124916552,652,The shade is what sold me
5553,667,9,37,94,140,1.3928571428571428,0.05139015923031591,652,Did you just call it a desserted island?
6540,667,17,32,119,168,1.3928571428571428,0.051382174997273176,652,It must be an uncharted dessert isle.
7316,667,14,27,99,140,1.3928571428571428,0.05616781178140433,652,Why didn't we swim to a desserted island?
5637,672,14,36,113,163,1.392638036809816,0.05032318698102726,652,"Pretty sweet view, eh, Doug? ... Sorry... that never gets old."
8766,673,12,29,94,135,1.3925925925925926,0.055734004907893625,652,"I don't blame you, I blame Spell Check."
8843,673,10,33,92,135,1.3925925925925926,0.053713710205552025,652,There they are - castaways from the Candy Cane mutiny.
3080,673,13,27,95,135,1.3925925925925926,0.056717172201958856,652,These sharks sure are crafty
6461,676,13,25,92,130,1.3923076923076922,0.058296380335191585,652,No it's not a mirage -- it's a meringue.
6322,677,15,30,108,153,1.392156862745098,0.05346225236948235,652,That’s all that remains of Big Rock Candy Mountain since the glaciers melted.
7717,677,12,36,105,153,1.392156862745098,0.05099229836359319,652,"According to plate tectonics, in 3 million years, we will be eating like kings."
3553,679,11,27,87,125,1.392,0.05780501150279887,652,Really?  Huh.  I see beautiful women.
9398,680,13,30,100,143,1.3916083916083917,0.05438966354318881,652,their cartoonist can’t spell
5225,681,10,34,94,138,1.391304347826087,0.052881411980661104,652,Glycemic Island--it's been off the charts for centuries.
9746,681,13,28,97,138,1.391304347826087,0.05580146325554012,652,These sharks get craftier every week.
7104,681,15,33,113,161,1.391304347826087,0.051509747798668876,652,I didn't know candy canes grew this far south.
6730,681,15,33,113,161,1.391304347826087,0.051509747798668876,652,"I know, but I bet the swim over there would burn at least a hundred calories."
2605,681,14,26,98,138,1.391304347826087,0.056741429522496084,652,I think we both deserve a cheat day.
2193,681,16,31,114,161,1.391304347826087,0.05225795508662071,652,I wonder what we look like to them.
1775,681,17,29,115,161,1.391304347826087,0.05299560001913426,652,Dessert Island. That's clever.
754,681,14,26,98,138,1.391304347826087,0.056741429522496084,652,I wish I were stranded on a dessert island.
483,681,10,34,94,138,1.391304347826087,0.052881411980661104,652,"If global warming were real, don't you think the icing would have melted?"""
4811,681,10,34,94,138,1.391304347826087,0.052881411980661104,652,I have a feeling any rescuers will visit there first.
6233,691,15,31,110,156,1.391025641025641,0.05269708208815067,652,I'm not swimming over there for half a donut.
9713,691,16,29,111,156,1.391025641025641,0.05347612033930736,652,It's only clickbait.
5297,693,13,26,94,133,1.3909774436090225,0.057313783048160157,652,We should have chosen that desserted island
3224,694,12,35,104,151,1.390728476821192,0.05144577284696166,652,At least we don't have to deal with the ants.
5984,694,13,33,105,151,1.390728476821192,0.05229691926463479,652,I guess spelling DOES matter....
7072,696,12,26,90,128,1.390625,0.05788510948931989,652,"Maybe we'll feel better if we face some 
 other direction."""
2044,697,13,40,116,169,1.3905325443786982,0.04829614928490381,652,It’s called ‘Temptation Island’
5695,698,9,39,98,146,1.3904109589041096,0.049915647004656935,652,"Yeah, the sweet life is always one island over."
6484,698,13,31,102,146,1.3904109589041096,0.053567388036488764,652,Do you think it's desserted?
9138,700,11,26,86,123,1.3902439024390243,0.058451001454495,652,"Well, before the ice caps melted, it was known as the Big Rock Candy Mountain."
2477,700,15,18,90,123,1.3902439024390243,0.06284615864420505,652,It's just another desserted island.
8068,702,12,31,98,141,1.3900709219858156,0.05399261614625772,652,"When the brochure said ""beach vacation with a sweet view"", this is not what I had in mind."
6398,702,14,27,100,141,1.3900709219858156,0.05583759346089843,652,paradise flossed
9075,702,14,27,100,141,1.3900709219858156,0.05583759346089843,652,"Those clever sharks are at it again."""
5152,702,10,35,96,141,1.3900709219858156,0.05208232284690933,652,At least we have a pretty sweet view.
3068,702,13,29,99,141,1.3900709219858156,0.05492285244696281,652,"That, my friend, is the difference between a desert island and a dessert island."
4726,702,16,23,102,141,1.3900709219858156,0.057623528950351555,652,We were so close to being on a desserted island
2186,702,12,31,98,141,1.3900709219858156,0.05399261614625772,652,You go ahead.  I never eat dessert.
759,702,9,37,95,141,1.3900709219858156,0.0511004034283094,652,Amazon Prime can deliver anything.
144,710,12,29,95,136,1.3897058823529411,0.055397940585318266,652,Bet they have WiFi.
218,710,11,31,94,136,1.3897058823529411,0.05440587614606362,652,You see candy?  I see a hamburger with legs...sitting beside me.
6298,710,11,31,94,136,1.3897058823529411,0.05440587614606362,652,It could be a trap.
8742,710,16,21,99,136,1.3897058823529411,0.05920018301144859,652,I told you that genie was wearing a hearing aid.
279,714,10,40,104,154,1.3896103896103895,0.04902208811136496,652,it's actually more of a dessert archipelago
9521,715,18,22,109,149,1.389261744966443,0.056910775183090304,652,"The pastries are vegan, but the sharks aren't."
5522,715,14,30,105,149,1.389261744966443,0.05362888629900334,652,I say we give Hansel one more day to swim back...
125,715,14,30,105,149,1.389261744966443,0.05362888629900334,652,I never thought I had to choose between starvation and diabetes.
1435,715,14,30,105,149,1.389261744966443,0.05362888629900334,652,We should have taken the good ship.
3412,719,13,39,115,167,1.3892215568862276,0.048682445272247986,652,"And I said, Mom, a day is never going to come where I regret not learning to swim....."
4479,719,13,39,115,167,1.3892215568862276,0.048682445272247986,652,And that’s the difference between desert and dessert
8361,721,10,43,109,162,1.3888888888888888,0.04735954134036387,652,I see a wonderful ilse covered with asian bowls of quinoa and kale salad with beets. Why what do you see?
3070,721,14,28,102,144,1.3888888888888888,0.05496971610201708,652,"Well, there goes another New Year's resolution"
5452,721,11,34,99,144,1.3888888888888888,0.052252219062553354,652,"Don't worry, the swim back will burn off all the calories."
4689,724,13,35,109,157,1.3885350318471337,0.0508378932223059,652,"Wait, how do you spell deserted?"
3451,725,13,28,98,139,1.3884892086330936,0.05547004042665255,652,"Damn autocorrect, I said dessert island not desert island."
8787,726,12,23,86,121,1.3884297520661157,0.06027016863078478,652,You have to admire the ingenuity of those man-eating sharks.
1903,727,16,34,120,170,1.388235294117647,0.05019158234882189,652,Mirage or real...it's still empty calories.
5564,728,10,32,92,134,1.3880597014925373,0.05392302372892542,652,Appetizers and main courses are on other islands.
4396,729,12,33,102,147,1.3877551020408163,0.05238597460816988,652,Looks like the big rock candy mountain has succumbed to climate change.
6884,729,8,41,98,147,1.3877551020408163,0.048698444484250286,652,So that's my hallucination. What's yours?
209,731,12,26,91,129,1.3875968992248062,0.057514404076556974,652,Now THAT’s a desserted island!
438,731,12,26,91,129,1.3875968992248062,0.057514404076556974,652,"That island looks like it would be 
a pretty sweet place to visit."
8502,733,18,26,116,160,1.3875,0.05392422764439029,652,Maybe eating Dave wasn't the best idea.
5248,734,16,23,103,142,1.3873239436619718,0.05728219426812654,652,They're coming for our coconut.
5476,735,13,34,108,155,1.3870967741935485,0.05128193000186983,652,It's either a mirage or a desserted island.
990,735,17,26,112,155,1.3870967741935485,0.054451676438491525,652,We have to die somehow.
3632,737,11,31,95,137,1.3868613138686132,0.05408215287509521,652,I prefer savory
4425,737,14,25,98,137,1.3868613138686132,0.05698162756952888,652,I'm fairly certain the sharks put it there.
5187,737,9,35,93,137,1.3868613138686132,0.0520595317467764,652,It's either a mirage or the sharks are smarter than we thought.
9790,737,14,25,98,137,1.3868613138686132,0.05698162756952888,652,For Jesus it would have been a cake walk...
7916,741,13,32,105,150,1.3866666666666667,0.052487703186855764,652,"And here we sit, a dentist and a nutritionist."
6329,742,12,39,112,163,1.3865030674846626,0.04870912088602549,652,and at night we have pie in the sky
6469,742,12,39,112,163,1.3865030674846626,0.04870912088602549,652,But Mom isn't here and I say we go straight to dessert.
9761,744,11,29,92,132,1.3863636363636365,0.05551655028152964,652,"You really must be more clear, Carl. I thought you said swim for the “desert” island."
4904,744,17,17,98,132,1.3863636363636365,0.06144957185518222,652,"So, when you wrote to the travel agent to book our vacation on ""The Desserted Island,"" I'm guessing you ran a spell check."
1819,746,15,26,104,145,1.3862068965517242,0.05552449918052616,652,The sharks are pulling out all the stops this time
5433,746,12,32,101,145,1.3862068965517242,0.05287356321839082,652,Autocorrect?
6554,748,16,29,113,158,1.3860759493670887,0.05291219479784319,652,Before global warming it was Big Rock Candy Mountain.
7722,748,12,37,109,158,1.3860759493670887,0.049771455051978476,652,"Well, I guess that casts some light on what happened to the Good Ship Lollipop."
659,750,12,25,90,127,1.3858267716535433,0.05814192077530715,652,You turned the oven off...right?
909,751,13,28,99,140,1.3857142857142857,0.05514226605075418,652,"Go ahead and try. If a shark doesn't get you, diabetes will."
1355,752,14,31,108,153,1.3856209150326797,0.05256098969103411,652,I 'm on a coconut cleanse. Don't let that stop you though.
5331,752,15,29,109,153,1.3856209150326797,0.053372810955640115,652,I always thought 'Desserted Island' was just poor spelling.
5536,752,14,31,108,153,1.3856209150326797,0.05256098969103411,652,It’s less refined over here.
518,755,18,28,120,166,1.3855421686746987,0.05244141751590758,652,And on the eighth day God made spell check.
2878,756,11,30,94,135,1.385185185185185,0.05462084515856414,652,If only we had something salty to go with it.
5648,756,13,26,96,135,1.385185185185185,0.05660877462781655,652,And you said you couldn’t imagine a more desserted island.
8175,756,18,16,101,135,1.385185185185185,0.06129718559959049,652,"and here I am,macarooned with you"
6488,759,14,29,105,148,1.385135135135135,0.05383239623510522,652,Desserted.
7788,759,11,35,102,148,1.385135135135135,0.05120684421385159,652,I'm saying it's fake news.
4807,759,12,33,103,148,1.385135135135135,0.052096732696963834,652,Of course it's real -- a mirage would have babes and booze.
5131,759,11,35,102,148,1.385135135135135,0.05120684421385159,652,"Well,I say the water is a mirage and the sweets are real."
1858,763,9,37,97,143,1.3846153846153846,0.050529625699053136,652,"You can open your eyes now, Happy Birthday!"
4089,763,11,28,91,130,1.3846153846153846,0.05609496099765123,652,Another vacation spoiled by autocorrect.
6071,763,18,24,114,156,1.3846153846153846,0.054916688884855104,652,I don't think the Professor and Mary Ann are going to come back.
1477,766,13,32,106,151,1.3841059602649006,0.05220178809309476,652,Desert/ dessert - such a fine line.
4702,766,8,42,101,151,1.3841059602649006,0.0477862488208021,652,But then I’ll need to brush my teeth.
4919,766,13,32,106,151,1.3841059602649006,0.05220178809309476,652,We'd be in paradise if that genie wasn't illiterate!
9980,769,13,27,98,138,1.3840579710144927,0.05569489637183892,652,"""I see it too, but there's no such thing as a dessert island."""
5113,769,12,29,97,138,1.3840579710144927,0.05473696154403239,652,Those sharks are very smart.
4766,771,9,30,86,125,1.384,0.05539768249490634,652,Do I have to spell it out for you?
5581,771,14,20,91,125,1.384,0.06094312525731703,652,I'm not going. It's just a typo.
9873,771,14,20,91,125,1.384,0.06094312525731703,652,"I was singing 'Big Rock Candy Mountain'when it appeared.
""How about trying 'Row, Row, Row your boat?"
681,774,14,28,104,146,1.3835616438356164,0.05434391956797605,652,That's one sweet island over there
4365,774,14,28,104,146,1.3835616438356164,0.05434391956797605,652,Beware the Island of Just Desserts
5934,774,14,28,104,146,1.3835616438356164,0.05434391956797605,652,Remember last week we thought we saw an island made entirely of brisket...
5401,777,18,15,100,133,1.3834586466165413,0.06198086243501657,652,I guess that’s what they call a “desserted” island.
4298,778,15,34,118,167,1.3832335329341316,0.05006058442369952,652,Not until after dinner.
3098,779,13,33,108,154,1.3831168831168832,0.051460341086106386,652,I'm in more of a salty mood.
7384,780,11,32,98,141,1.3829787234042554,0.052937590588097806,652,At least I'll never struggle again with the difference between desert and dessert
1148,780,14,26,101,141,1.3829787234042554,0.05573454821790714,652,It was a mountain before global warming.
9444,782,9,31,88,128,1.3828125,0.054476180581408136,652,"...Yeah, it hasn't moved, but it could still be a trap."
8555,783,12,38,112,162,1.382716049382716,0.04886237632725487,652,It's a mirage. Candy canes aren't in season.
2896,784,11,35,103,149,1.3825503355704698,0.05092765026053589,652,"Okay, now I just think we’re being messed with."
3019,784,15,27,107,149,1.3825503355704698,0.05437282820792275,652,"As an English major, I had no choice but to stay on this properly spelled deserted island."
7562,784,13,31,105,149,1.3825503355704698,0.05267841117757701,652,What would we do for shade?
7829,784,14,29,106,149,1.3825503355704698,0.05353232412067568,652,What three things would you bring?
3033,788,11,30,95,136,1.3823529411764706,0.05429165923475866,652,"Thank God, it's our Desserted island"
8218,789,14,32,111,157,1.3821656050955413,0.0515440441747169,652,"No, I’m pretty sure I booked the one with two ‘S’s."
2979,790,8,31,84,123,1.3821138211382114,0.05478603310453256,652,"The problem is if we swim over there we’ll have to wait half an hour before we can
go back"
8066,790,10,27,86,123,1.3821138211382114,0.05716703128535314,652,We can swim it off.
9730,792,15,25,104,144,1.3819444444444444,0.05574644264957661,652,Autocorrect didn't book the tickets. You did.
3994,792,14,27,103,144,1.3819444444444444,0.0548683950098546,652,"Well, shit."
2194,792,15,25,104,144,1.3819444444444444,0.05574644264957661,652,We could try.  The sharks around here don't have any teeth.
1517,792,10,35,99,144,1.3819444444444444,0.051205862774266864,652,I had envisioned the Spice Islands differently.
2786,796,10,30,91,131,1.381679389312977,0.054678922166789753,652,The lemon mirage pie is my favorite
3626,796,10,30,91,131,1.381679389312977,0.054678922166789753,652,I always hated Candyland when I was a kid. Now it doesn't look so bad.
1398,798,11,36,105,152,1.381578947368421,0.05021235016011432,652,"Well, SOMEONE planned ahead."
9144,798,15,28,109,152,1.381578947368421,0.05357082799028439,652,Ours is just desert.
9042,800,12,29,98,139,1.381294964028777,0.05441194088754569,652,Best mirage ever!
8427,800,9,35,95,139,1.381294964028777,0.05145741994585261,652,Do you want ants? 'Cuz I bet there are ants.
7377,800,12,29,98,139,1.381294964028777,0.05441194088754569,652,Happy birthday.
872,800,11,31,97,139,1.381294964028777,0.053445251394248806,652,On the other hand you have to admit those sharks are very clever.
566,800,13,27,99,139,1.381294964028777,0.055361753275208675,652,What a difference an s makes.
221,800,14,25,100,139,1.381294964028777,0.056295542809892074,652,Coconuts are nature's candy...coconuts are nature's candy...coconuts are nature's candy...
1457,800,16,21,102,139,1.381294964028777,0.05811812943799048,652,Do you think they have a Department of Foreign Eclairs?
2586,807,11,39,110,160,1.38125,0.04846047715316006,652,What’ll you bet they have salt water taffy?
3078,807,14,33,113,160,1.38125,0.05083568532552426,652,"Wreckage from the good ship Lollipop, I believe."""
4639,807,15,31,114,160,1.38125,0.051603132218083235,652,"As a dentist, I find karma to be a cruel mistress"""
8610,810,14,28,105,147,1.380952380952381,0.054036001119198276,652,Autocorrect. My bad.
1798,810,11,34,102,147,1.380952380952381,0.05138409809082317,652,"Remember, if we swim out there we have to wait 30 minutes before we can swim back."
6173,810,16,24,107,147,1.380952380952381,0.05573387961720504,652,I guess it’s just deserts.
9143,810,11,34,102,147,1.380952380952381,0.05138409809082317,652,"I told you desserted island wasn't a typo, Larry."
4880,814,13,33,109,155,1.3806451612903226,0.0511869731525752,652,‘’I told you a prayer for ‘eye candy’ might not be understood.”
8459,814,14,31,110,155,1.3806451612903226,0.051998975000319275,652,Dessert Island.  Who’d think one little ‘s’ would make such a big difference!
8839,814,13,33,109,155,1.3806451612903226,0.0511869731525752,652,Wouldn't you know it; I just brushed my teeth.
6756,817,13,25,96,134,1.3805970149253732,0.05684517807111144,652,I told you to book the one with two S's.
231,818,12,38,113,163,1.3803680981595092,0.04861841036409491,652,Just make sure you don't swim back for at least half an hour afterwards.
7297,819,13,28,101,142,1.380281690140845,0.05449745376534689,652,It’s probably covered in ants.
8179,820,11,24,86,121,1.3801652892561984,0.05898148183392898,652,"It’s tempting, but I bet the property taxes are insane.."
4300,821,18,29,124,171,1.3801169590643274,0.05122926394193354,652,At least my first shipwreck was in the Sandwhich Islands.
4679,822,14,29,107,150,1.38,0.05323536864034032,652,Damned if we do. Damned if we don’t.
1941,823,11,27,91,129,1.37984496124031,0.056326711741603176,652,These sharks are getting more and more clever.
4596,823,12,25,92,129,1.37984496124031,0.05739183292620483,652,I like it better before the takeover when they were the Sandwich Islands
1354,825,11,30,96,137,1.3795620437956204,0.053966127741985975,652,"Who knew that one ""s"" would make such a big difference?"
4572,825,10,32,95,137,1.3795620437956204,0.052962257660607456,652,I prefer this island for the more authentic castaway experience.
2553,827,14,27,104,145,1.3793103448275863,0.054552310230272565,652,I ‘m not going to candy-coat this for you Bill.  It’s a mirage and we’re doomed!
3291,827,14,27,104,145,1.3793103448275863,0.054552310230272565,652,It's desserted out here.
5334,827,11,33,101,145,1.3793103448275863,0.05185169456845958,652,Its a good thing you didn't bring the bag of weed.
6782,827,10,35,100,145,1.3793103448275863,0.050919669961693524,652,I wonder what they see when they look at us.
6638,831,11,36,106,153,1.3790849673202614,0.0499453915308128,652,"If the sharks don't get you, those empty carbs will!"
2854,831,11,36,106,153,1.3790849673202614,0.0499453915308128,652,What do you think? Mirage or meringue?
1629,831,15,28,110,153,1.3790849673202614,0.0532779446224064,652,You idiot!...and that was our last wish too.
825,831,17,24,112,153,1.3790849673202614,0.0548683698245101,652,Looks like we washed up on the wrong desserted island...
2060,831,14,30,109,153,1.3790849673202614,0.0524646554470979,652,It's a much more appealing mirage than Kale-Granola island.
114,836,14,33,114,161,1.3788819875776397,0.050574417356080204,652,Yeah. I see it too.
2855,836,13,35,113,161,1.3788819875776397,0.04980092307733052,652,I don't see any chocolate!  Forget it!
8603,838,11,28,93,132,1.378787878787879,0.055394097319540765,652,Oh...I thought you said dessert--ed island.
9439,839,9,35,96,140,1.3785714285714286,0.0511610892648344,652,Too bad it's not a cheat day.
9644,839,12,29,99,140,1.3785714285714286,0.054090496610040256,652,It's either a typo or a bad pun.
6716,839,15,23,102,140,1.3785714285714286,0.05686920601061,652,That typo cost us dessert island.
6386,839,8,37,95,140,1.3785714285714286,0.050146606384136753,652,"Next time, wish for a rescue boat."
5889,839,14,25,101,140,1.3785714285714286,0.055958302952809354,652,"It's likely a mirage, a spelling error, or perhaps both."
3900,839,10,33,97,140,1.3785714285714286,0.052155843178719304,652,"Well, the seafood entrees do get kind of repetitive, but the dessert cart is fabulous!"
1853,839,12,29,99,140,1.3785714285714286,0.054090496610040256,652,"Do you actually want ants? 
Because that's exactly how you get them."
2939,846,9,38,101,148,1.3783783783783783,0.04926878955611577,652,I’m so glad we ate the mushrooms
5703,846,13,30,105,148,1.3783783783783783,0.0528689727321589,652,I think it looks tacky.
8531,846,13,30,105,148,1.3783783783783783,0.0528689727321589,652,I think your second wish should definitely be learning how to swim.
9062,846,12,32,104,148,1.3783783783783783,0.0519923034149914,652,"You know the rules - no dinner, no dessert."
4868,850,15,32,117,164,1.3780487804878048,0.050643389900965695,652,I'd rather have a sub.
9959,851,10,31,94,135,1.3777777777777778,0.053476866008430754,652,"Wow...yours is good, but mine has wine and women."
6012,851,13,25,97,135,1.3777777777777778,0.05649292129660394,652,Imagine for a second you're no longer a nutritionist.
4363,851,13,25,97,135,1.3777777777777778,0.05649292129660394,652,I sure hope they're not looking at us the same way.
1228,851,7,37,91,135,1.3777777777777778,0.05028021717875756,652,Henry hasn't come back for 5 weeks......ya still think it's mirage?
491,851,13,25,97,135,1.3777777777777778,0.05649292129660394,652,Now that's what I'd call a desserted island.
1677,851,9,33,93,135,1.3777777777777778,0.05243297510698886,652,Why couldn’t we have washed up on the dessert island?
4004,857,14,26,103,143,1.3776223776223777,0.055081751876245824,652,Why couldn’t we have landed on that dessert island?
5368,857,12,30,101,143,1.3776223776223777,0.053263620579878344,652,That darn shark gets more clever every day.
7364,859,19,19,113,151,1.3774834437086092,0.05695877588651705,652,I understand Shirley Temple was shipwrecked there.
9702,859,11,35,105,151,1.3774834437086092,0.05037757819195025,652,"It's desserted, Gilligan."
7058,859,13,31,107,151,1.3774834437086092,0.052100871643257225,652,I knew we were in trouble once we crossed the Tropic of Candycorn.
6347,859,12,33,106,151,1.3774834437086092,0.05124646919775657,652,I bet my hallucination is better than yours.
6214,859,18,21,112,151,1.3774834437086092,0.05617830479589006,652,"Wow! 
A desserted island!"
261,859,10,37,104,151,1.3774834437086092,0.04949343556205721,652,I'm really more of a meat and potato guy.
6656,865,16,28,115,159,1.3773584905660377,0.05254394916319507,652,This feels just like the Mueller Report.
1326,866,15,33,119,167,1.377245508982036,0.049974213440762236,652,It's not all bad. At least our island has a sweet view.
502,867,18,30,127,175,1.3771428571428572,0.05032197528258013,652,I would have preferred being stranded on the dessert island.
9516,868,11,27,92,130,1.376923076923077,0.05596807231014705,652,"Well, it certainly has carb appeal."
7895,869,14,24,100,138,1.3768115942028984,0.056524858390548646,652,You can’t seriously believe the four of us are imagining this.
7268,869,8,36,94,138,1.3768115942028984,0.05059980710723712,652,"That's the difference between us, Doug. 
You see dessert. I see an obesity epidemic."
3548,869,13,26,99,138,1.3768115942028984,0.0555812296848008,652,I thought the brochure said 'desert' island.
4709,869,8,36,94,138,1.3768115942028984,0.05059980710723712,652,Expedia said Island Paradise with the Sweetest View.
167,873,15,25,106,146,1.3767123287671232,0.05510363916743573,652,"I know it looks good to you now, but those are empty calories."
3137,873,14,27,105,146,1.3767123287671232,0.05423963254120916,652,The sharks are getting a little too savvy for my liking.
3314,873,9,37,100,146,1.3767123287671232,0.049694780226474417,652,Got Milk?
7318,873,14,27,105,146,1.3767123287671232,0.05423963254120916,652,What makes you think it's deserted?
3578,877,14,30,110,154,1.3766233766233766,0.05218095654824626,652,The sharks are getting really creative
5209,878,11,22,84,117,1.376068376068376,0.060363492379704495,652,"What is this, a New Yorker cartoon?"
9092,879,11,25,89,125,1.376,0.057545493924092285,652,Man... do you know what they put IN that crap?
4486,879,11,25,89,125,1.376,0.057545493924092285,652,"Well, that's just desserts."
385,881,12,26,95,133,1.3759398496240602,0.056074909780405954,652,What would Hansel and Gretel do?
2339,881,13,24,96,133,1.3759398496240602,0.05708166670160755,652,"We could do worse, the island behind us is made of broccoli."
3819,883,11,31,99,141,1.375886524822695,0.05282208778219166,652,"Well, I guess it's a desserted island."
8829,883,13,27,101,141,1.375886524822695,0.05470655539199117,652,I finally understand the distinction between 'desert' and 'dessert'.
1008,885,14,28,107,149,1.3758389261744965,0.05342989160052856,652,Let's call it Desserted Island.
2177,885,12,32,105,149,1.3758389261744965,0.051704582710914736,652,"Any way you look at it, it’s still a desserted island."
3581,885,10,36,103,149,1.3758389261744965,0.0499196797883902,652,"Sure,but then you'd have to wait 30 minutes before you swim back."
4846,888,14,31,112,157,1.375796178343949,0.051448091821945596,652,Remember we have the better view.
5844,888,12,35,110,157,1.375796178343949,0.049835604917198816,652,"No Way! Remember ""Hansel and Gretel""?"
9091,888,11,37,109,157,1.375796178343949,0.049009470514738515,652,I knew not taking those swimming lessons would come back to haunt us.
48,891,14,34,117,165,1.3757575757575757,0.04964881484323074,652,Must be a typo.
545,892,12,41,120,173,1.3757225433526012,0.04658596938373756,652,At least we're on the healthy island.
7592,893,14,32,114,160,1.375,0.050741359211112926,652,"Sooo, what does your mirage have on it today?"
5141,893,9,39,104,152,1.375,0.04833629795036935,652,Couldn't you have wished for a boat?
4998,893,13,28,103,144,1.375,0.05386661560384388,652,"So, is it d-e-s-e-r-t isle or d-e-s-s-e-r-t isle?"
4893,893,13,28,103,144,1.375,0.05386661560384388,652,Ooh look! A desserted island.
9250,893,12,30,102,144,1.375,0.05295740910852021,652,The sharks are getting creative.
1774,893,13,31,108,152,1.375,0.05181651476613981,652,First time at weightwatchers?
1095,893,14,20,94,128,1.375,0.05973201307361716,652,"Those sharks are clever devils...good bakers, too."
4516,893,10,34,100,144,1.375,0.051090478420513785,652,It probably doesn’t taste as good as it looks.
1363,893,10,28,90,128,1.375,0.05545978183850711,652,"A dessert island, of course."
4048,902,14,30,111,155,1.3741935483870968,0.051900122489589265,652,"Ok , if we did know how to swim, what would you eat first?"
5161,902,9,40,106,155,1.3741935483870968,0.047693676851627814,652,We should have wished for a bridge as well.
2146,904,12,31,104,147,1.3741496598639455,0.052173774313312785,652,We're screwed. Nobody's ever found in the Toblerone Triangle.
3008,904,13,29,105,147,1.3741496598639455,0.05305931290746281,652,Finally UberEats has arrived
3119,904,12,31,104,147,1.3741496598639455,0.052173774313312785,652,I told them to drop us off at the dessert island.
10003,904,13,29,105,147,1.3741496598639455,0.05305931290746281,652,"I would not object if you were to lay off the ""Dessert Island"" jokes."
2573,908,11,30,98,139,1.3741007194244603,0.053325820515611654,652,And you chose the DESERT island!
5899,908,12,28,99,139,1.3741007194244603,0.05429463645903287,652,Want to swim over to the desserted island?
5110,908,11,30,98,139,1.3741007194244603,0.053325820515611654,652,"Go if you must, but it's probably baking over there."
490,908,12,28,99,139,1.3741007194244603,0.05429463645903287,652,That was Big Rock Candy Mountain before the glaciers melted.
5083,908,14,24,101,139,1.3741007194244603,0.0561821713475829,652,It's called 'Diabetes Island.' No one's ever returned.
3510,913,12,25,94,131,1.3740458015267176,0.056659689018477954,652,What level of Candy Crush do you think that is?
4843,913,7,35,89,131,1.3740458015267176,0.05121641630560584,652,But ours is in good taste...
7034,913,11,27,93,131,1.3740458015267176,0.05561367230793459,652,"Every time I go on a diet, something like this happens - every time!"
6209,916,15,35,124,174,1.3735632183908046,0.048469496596781514,652,"No, that’s Confectionary Cay. Dessert island is just a common spelling error."
4573,917,11,40,115,166,1.3734939759036144,0.04713143108432074,652,*This* is why spelling is important.
9842,918,16,27,115,158,1.3734177215189873,0.052728639068236716,652,"Dude, I am taking my chances with the sharks if you sing The Candy Man one more time"
5489,918,11,37,110,158,1.3734177215189873,0.04875634422894257,652,We can only get there on the Good Ship Lollipop.
5571,918,14,31,113,158,1.3734177215189873,0.05117673365721463,652,Sometimes I just think everything is out of reach
1037,921,9,38,103,150,1.3733333333333333,0.048739518271239124,652,"I understand, but common sense suggests we wait and see if it’s still there tomorrow."
1772,921,11,34,105,150,1.3733333333333333,0.05054217603683485,652,That’s strange.  I see three candy canes.
3305,921,13,30,107,150,1.3733333333333333,0.0522827167978516,652,"But if you were over there, you'd be wanting coconut water."
5647,921,8,40,102,150,1.3733333333333333,0.04781270942646397,652,Just remember to wait thirty minutes before swimming back.
9718,921,14,28,108,150,1.3733333333333333,0.0531316095594452,652,"One has two esses, one has two asses."
6122,926,8,37,97,142,1.3732394366197183,0.049580353572270544,652,"Sure, it seems better, but do you know what they pay in property taxes??"
4952,926,10,33,99,142,1.3732394366197183,0.05155571454344759,652,"Okay, we’ll go there. 
But only on a special occasion."
729,926,13,27,102,142,1.3732394366197183,0.05438439173776417,652,Can't believe this is all that's left of the food pyramid.
1577,926,9,35,98,142,1.3732394366197183,0.05057767868554672,652,"Yeah, but no shade."
2426,930,12,26,96,134,1.373134328358209,0.05572553436470314,652,Since when did Mary Ann and Ginger learn how to bake?
7961,930,10,30,94,134,1.373134328358209,0.0536739553132021,652,No we are not near the sandwich islands.
5449,932,13,21,92,126,1.373015873015873,0.05934470408339976,652,That’s where we’d be if we weren’t such good spellers.
3144,933,8,44,109,161,1.3726708074534162,0.045632099359511485,652,It's either a mirage or a simple spelling mistake.
6470,933,9,42,110,161,1.3726708074534162,0.046475028171149325,652,My sweet tooth fell out months ago.
5827,935,11,35,107,153,1.3725490196078431,0.04983836355701619,652,You really chose this place because of the shade?
3173,935,12,33,108,153,1.3725490196078431,0.050693804296450505,652,I guess that’s the desserted island
9333,935,13,31,109,153,1.3725490196078431,0.05153504735665164,652,"Well, this takes the cake."
9602,938,12,30,103,145,1.3724137931034484,0.05265446860251198,652,And you thought our island was desserted.
8821,938,6,42,97,145,1.3724137931034484,0.04688049082651288,652,I bet THEY wish they had a palm tree.
4401,938,15,24,106,145,1.3724137931034484,0.05531590535869408,652,You had to choose the gluten free island didn't you!
2332,938,12,30,103,145,1.3724137931034484,0.05265446860251198,652,Dessert Island.
5793,942,13,25,99,137,1.3722627737226278,0.055800605027869335,652,"If we were over there, instead of being marooned in a desert island we could be macarooned on a dessert island"
8374,942,15,21,101,137,1.3722627737226278,0.05769221728611084,652,"IF YOU'RE SO SURE THE SHARK'S NOT UP TO SOMETHING, THEN  YOU GO FIRST."
9375,942,8,35,94,137,1.3722627737226278,0.05076412598181319,652,Tell me again why you can't swim over and bring me back the doughnut?
2604,945,14,20,95,129,1.372093023255814,0.059338414311607995,652,Let's go someplace else for dessert.
4432,945,7,34,88,129,1.372093023255814,0.05170279679051976,652,Do you think they have delivery service?
1585,947,14,33,117,164,1.3719512195121952,0.049805463095810014,652,I wonder what being stranded on a dessert island is like?
9287,948,15,28,113,156,1.3717948717948718,0.05241713198204591,652,And you SWEAR that wasn’t there yesterday?
5804,948,14,30,112,156,1.3717948717948718,0.05162211482770178,652,"Well, I'm not falling for it, are you?"
4495,948,13,32,111,156,1.3717948717948718,0.050814660811085176,652,That's how you get ants.
4073,948,12,34,110,156,1.3717948717948718,0.04999416733386849,652,"Before climate change, they called it Candy Land."
2057,948,12,34,110,156,1.3717948717948718,0.04999416733386849,652,"Yeah, but we've got coconuts!"
1332,953,14,27,107,148,1.3716216216216217,0.053624302869047555,652,"Bummer! You can't swim, and I'm diabetic!"
6584,953,11,33,104,148,1.3716216216216217,0.0509880365195566,652,I've thought of moving but it's just so affordable here.
1006,955,10,32,98,140,1.3714285714285714,0.052032538976282044,652,gentrification
1503,955,10,32,98,140,1.3714285714285714,0.052032538976282044,652,Man those shrooms you grew were good.
4662,955,11,30,99,140,1.3714285714285714,0.053010942599024946,652,Mirages are not exclusively a desert phenomenon; they can also be a dessert phenomenon.
5530,955,10,32,98,140,1.3714285714285714,0.052032538976282044,652,Ready to head back?
7583,955,16,20,104,140,1.3714285714285714,0.05765444171814654,652,Only the grammatically challenged are lucky enough to land on a dessert island.
2013,960,10,29,93,132,1.371212121212121,0.054206900337663004,652,Wait a good 30 minutes before swimming back.
9429,961,13,33,113,159,1.371069182389937,0.050120036725075263,652,"No, that's fine, go ahead. I just didn't think you'd break your New Year's resolution this quickly."
2205,962,12,32,107,151,1.3708609271523178,0.05113795050091042,652,We really are desserted.
4414,962,10,36,105,151,1.3708609271523178,0.04938106458889338,652,"I'm pretty sure it's a mirage.  I mean, who in their right mind would leave cheesecake out in this heat"
6864,962,11,34,106,151,1.3708609271523178,0.050267183735345784,652,I'm really more in the mood for savory.
392,965,8,37,98,143,1.3706293706293706,0.04930155499535766,652,Still think you were right to steer our last piece of driftwood to the island with all the kale?
7033,965,10,33,100,143,1.3706293706293706,0.05126040808888811,652,Who knew 5th grade spelling was so important?
7040,965,11,31,101,143,1.3706293706293706,0.05221228297708195,652,"""Yes, but OUR island is gluten free!"""
9344,965,8,37,98,143,1.3706293706293706,0.04930155499535766,652,"Yeah but, we'll have to wait thirty minutes to swim back dude."
7768,969,9,32,94,135,1.3703703703703705,0.05230004512250975,652,It was the site of the wreck of the good ship Lollipop.
6768,970,11,35,108,154,1.37012987012987,0.049572742630662185,652,You can always tell when the Carnival Cruise ship is about to arrive
6747,970,10,37,107,154,1.37012987012987,0.0487090789699647,652,"""Can I bring you back anything?"""
4481,970,13,31,110,154,1.37012987012987,0.051256430694822094,652,That's the kind of mistake that a spell checker will not catch.
588,970,10,37,107,154,1.37012987012987,0.0487090789699647,652,Look! An uncharted dessert island!
3403,970,11,35,108,154,1.37012987012987,0.049572742630662185,652,What would Oprah do?
3315,970,14,29,111,154,1.37012987012987,0.05207786598351275,652,The sharks are becoming more creative.
3783,970,12,33,109,154,1.37012987012987,0.05042161490620353,652,"Ed, who can't swim a stroke, and Jason, who is diabetic, can only sit and ponder what might have been."
9551,977,13,21,93,127,1.3700787401574803,0.05894878566069909,652,Seems like a cruel joke to place Desserted Island so close to Deserted Island.
6125,977,12,23,92,127,1.3700787401574803,0.057878968148353874,652,"Sure, it looks less like a flying saucer with all that on top, but it's still them, Thomas, and we won't fall for it."
6282,979,16,22,108,146,1.36986301369863,0.05584723294402933,652,If only we weren't dentists.
5070,979,11,32,103,146,1.36986301369863,0.05144460001843606,652,"So, there were survivors from the Good Ship Lollipop after all."
3433,981,15,31,119,165,1.3696969696969696,0.05029421377959393,652,"You're right, a dessert island would have been better."
240,982,10,31,97,138,1.3695652173913044,0.05252141056067068,652,Where's a chute or ladder when you need one?
3313,982,12,27,99,138,1.3695652173913044,0.05449836339631238,652,"Go ahead if you want,but it never tastes as good as it looks."
8511,982,9,33,96,138,1.3695652173913044,0.05150448567343949,652,"Spelling matters, honey.  Desert island, dessert island.  Big difference”."
8765,982,10,31,97,138,1.3695652173913044,0.05252141056067068,652,"Rats! I asked the cartoonist to put us on the dessert island. Turns out he can draw, but he can’t spell."
9074,982,10,31,97,138,1.3695652173913044,0.05252141056067068,652,"Now THAT, is one desserted island."
6313,987,13,32,112,157,1.3694267515923566,0.05054546838229031,652,If only we washed up on a desserted isle
7305,987,10,38,109,157,1.3694267515923566,0.04806106971344674,652,Why didn't you book the all inclusive?
3687,989,12,24,94,130,1.3692307692307693,0.05689067394719416,652,"Before global warming sea level rise, that was Big Rock Candy mountain."
3370,989,12,24,94,130,1.3692307692307693,0.05689067394719416,652,"'Take one last look...we're out of peyote buttons."""
234,991,13,29,107,149,1.3691275167785235,0.05246421157468863,652,Are you kidding? We need a Banana Boat.
1283,991,14,27,108,149,1.3691275167785235,0.053321554907193924,652,Our mirages have really upped their game
2485,991,17,21,111,149,1.3691275167785235,0.055814625166012814,652,You do realize it's just a typo.
5051,991,9,37,103,149,1.3691275167785235,0.048884707321256125,652,For my second wish I want a row boat
6695,991,8,39,102,149,1.3691275167785235,0.04794809577363493,652,"Desert, dessert ... I should have been more specific."
1612,996,15,22,104,141,1.3687943262411348,0.05641371595000448,652,That must be the south beach diet.
8037,997,12,35,113,160,1.36875,0.049065059972070675,652,"You should never have wished me ""sweet dreams."""
5299,998,10,36,106,152,1.368421052631579,0.04911575245199942,652,Everything looks perfect from far away.
5284,998,12,32,108,152,1.368421052631579,0.05085896076806368,652,But we have a tree.
2407,998,13,30,109,152,1.368421052631579,0.05170853185063483,652,Maybe when we retire.
1128,998,8,40,104,152,1.368421052631579,0.04730835430919929,652,Are you hallucinating what I'm hallucinating?
3874,1002,12,36,115,163,1.3680981595092025,0.048422087621480696,652,Seems excessive.
6978,1002,12,36,115,163,1.3680981595092025,0.048422087621480696,652,The sharks are messing with us again. Remember Pete?
1603,1004,13,27,104,144,1.3680555555555556,0.05375066882887194,652,"Desert island, dessert island -- we missed it by that much!"
1973,1004,9,35,100,144,1.3680555555555556,0.05000633970858772,652,We’re on Weight Watchers Island
4162,1006,11,24,90,125,1.368,0.057401809570217247,652,"Yeah, desert island and dessert island, ha-ha, I get it. But now I’m expecting a voice-over encouraging us to switch auto insurance."
7880,1006,11,24,90,125,1.368,0.057401809570217247,652,"So, I misspelled, “dessert”.  How did you get here?"
9671,1008,13,31,111,155,1.367741935483871,0.05098062656312006,652,Looks like we're getting our just desserts.
8383,1008,9,39,107,155,1.367741935483871,0.047580201371188055,652,"I would, but I finally made it back to my high school weight."
2382,1010,9,32,95,136,1.3676470588235294,0.051985442416579174,652,I think it's a trap.
3267,1010,9,32,95,136,1.3676470588235294,0.051985442416579174,652,One more dessert island joke and I'm going to kill you.
8491,1010,9,32,95,136,1.3676470588235294,0.051985442416579174,652,But we'll swim off the calories on our way back.
5660,1013,16,29,121,166,1.3674698795180722,0.050764271108986056,652,I'm pretty sure it's a misspelling.
7615,1013,16,29,121,166,1.3674698795180722,0.050764271108986056,652,"If you sing ""Big Rock Candy Mountain"" one more time, I'll kill you."
3216,1015,14,26,107,147,1.3673469387755102,0.053818527887705574,652,The swim should offset the calories.
366,1015,9,36,102,147,1.3673469387755102,0.04930004202251735,652,"I don't have to out swim the shark, I just have to out swim you"
1039,1015,10,34,103,147,1.3673469387755102,0.050236262834107495,652,Damn. Big Sugar is everywhere!
6314,1015,14,26,107,147,1.3673469387755102,0.053818527887705574,652,It happens when a mapmaker misspells desert island.
8399,1019,11,25,92,128,1.3671875,0.05641772211679966,652,Legend says it was the wreck of the Good Ship Lollipop.
181,1020,10,31,98,139,1.3669064748201438,0.052209930592511375,652,I feel like we're not thinking big enough with our prayers.
2771,1021,13,29,108,150,1.3666666666666667,0.052171346217484815,652,Don't go Hansel!
9298,1021,10,35,105,150,1.3666666666666667,0.049531737202582964,652,"I can't swim and you're a diabetic, so let's change the subject..."
487,1023,10,39,112,161,1.3664596273291925,0.04719577386743793,652,"Aw, you remembered my birthday."
3518,1023,17,25,119,161,1.3664596273291925,0.05263952252648101,652,But I DID type in ‘dessert island!’!
6174,1025,11,26,94,131,1.366412213740458,0.055476483906383864,652,"I tried to tell you. It's location, location, location."
9940,1026,12,28,102,142,1.3661971830985915,0.053336273679782054,652,"Tempting, yes, but what do we do when our pants don't fit anymore?"
9142,1026,14,24,104,142,1.3661971830985915,0.05517733530879055,652,"If I were seeing a mirage, that's not what I would see"
8614,1026,7,38,97,142,1.3661971830985915,0.04842837479938162,652,What would be the point? We have no milk.
8308,1026,12,28,102,142,1.3661971830985915,0.053336273679782054,652,"Funny the difference an ""s"" makes..."
4869,1026,13,26,103,142,1.3661971830985915,0.05426461287903617,652,That must be the Dessert Isle.
2213,1026,11,30,101,142,1.3661971830985915,0.052391487564083974,652,We really whiffed the landing on this one
1659,1032,13,30,110,153,1.3660130718954249,0.05142586281163292,652,It's like Candy Land and Fantasy Island had a baby.
3102,1032,18,20,115,153,1.3660130718954249,0.05544921934480602,652,The shark can't eat BOTH of us!
3241,1032,9,38,106,153,1.3660130718954249,0.04796480082204944,652,I imagined the same thing my first week here.
8340,1032,15,26,112,153,1.3660130718954249,0.05307181916923423,652,I told you if anyone can the candyman can
8892,1032,12,32,109,153,1.3660130718954249,0.05058280393488865,652,"Oh, I know it is a mirage...but so is 'democratic socialism'..."
9410,1037,14,32,118,164,1.3658536585365855,0.04970689959570512,652,Why am I not enough?
5481,1037,9,42,113,164,1.3658536585365855,0.04578965354729526,652,Yesterday it was a blonde.
1844,1037,12,36,116,164,1.3658536585365855,0.04817823646879406,652,"Since we have no idea what day it is,can today be our ""cheat"" day?"
1204,1040,11,27,96,134,1.3656716417910448,0.054575256494976465,652,I just thought of a really sweet spot for our next vacation
2985,1040,12,25,97,134,1.3656716417910448,0.05559387980818139,652,"No, the Mirage is a big hotel in the middle of Las Vegas. That is an island covered with candy!"
3612,1040,9,31,94,134,1.3656716417910448,0.052478728264167905,652,And you thought it was important to pick the island with shade!
6749,1040,12,25,97,134,1.3656716417910448,0.05559387980818139,652,I saw the sharks setting it up last night
6833,1040,11,27,96,134,1.3656716417910448,0.054575256494976465,652,I really wasted that genie wish.
9310,1045,14,25,106,145,1.3655172413793104,0.05432782665791481,652,But do they understand the cavity of their situation?
9270,1045,15,23,107,145,1.3655172413793104,0.0552023386278649,652,"I wished to be on a desserted island, what'd you wish for?"
807,1045,11,31,103,145,1.3655172413793104,0.05161546694096023,652,If only we hadn't gotten shipwrecked during Lent.
8648,1045,8,37,100,145,1.3655172413793104,0.04875243692057124,652,I don't want to ruin my dinner.
5048,1049,13,31,112,156,1.3653846153846154,0.05070759724789727,652,"My ex told me that it will end with me getting my just deserts!"", but this is cruel"
9502,1049,9,39,108,156,1.3653846153846154,0.047332953371829536,652,I'm heading over there on my 'cheat' day
2706,1051,15,31,121,167,1.3652694610778444,0.04978800845395368,652,"The question, as I see it, is do we want to die of starvation or diabetes?"
3859,1052,10,26,90,126,1.3650793650793651,0.0558946567036794,652,This is the year we learn how to swim!
7746,1053,11,28,98,137,1.364963503649635,0.053711448983492366,652,"Either it's a mirage, or there's an old lady over there waiting to push us into her oven. Either way, I say we stay put."
1769,1053,12,26,99,137,1.364963503649635,0.054701571813450464,652,Who knew spelling mattered in making a wish
3638,1053,13,24,100,137,1.364963503649635,0.05567408881892773,652,Thats a real dessert Island
8338,1053,12,26,99,137,1.364963503649635,0.054701571813450464,652,I'm confused--which is a desert island and which is a dessert island?
8706,1057,7,40,101,148,1.364864864864865,0.04711637711193173,652,"We're deserted, their desserted."
5959,1057,12,30,106,148,1.364864864864865,0.0517648172887719,652,Looks like another desserted island.
3547,1059,9,40,110,159,1.3647798742138364,0.04672319950355791,652,"Next, we'll see the Good Ship Lollypop sail by."
6631,1059,13,32,114,159,1.3647798742138364,0.05001503129509474,652,That must be a desserted island!
4983,1061,10,23,85,118,1.3644067796610169,0.058551314627692606,652,I hate being in the cartoon that people are not supposed to get.
6467,1062,15,17,97,129,1.3643410852713178,0.06021801526468739,652,And that's the desert island for poor spellers.
793,1063,13,25,102,140,1.3642857142857143,0.054791686496380124,652,"It's a nice place to visit, but I wouldn't want to live there."
1652,1063,18,15,107,140,1.3642857142857143,0.05929589803444791,652,Jenny Craig’s private island; that two-face bitch.
6026,1063,12,27,101,140,1.3642857142857143,0.05384564964970519,652,There has got to be a catch
8586,1063,8,35,97,140,1.3642857142857143,0.04988240465859244,652,We must have capsized after the Sandwich Islands.
9992,1067,8,39,104,151,1.3642384105960266,0.04743620668808226,652,It can't hurt just to look.
6843,1067,14,27,110,151,1.3642384105960266,0.05272565816998183,652,"You know, we would probably burn off the calories during the swim"""
2309,1067,9,37,105,151,1.3642384105960266,0.04835797685702962,652,Our just desserts.
4332,1067,14,27,110,151,1.3642384105960266,0.05272565816998183,652,Do you think that island is desserted?
4714,1071,15,29,118,162,1.3641975308641976,0.05087696000539037,652,We could swim or wait for the next Sugar Plum Ferry...
1887,1072,9,30,93,132,1.3636363636363635,0.05298484552470894,652,It can be our cheat day.
2636,1072,12,32,110,154,1.3636363636363635,0.050309442097831336,652,Dessert island. Those sharks are pretty clever.
3021,1072,13,30,111,154,1.3636363636363635,0.05114608882425574,652,I'm more in the mood for a salad.
4370,1072,13,26,104,143,1.3636363636363635,0.05394462082699332,652,Well we've stripped this one of all vegetation.  Room for dessert?
6210,1076,15,27,115,157,1.3630573248407643,0.052031148601533767,652,But think of the calories we'd burn swimming to it.
3247,1076,10,37,110,157,1.3630573248407643,0.047947302720323624,652,"Yeah, but think of the calories you'll burn swimming there and back"
535,1076,16,25,116,157,1.3630573248407643,0.05281003448325892,652,You seriously want to wait for your cheat day?
4832,1076,11,35,111,157,1.3630573248407643,0.04879142502000183,652,At least we have company. That one is completely desserted.
462,1080,11,31,104,146,1.3630136986301369,0.05132181661148059,652,I didn't think I had to spell it out when I said row for the desserted island.
1643,1080,10,33,103,146,1.3630136986301369,0.05039301091434093,652,Why couldn't we land on a dessert-ed island?
1992,1080,11,31,104,146,1.3630136986301369,0.05132181661148059,652,"I don't know about you, but I say screw the American Dental Association recommendations."
2223,1080,13,27,106,146,1.3630136986301369,0.053130739528841175,652,Swe-e-eet!
7799,1080,13,27,106,146,1.3630136986301369,0.053130739528841175,652,"Now that, my son, shows you the power of delusional thinking!"
7933,1080,10,33,103,146,1.3630136986301369,0.05039301091434093,652,"Well, the upside is that we have a really sweet view."
8244,1080,13,27,106,146,1.3630136986301369,0.053130739528841175,652,I've been over there. It's all plastic.
453,1087,13,23,99,135,1.362962962962963,0.05623866008896599,652,"It isn't about 'yielding to temptation', I can't swim."
5989,1087,9,31,95,135,1.362962962962963,0.052158926470433443,652,"Okay, if we use the cupcake paper as a boat 
and the candy canes as oars..."
6274,1087,7,35,93,135,1.362962962962963,0.04999436939817319,652,"Don't let it fool you - I'll bet from over there, this place will look pretty good, too."
6530,1087,11,27,97,135,1.362962962962963,0.05423716668093172,652,It would have shortened our life expectancy from a week to 5 days.
9532,1087,15,19,101,135,1.362962962962963,0.05817132908597966,652,"I know it's just desserts, but I personally find it cruel and unusual."
2456,1092,18,26,127,171,1.3625730994152048,0.050969435061620674,652,"You see a mirage? No, I see meringue."
3501,1093,10,38,112,160,1.3625,0.04732423621500229,652,We finally discovered where the Good Ship Lollipop ran aground.
230,1093,11,36,113,160,1.3625,0.04814768619087102,652,"Not to spoil the surprise or anything, but when you say you’ll take me somewhere special for my birthday, I think I know where it is."
7238,1093,14,30,116,160,1.3625,0.05053759731267767,652,I guess that is the dessert island.
9121,1096,14,26,109,149,1.3624161073825503,0.05320727797577198,652,I always pick the wrong aisle.
6744,1096,15,24,110,149,1.3624161073825503,0.05405283666153216,652,"Desert island, dessert  island? It’s only a matter of taste."
1801,1096,12,30,107,149,1.3624161073825503,0.051474508122532465,652,"Boy what a difference another ""s"" makes, huh?"
6434,1096,12,30,107,149,1.3624161073825503,0.051474508122532465,652,Next time check the spelling before you book the trip.
173,1100,13,24,101,138,1.3623188405797102,0.055332419150681204,652,Anyone who says sharks haven’t evolved hasn’t seen their marketing.
731,1100,12,26,100,138,1.3623188405797102,0.05436809805639403,652,"I'm hungry too, but there must be a reason why it was left desserted."
3494,1100,13,24,101,138,1.3623188405797102,0.055332419150681204,652,"How many times have we been over this? 'Dessert' island, not 'desert' island"
4210,1100,7,36,95,138,1.3623188405797102,0.04926416011955038,652,Next time let's go to the desserted island.
8070,1100,7,36,95,138,1.3623188405797102,0.04926416011955038,652,"Well...for your next mirage, how about something with a bit more protein."
8362,1100,7,36,95,138,1.3623188405797102,0.04926416011955038,652,"She was a good ship, the Lollipop."
9697,1100,11,28,99,138,1.3623188405797102,0.0533863612121362,652,It must be Palm Sundae.
9964,1100,10,30,98,138,1.3623188405797102,0.05238622949474112,652,What luck. You can’t swim and I’m a diabetic!
6134,1108,7,32,88,127,1.3622047244094488,0.0520415495250018,652,This is all tied in with our inability to make good choices
1186,1108,10,26,91,127,1.3622047244094488,0.05552725463969795,652,"No, no. We are on the desert island. That is the dessert island."
2087,1108,12,22,93,127,1.3622047244094488,0.05773425986126105,652,"Knowing what happened to the Good Ship Lollipop and not being able to tell anybody is just a really special type of torture, ain't it Jimmy?"
2519,1111,10,39,114,163,1.361963190184049,0.04672253439180312,652,"Yeah, but we've got a tree."
3365,1111,15,29,119,163,1.361963190184049,0.05061321003639147,652,"If you knew how to spell, this never would have happened."
4781,1113,14,27,111,152,1.361842105263158,0.05243241770831817,652,"Dude, did you ever do acid?"
4954,1113,13,29,110,152,1.361842105263158,0.051594767670752044,652,"There’s no room, no shade and a lot of empty calories."
5317,1115,12,27,102,141,1.3617021276595744,0.05352479161656629,652,"It's not the calories that will kill you, it's the mirage."
1861,1115,13,25,103,141,1.3617021276595744,0.054463019014654,652,Why couldn’t we have landed on the dessert island instead of the desert island?
4615,1117,12,36,118,166,1.3614457831325302,0.04769734394747745,652,These islands all look better from a distance.
1000,1118,9,25,85,119,1.361344537815126,0.05689979051881099,652,"Desert island, dessert island...what difference does it make?"
703,1119,15,26,114,155,1.3612903225806452,0.052490445171775035,652,"Theoretically, how much would we tip the delivery guy?"
9680,1120,12,28,104,144,1.3611111111111112,0.05271486455947329,652,ready to swim back?
7985,1121,10,41,118,169,1.3609467455621302,0.04557877715302305,652,That'd be a sweet spot for a vacation.
2517,1122,12,24,97,133,1.3609022556390977,0.05580695523431359,652,"Oh , hell. My insulin went down with the ship."
2655,1123,13,31,114,158,1.360759493670886,0.050169714734853876,652,We die from starvation or we die from diabetes. Odds or evens?
4451,1124,12,20,90,122,1.360655737704918,0.05942593751826196,652,"Too bad you didn't know the difference between ""desert"" and ""dessert"" when you made that wish..."
5836,1125,10,33,104,147,1.3605442176870748,0.05010991388446206,652,You don't look so tasty anymore.
2340,1125,12,29,106,147,1.3605442176870748,0.051936301271262184,652,Why did we have to get the desert island?
2694,1125,12,29,106,147,1.3605442176870748,0.051936301271262184,652,I told you we should have grabbed our insulin before the ship went down.
185,1125,15,23,109,147,1.3605442176870748,0.05456137159278502,652,Sweet!
1281,1125,11,31,105,147,1.3605442176870748,0.05103127893384367,652,That's just his cap - wait till you see the rest of him!
5065,1130,16,30,126,172,1.3604651162790697,0.04935706682860474,652,Even God's mistakes can slip past spell check once in a while.
8936,1130,10,42,120,172,1.3604651162790697,0.04503469007217927,652,I’m swimming over there tomorrow. It’s my cheat day.
920,1132,10,29,97,136,1.3602941176470589,0.052882895783139136,652,Did you bring your toothbrush?
3985,1132,11,27,98,136,1.3602941176470589,0.05390299739610028,652,"Before Antarctica melted that was the Big Rock Candy Mountain."""
5965,1132,10,29,97,136,1.3602941176470589,0.052882895783139136,652,I have a feeling this island isn’t desserted.
7449,1135,10,34,106,150,1.36,0.04940813000875432,652,That donut would go right to my thighs!
9951,1135,11,32,107,150,1.36,0.05030555406289592,652,I think we smoked too much salmon.
9703,1135,9,36,105,150,1.36,0.04849410121188961,652,"*They keep delivering to the wrong address."""
6885,1135,10,25,90,125,1.36,0.05611049007782943,652,This is one way to watch your calories.
1023,1135,12,30,108,150,1.36,0.051187246733809776,652,And that's the desserted island.
4361,1135,11,23,91,125,1.36,0.05724874981026844,652,MY DENTIST OWNS THAT ISLAND.
103,1135,11,32,107,150,1.36,0.05030555406289592,652,"Swimming over there must be a piece of cake, right?"
5374,1135,15,24,111,150,1.36,0.053745610090749234,652,I had always assumed it was a typo.
3970,1135,11,32,107,150,1.36,0.05030555406289592,652,"Well, you’re the one who didn’t want the upgrade."
756,1144,12,35,117,164,1.3597560975609757,0.04807159226703205,652,That Willy Wonka is one cruel SOB.
934,1145,14,22,103,139,1.3597122302158273,0.0559346273819823,652,It's so sad to see how climate change affected Rock Candy Mountain.
2374,1145,13,24,102,139,1.3597122302158273,0.054994709980196205,652,That's Willy Wonka's private island.
3740,1145,11,28,100,139,1.3597122302158273,0.05306495356348922,652,I love LSD.
6312,1145,13,24,102,139,1.3597122302158273,0.054994709980196205,652,You always were a poor speller.
4115,1145,12,26,101,139,1.3597122302158273,0.05403844660286396,652,The North Pole looks so different without all the ice
2290,1150,10,35,108,153,1.3594771241830066,0.04873210033198207,652,"You know, if we swim over there we would technically burn off the calories..."
2549,1150,13,29,111,153,1.3594771241830066,0.051310968990878336,652,The sharks here are always coming up with something clever to get us in the water.
2725,1150,12,31,110,153,1.3594771241830066,0.05046599079357676,652,Suddenly I get the difference between desert and dessert.
2787,1150,12,31,110,153,1.3594771241830066,0.05046599079357676,652,Do you have the same odd sensation that we’re merely characters in the New Yorker caption contest?
7080,1150,11,33,109,153,1.3594771241830066,0.04960662168271359,652,I told you to double-check the spelling before you booked the island.
8714,1150,13,29,111,153,1.3594771241830066,0.051310968990878336,652,Too bad neither one of us can swim.
6258,1156,11,29,102,142,1.3591549295774648,0.052260412013753144,652,"It was all a misunderstanding.  I told the Genie I wanted to spend my life on a dessert island."""
9126,1157,13,30,113,156,1.358974358974359,0.050595067669842675,652,"Of all the things to give up for lent, I had to choose swimming!"
1358,1157,10,36,110,156,1.358974358974359,0.04808036932782009,652,It's amazing the difference one letter can make.
2890,1157,16,24,116,156,1.358974358974359,0.05299056359704374,652,I see we got our just desserts.
2458,1160,13,35,122,170,1.3588235294117648,0.04760602496693968,652,"Sam, that is not what you think it is, it’s just a tropical illusion."
9518,1160,12,37,121,170,1.3588235294117648,0.046869179306646774,652,"Yes, I see the candy-canes and cupcakes, just like last week I saw the picnic table and the guy grilling steaks and the week before that I saw..."
664,1162,10,27,94,131,1.3587786259541985,0.05425922674020213,652,The sharks must think we’re eight-year-olds.
894,1163,11,30,104,145,1.3586206896551725,0.05148732506764378,652,Looks like sugar infested waters.
3338,1163,11,30,104,145,1.3586206896551725,0.05148732506764378,652,Try not to think about it.
4996,1163,12,28,105,145,1.3586206896551725,0.05240925570196782,652,"Yeah man, we’re surrounded by chocolate milk too."
6946,1163,13,26,106,145,1.3586206896551725,0.053315246635904,652,"Oh, them? Survivors from the wreck of the Good Ship Lollipop."
3906,1167,9,30,95,134,1.3582089552238805,0.052330906193994005,652,I didn't realize a dessert island was an option.
36,1167,8,32,94,134,1.3582089552238805,0.051247467180832965,652,"Really, you’re a dentist too?"
46,1167,10,28,96,134,1.3582089552238805,0.05339236456384609,652,"Yeah, but think of the ant problem over there."
182,1167,12,24,98,134,1.3582089552238805,0.05545436227193261,652,"Yeah, seems nice, but they probably have ants."
683,1167,10,28,96,134,1.3582089552238805,0.05339236456384609,652,You're right. We should have asked for a dessert island..
1191,1167,9,30,95,134,1.3582089552238805,0.052330906193994005,652,Do you think they have bacon?
1789,1167,7,34,93,134,1.3582089552238805,0.050140622670809584,652,Sure looks like a dessert island from here
9994,1174,12,29,107,148,1.3581081081081081,0.051641678388543166,652,Holy cow! A dessert island.
1246,1174,11,31,106,148,1.3581081081081081,0.05074381029671,652,With our luck there's a gummy shark between here and Candy Island.
7647,1176,12,34,116,162,1.3580246913580247,0.048453804591639095,652,"We get one wish, and, as is now apparent, a genie who cannot spell."
6366,1177,8,28,87,123,1.3577235772357723,0.054309278283659695,652,Let’s just appreciate where we are.
3134,1178,10,29,98,137,1.3576642335766422,0.0525613039177426,652,We'd only be able to skinny dip on the way there.
7792,1178,10,29,98,137,1.3576642335766422,0.0525613039177426,652,"So the travel brochure really didn't sugarcoat it."""
1333,1180,11,32,108,151,1.3576158940397351,0.050028134125263725,652,Dare we hope for The Good Ship Lollipop?
3067,1180,12,30,109,151,1.3576158940397351,0.05090299033265068,652,Why didn’t we end up on a dessert island?
9945,1180,13,28,110,151,1.3576158940397351,0.05176306255967165,652,"Okay, I believe. Could you visualize a boat?"
8400,1183,14,31,120,165,1.3575757575757577,0.04935018625430356,652,Being Catholic prepared me for this.
8158,1184,12,26,102,140,1.3571428571428572,0.05371255819312083,652,We should see if we can get an upgrade.
6203,1184,17,31,134,182,1.3571428571428572,0.047964364278034854,652,"No, I said “get your own DESERTED Island”!!"
4970,1184,11,28,101,140,1.3571428571428572,0.05274717039548742,652,I wish we were marooned on the desserted island.
4097,1184,9,32,99,140,1.3571428571428572,0.050761344927936734,652,"When the president tweeted about buying his own desserted island, I assumed it was just a typo."
3193,1184,9,32,99,140,1.3571428571428572,0.050761344927936734,652,I’ve heard that’s the place where young people with college degrees have good paying jobs
5404,1184,15,25,114,154,1.3571428571428572,0.05266722707196812,652,Mom was right--we should've learned to swim.
2171,1184,5,25,68,98,1.3571428571428572,0.05847130347895528,652,Most  tempting mirage since the sunning girls yesterday.
1838,1184,10,25,91,126,1.3571428571428572,0.055736666241522015,652,"And then I said ... 'Swim? For cryin' out loud, we live in Kansas! Why should I waste my time learning how to swim'?..."
1077,1184,10,30,100,140,1.3571428571428572,0.0517637813708753,652,One more 's' and we could have been stranded on the Dessert Island.
2538,1184,11,28,101,140,1.3571428571428572,0.05274717039548742,652,That one's for people who want to be alone on a dessert island.
684,1184,12,31,111,154,1.3571428571428572,0.05019152810962632,652,"Oh, I thought you said it was a D-E-S-E-R-T-E-D island."
23,1184,7,36,97,140,1.3571428571428572,0.04869460229897512,652,Is today a cheat day?
1295,1196,12,27,104,143,1.3566433566433567,0.05289379743701177,652,"You'll probably survive the sharks, but the cholesterol will kill you."
253,1197,11,24,94,129,1.3565891472868217,0.0559000197746355,652,"Of course I can swim, but I'm finally down to my ideal weight."
4189,1197,12,22,95,129,1.3565891472868217,0.05697311858949264,652,"Disagree with his motives all you want, but you have to admit - the sea monster's disguises are getting much better."
7845,1199,13,31,116,160,1.35625,0.049642491531034234,652,"If I spelled my wish correctly, that's where we'd be."
7213,1199,11,35,114,160,1.35625,0.0480327415520527,652,Were they there before we ate that shellfish?
2291,1201,9,34,103,146,1.356164383561644,0.04931244416467622,652,Ah...the elusive Desserted Isle
6045,1201,12,28,106,146,1.356164383561644,0.05210697730019456,652,Someone misspelled 'desert island'
1692,1203,10,27,95,132,1.356060606060606,0.05391515828627825,652,But we got Wi-Fi.
2114,1203,11,25,96,132,1.356060606060606,0.05497731090221102,652,How many calories in a mirage?
3013,1203,10,27,95,132,1.356060606060606,0.05391515828627825,652,I bet the fish swimming around that island are Swedish.
8247,1206,9,24,85,118,1.3559322033898304,0.05712386024307606,652,"Bro, we need a sugar plum ferry."
8056,1207,13,32,118,163,1.3558282208588956,0.04898498765704616,652,Guess I picked the wrong week to give up sugar.
8969,1207,8,42,113,163,1.3558282208588956,0.04495361170769611,652,That cupcake has sailed.
7112,1209,16,21,112,149,1.3557046979865772,0.054768799468211476,652,I'm staying here.  The wifi's better.
7005,1209,10,33,106,149,1.3557046979865772,0.04955252834907552,652,"It’s a dessert island.  You can go, but not till after dinner."
2630,1211,8,32,95,135,1.3555555555555556,0.05093559886023872,652,Remember: coconuts are the healthy alternative.
8036,1211,11,26,98,135,1.3555555555555556,0.05409353186649751,652,We'd only get fat & regret it.
2392,1211,12,24,99,135,1.3555555555555556,0.05510597525954264,652,I swore you said deserted island.
5386,1214,15,29,122,166,1.355421686746988,0.049837311257255844,652,And you said sharks were dumb.
5586,1215,9,25,87,121,1.3553719008264462,0.05611320726204283,652,"Honey, want to go out, just for dessert?"
6825,1215,12,19,90,121,1.3553719008264462,0.05968178256158946,652,I think you call it a desserted island.
57,1217,12,30,110,152,1.355263157894737,0.050621696744787226,652,"Yes, but we’d have to wait 30 minutes before we swam back."
4378,1217,10,34,108,152,1.355263157894737,0.04887002588335563,652,I closed on this island after the realtor said he'd sweeten the deal.
6188,1217,7,40,105,152,1.355263157894737,0.04611793905431834,652,"Well, today is my cheat day."
2342,1220,9,31,98,138,1.355072463768116,0.05122091781944237,652,That's the last time I'll trust Google Earth.
6948,1221,13,34,122,169,1.3550295857988166,0.047736237910378496,652,Good thing we saved room for dessert.
7380,1222,13,29,113,155,1.3548387096774193,0.05075214378913674,652,Talk about a fat chance.
9840,1222,11,22,91,124,1.3548387096774193,0.057477288171357534,652,It was a good ship.
6604,1222,9,26,89,124,1.3548387096774193,0.05514868963457134,652,We should have paid the all-inclusive rate.
5837,1222,15,25,115,155,1.3548387096774193,0.052377041347483146,652,"So sorry hon, I always get desert and dessert mixed up!"
3885,1222,13,29,113,155,1.3548387096774193,0.05075214378913674,652,Yeah but I bet it's all made with palm oil.
6136,1222,9,37,109,155,1.3548387096774193,0.04733530793126538,652,"Ok, great, but where's the marshmallow sky?"
3199,1222,7,41,107,155,1.3548387096774193,0.045530835878830146,652,How’d you know it was my birthday?
3827,1222,15,25,115,155,1.3548387096774193,0.052377041347483146,652,I could never live in a place that's so much about image.
2320,1222,14,27,114,155,1.3548387096774193,0.051570992619442424,652,The wreckage from The Good Ship Lollipop.
1592,1222,12,31,112,155,1.3548387096774193,0.04991986497008818,652,It’s times like this I really wish you weren’t a dentist.
1053,1222,17,21,117,155,1.3548387096774193,0.0539530242103138,652,"What do you think will get us there quicker, a chute or a ladder?"
6363,1233,8,34,99,141,1.3546099290780143,0.049449606713896456,652,That's some serious eye candy!
2790,1233,7,36,98,141,1.3546099290780143,0.04841432103794615,652,Would you rather die of cavities or starve to death
7181,1233,9,32,100,141,1.3546099290780143,0.05046365748489453,652,I'd rather be on a dessert island than a deserted island.
878,1233,9,32,100,141,1.3546099290780143,0.05046365748489453,652,"I don't know, maybe it's not a trap."
1811,1233,13,24,104,141,1.3546099290780143,0.054330923212546504,652,"I mean, we could swim to it but I'm still going to eat you."
5774,1238,6,39,99,144,1.3541666666666667,0.0467148747834084,652,What time do you think they open?
6532,1238,13,25,106,144,1.3541666666666667,0.053499114066545124,652,"You’re the one who wanted a vegan, no sugar, gluten free vacation."
9350,1238,9,33,102,144,1.3541666666666667,0.0497358504240635,652,"I love a good mirage at dinner time, don’t you?"
9660,1238,14,23,107,144,1.3541666666666667,0.054399267486155575,652,Now I'm depressed.
5672,1242,11,35,115,161,1.3540372670807452,0.0477847284267985,652,Forget it.  I don't think any of those desserts would go with fish.
1554,1242,12,33,116,161,1.3540372670807452,0.04859032848598247,652,Remember when you said a ship would be the sweetest thing you could ever see?
2347,1242,13,31,117,161,1.3540372670807452,0.04938278823566441,652,"it must be your mirage kev, my mirage would have tequila and naked women"
3598,1242,12,33,116,161,1.3540372670807452,0.04859032848598247,652,You'll burn some of it off in the swim back.
8721,1246,9,28,93,130,1.353846153846154,0.05334548735417158,652,Did the brochure say “desert” or “dessert”?
9325,1246,10,26,94,130,1.353846153846154,0.05445182830200418,652,"Okay, I got one. If you were stranded on a dessert island..."
521,1246,11,24,95,130,1.353846153846154,0.05553613409130857,652,Will the sharks stop at nothing?
1302,1246,13,20,97,130,1.353846153846154,0.057643589049967504,652,These pop-up shops are everywhere.
9533,1246,11,24,95,130,1.353846153846154,0.05553613409130857,652,"We should swim for it right now, before they build the wall."
3251,1251,8,36,103,147,1.3537414965986394,0.048076137360922644,652,"You know, I'm actually more of a savoury type, myself"
1184,1252,14,30,120,164,1.353658536585366,0.04949536034541328,652,"Happy Birthday, George."
9936,1253,7,33,93,133,1.3533834586466165,0.05028454998701167,652,But then you would look over here and dream of coconuts.
426,1253,11,25,97,133,1.3533834586466165,0.05462802059023609,652,We should've gone to the desserted island
693,1255,12,29,109,150,1.3533333333333333,0.051061805482376536,652,I'm going to wait until after dinner.
2121,1255,12,29,109,150,1.3533333333333333,0.051061805482376536,652,Just like my mom to keep the sweets out of reach.
4276,1255,8,37,105,150,1.3533333333333333,0.047427483010045526,652,"Yeah, but a real island wouldn't be moving toward us."
5649,1255,11,31,108,150,1.3533333333333333,0.05017790869005088,652,Imagine seeing a dessert island way out here.
6344,1255,11,31,108,150,1.3533333333333333,0.05017790869005088,652,Welcome my friend to middle-class island. Where what you see is what you will never get.
7218,1255,13,27,110,150,1.3533333333333333,0.051930659900804595,652,Remember that time you said that you’d rather die than eat another carb?
8711,1255,11,31,108,150,1.3533333333333333,0.05017790869005088,652,"So, the genie gives us three wishes...and before I can even think, the wife and kids use them all!"
9926,1262,9,24,86,119,1.3529411764705883,0.05672071084872762,652,My biggest regret is never learning to swim.
7400,1262,13,28,112,153,1.3529411764705883,0.05119032745195421,652,"Aye, she was quite the good ship, the Lollipop."
4269,1262,12,30,111,153,1.3529411764705883,0.05034332440982412,652,Sure Hansel. What could go wrong? Let's swim over.
4231,1262,8,32,96,136,1.3529411764705883,0.05062723328375709,652,I don’t care what you were planning to give up for Lent.
4449,1262,9,30,97,136,1.3529411764705883,0.051691867946917915,652,I think Gene Wilder was way better than Johnny Depp.
2686,1267,16,23,117,156,1.3525641025641026,0.052877878860115135,652,I didn’t know the Good Ship Lollipop was a submarine.
4694,1267,11,33,112,156,1.3525641025641026,0.04881091213090623,652,Is that my mirage or yours?
9402,1267,14,27,115,156,1.3525641025641026,0.051289805038305866,652,How about today? Is today a cheat day?
8566,1270,12,25,102,139,1.3525179856115108,0.053899458598522534,652,That's the dessert island.
2568,1270,9,31,99,139,1.3525179856115108,0.05091520788082779,652,It's amazing the difference an extra 's' can make.
7662,1270,12,25,102,139,1.3525179856115108,0.053899458598522534,652,They're just desserts. Just not your just desserts.
4334,1273,10,23,89,122,1.3524590163934427,0.05693015035741894,652,And to think we used to live there.
575,1273,7,29,86,122,1.3524590163934427,0.053240896208334575,652,Too bad about your insulin.
3234,1275,12,32,115,159,1.3522012578616351,0.048983265551674905,652,We came so close to being stranded on a dessert island.
8552,1275,15,26,118,159,1.3522012578616351,0.051363360402196474,652,"When we signed up for Temptation Island, I was expecting supermodels..."
66,1277,10,30,102,142,1.352112676056338,0.05115505631014838,652,I wish we’d noticed that before eating the only guy that knew how to swim
8716,1277,12,26,104,142,1.352112676056338,0.05307183836865408,652,That's my kind of desserted island
9556,1277,12,26,104,142,1.352112676056338,0.05307183836865408,652,One s.   One lousy s.
4875,1280,9,39,114,162,1.3518518518518519,0.04589775548385575,652,All those years playing Candyland with my kids has finally paid off.
5139,1280,14,29,119,162,1.3518518518518519,0.04990000139241922,652,I spy with my eye something that starts with C.
5978,1280,17,23,122,162,1.3518518518518519,0.052154135476182695,652,"No.  I would go there on our vacation, but it doesn't exist; and neither do you."
8598,1283,14,23,108,145,1.3517241379310345,0.054077986189414916,652,It's a desserted  island ....
5014,1283,15,21,109,145,1.3517241379310345,0.054956473967273205,652,"Just our luck, another desserted island."
1821,1283,12,27,106,145,1.3517241379310345,0.05227674156904289,652,That? Blame auto-correct.
1586,1283,12,27,106,145,1.3517241379310345,0.05227674156904289,652,I just hallucinate food and I gain weight.
4810,1283,9,33,103,145,1.3517241379310345,0.04945201095241139,652,"We could swim over, but we'd have to float back."
777,1288,11,23,94,128,1.3515625,0.0561102197516701,652,"Just exactly, what was in that last coconut, you gave me earlier?"
3708,1288,8,29,91,128,1.3515625,0.05271870894086588,652,"You laugh, but since I moved them over there, I've lost 8 pounds!"
9031,1288,8,29,91,128,1.3515625,0.05271870894086588,652,I'm starting to think that sea level rise will eventually affect my way of life.
9064,1288,8,29,91,128,1.3515625,0.05271870894086588,652,Really? Dessert on a deserted island?
6493,1292,13,26,109,148,1.3513513513513513,0.05239691888242544,652,I think your weed was laced.
5112,1292,8,36,104,148,1.3513513513513513,0.04780997585844713,652,"If it helps, remember those are empty calories."
514,1292,13,26,109,148,1.3513513513513513,0.05239691888242544,652,We could rationalize it with the swim.
2777,1292,14,24,110,148,1.3513513513513513,0.053266929437773176,652,Screw the sharks- I think...you should go for it.
4319,1296,7,32,92,131,1.3511450381679388,0.05074161009434196,652,"Nah, I’ll wait for a burger and fries mirage."
5233,1296,8,30,93,131,1.3511450381679388,0.05188594036020284,652,"Unfortunately, these waters are snack infested."
5693,1296,11,24,96,131,1.3511450381679388,0.05517671830900627,652,"There, but for want of an extra ""s"", go you and I."
6451,1296,9,28,94,131,1.3511450381679388,0.053005571586002415,652,"Chocolate syrup's a bitch to swim in, man ..."
5120,1300,11,31,109,151,1.3509933774834437,0.049899391491588285,652,I think I'll stay here - sticky hands and sand are the WORST!
8180,1300,13,27,111,151,1.3509933774834437,0.051638645535411726,652,We won't be able to swim back for half an hour.
8833,1300,11,31,109,151,1.3509933774834437,0.049899391491588285,652,I've always heard good things about the South Beach Diet.
6666,1303,9,22,83,114,1.3508771929824561,0.058419987280790564,652,"Actually, maybe we're its hallucination."
8061,1304,11,25,98,134,1.3507462686567164,0.05428291442229625,652,"Dude, don’t do it. You know we’re outta toothpaste."
8142,1304,9,29,96,134,1.3507462686567164,0.05217464036205944,652,I have more of a savory palate anyway.
9571,1304,10,27,97,134,1.3507462686567164,0.05323921437760225,652,Let’s seek asylum
781,1307,9,36,109,154,1.3506493506493507,0.04745672266003775,652,You'd seriously choose death over gluten?
1256,1308,10,28,99,137,1.3503649635036497,0.05241202413909692,652,I wish we were desserted not deserted
6078,1308,12,24,101,137,1.3503649635036497,0.054421546176756395,652,It's about time the dessert tray arrived.
7107,1308,9,30,98,137,1.3503649635036497,0.05137779741679769,652,Ever wonder what it would be like to live on a desserted island?
8410,1308,9,30,98,137,1.3503649635036497,0.05137779741679769,652,I thought you said it was a dessert island
7450,1312,10,35,112,157,1.3503184713375795,0.04770260266841387,652,"Alright, is that your hallucination or mine?"
2899,1312,14,27,116,157,1.3503184713375795,0.051011523900516775,652,I told you to check the spelling before booking.
7225,1312,14,27,116,157,1.3503184713375795,0.051011523900516775,652,This time you swim over and see if it's real.
522,1315,15,26,119,160,1.35,0.05108877462889241,652,If I knew I would be trapped in a classic cartoon cliché I would rather it had been in a bar.
2401,1315,15,19,106,140,1.35,0.05637654203003348,652,I thought Mar-a-lago was bigger...
2423,1315,3,36,81,120,1.35,0.048290089802248706,652,How far do you think we can get on one of those mints?
4482,1315,8,33,99,140,1.35,0.04958719623887276,652,I just REALLY am in the mood for pizza.
4744,1315,12,32,116,160,1.35,0.04872590518890323,652,"Sorry, Gary. I'm diabetic, so I'm still going to have to eat you."
8333,1315,11,34,115,160,1.35,0.047912393848322056,652,Lesson learned:  When the genie says submit your wish in writing...always use spell check.
5059,1321,10,37,116,163,1.3496932515337423,0.04648823479653038,652,Beware reefs bearing gifts.
9253,1321,17,23,123,163,1.3496932515337423,0.0518781120393741,652,That's probably what we look like to them.
9122,1323,14,22,107,143,1.3496503496503496,0.05459190328734421,652,"Let me remind you, we don't take kindly to desserters on this island."
12,1323,12,26,105,143,1.3496503496503496,0.05275689331315552,652,"As mirages go, it’s not bad."
3310,1323,11,28,104,143,1.3496503496503496,0.051815024228655325,652,I told you to pick desserted island.
7361,1323,13,24,106,143,1.3496503496503496,0.05368223959835514,652,My travel agent hates me.
8004,1323,8,34,101,143,1.3496503496503496,0.04888064614034406,652,It's farther away than it looks.
5508,1328,3,37,83,123,1.3495934959349594,0.04757723413254882,652,"That cake’s gotta be stale”
“Yeah"
9119,1329,10,31,105,146,1.3493150684931507,0.05012263256334676,652,Remember when it was only a board game?
7892,1329,11,29,106,146,1.3493150684931507,0.051056357159219946,652,Now that’s Eye Candy
6306,1329,12,27,107,146,1.3493150684931507,0.05197330966620647,652,"Yeah, I thought about it too, but then I'd just want something salty."
4587,1329,10,31,105,146,1.3493150684931507,0.05012263256334676,652,"Yeah, it looks sweet from here."
9496,1333,10,24,92,126,1.3492063492063493,0.05556915933216778,652,That Great British Baking Show really gets around.
1271,1334,12,35,122,169,1.349112426035503,0.046881612190317265,652,What'd you put in that joint?
590,1335,11,30,108,149,1.348993288590604,0.05032650018042513,652,You think it could be a desserted island
7516,1335,12,28,109,149,1.348993288590604,0.051219638245281814,652,"She's a nice witch, but she eats kids."
8407,1335,10,32,107,149,1.348993288590604,0.04941722269455383,652,"I misread the ad. I thought the island would be deserted, not desserted."
1761,1338,7,31,91,129,1.3488372093023255,0.05121011729350314,652,I stand corrected. There is such a thing as a dessert island.
3358,1338,8,29,92,129,1.3488372093023255,0.05237938663464953,652,Just be sure to wait an hour before you come back.
2479,1340,12,29,111,152,1.3486842105263157,0.050494132417504015,652,Obviously bait.
592,1340,13,27,112,152,1.3486842105263157,0.05134973986630415,652,It's where people who can't spell 'desert' end up.
3397,1342,9,28,95,132,1.3484848484848484,0.05266970356355831,652,"I'm more of a savory person."""
6475,1342,9,28,95,132,1.3484848484848484,0.05266970356355831,652,So are we on the one with one or two S's?
9526,1342,10,26,96,132,1.3484848484848484,0.0537564702568634,652,"My hallucinations used to involve beatiful women, but I like this one more now."
9978,1342,9,28,95,132,1.3484848484848484,0.05266970356355831,652,"Two reasons.  I’m watching my carbs, and I can’t swim."
7426,1346,8,38,109,155,1.3483870967741935,0.04630778832891874,652,"Don't get too excited, it's all vegan."
7743,1346,11,32,112,155,1.3483870967741935,0.04894663217832321,652,"Sweet, a dessert-ed island!"
6966,1348,10,27,98,135,1.348148148148148,0.05290720990545556,652,Guess that's what eye candy looks like!
6821,1348,8,31,96,135,1.348148148148148,0.05077456273522056,652,"TripAdvisor DID call it ""a pretty sweet deal."""
2674,1348,14,19,102,135,1.348148148148148,0.056933348206776924,652,"OK, desert island, dessert island. You pick."
1313,1348,14,19,102,135,1.348148148148148,0.056933348206776924,652,Must be a dessert island?
3663,1348,12,23,100,135,1.348148148148148,0.05495716057991917,652,I've got this.  I'm level 3047 in Candy Crush.
8692,1353,15,25,118,158,1.3481012658227849,0.05152454070399064,652,It would spoil our dinner...
481,1354,13,22,103,138,1.3478260869565217,0.055054644207692946,652,That's where The Good Ship Lollipop went down.
1304,1354,8,32,98,138,1.3478260869565217,0.05002080801877035,652,"Trust me, we're better off here on Insulin Island."
1403,1354,11,26,101,138,1.3478260869565217,0.05309840678628378,652,In many ways it is the most highly evolved and patient sea predator ever.
7000,1354,11,26,101,138,1.3478260869565217,0.05309840678628378,652,Now that's my type of desserted island.
3385,1358,16,25,123,164,1.3475609756097562,0.050874819006775485,652,What a difference one more “s” makes.
3676,1359,10,29,102,141,1.3475177304964538,0.05131089616378166,652,This time try holding it above the water when you swim it back.
5266,1359,8,33,100,141,1.3475177304964538,0.04929679320141368,652,Do you still think spelling doesn’t matter
6693,1359,11,27,103,141,1.3475177304964538,0.0522888629415873,652,"The sand does look
sweeter on the other side."
6762,1359,10,29,102,141,1.3475177304964538,0.05131089616378166,652,"You've become delusional, Bob.  All I see is two palms and a pile of rocks."
6838,1359,11,27,103,141,1.3475177304964538,0.0522888629415873,652,It's always a surprise when your mind goes places your body can't follow.
6915,1359,6,37,98,141,1.3475177304964538,0.04719681742189307,652,Good thing we landed here -- that stuff'll kill ya.
9732,1359,9,31,101,141,1.3475177304964538,0.05031392394294709,652,"Next time you book a vacation on your phone, do me a favor and turn off autocorrect."
8808,1366,8,34,102,144,1.3472222222222223,0.04860070373662373,652,I guess being pre diabetic doesn’t mean much now.
6336,1366,9,32,103,144,1.3472222222222223,0.04958985280095282,652,They say Oprah lives there and it’s mostly cauliflower.
3878,1366,11,28,105,144,1.3472222222222223,0.05151119970521326,652,"If you're having second thoughts, I'm a dentist."
1134,1366,11,28,105,144,1.3472222222222223,0.05151119970521326,652,Swimming over is a piece of cake.
130,1366,9,32,103,144,1.3472222222222223,0.04958985280095282,652,The Good Ship Lollipop should be along any time now.
2251,1366,9,32,103,144,1.3472222222222223,0.04958985280095282,652,That's the second empty calories mirage this week.
5468,1372,9,24,88,121,1.3471074380165289,0.05593032831632606,652,"As a dentist, I may feel more useful there."
1816,1373,12,35,123,170,1.3470588235294119,0.04665024509712103,652,Just stay here. Last week it was cocktails.
3678,1373,11,37,122,170,1.3470588235294119,0.04589805794744683,652,"You're right, I do deserve a cheat day."
7020,1375,10,31,106,147,1.346938775510204,0.04983717895652952,652,So glad we chose the low carb deserted island package.
9463,1375,10,31,106,147,1.346938775510204,0.04983717895652952,652,"So when you typed 'dessert island' into your GPS, did you spell it with one 's' or two?"
7234,1375,9,33,105,147,1.346938775510204,0.048893316989437274,652,I still think it's strange we're delusional with the same sweets.
1854,1375,11,29,107,147,1.346938775510204,0.050763494427203314,652,"If the sharks don't get you, diabetes will."
1057,1375,8,35,104,147,1.346938775510204,0.04793087195236534,652,They say it was run by a guy named Wonka.
704,1375,10,31,106,147,1.346938775510204,0.04983717895652952,652,Sometimes it seems like God is really just playing games with us.
4595,1375,6,39,102,147,1.346938775510204,0.045945539129309786,652,"Somewhat ironic, being shipwrecked on the Good Ship Lollypop …"
6771,1382,12,19,93,124,1.346774193548387,0.05843975699673655,652,"If it weren’t for that darned Autocorrect, I’d be there right now."
520,1382,10,23,91,124,1.346774193548387,0.056151086460678734,652,"It's only one ""s"" away."
3271,1382,10,23,91,124,1.346774193548387,0.056151086460678734,652,"Just my luck, stranded with a dentist."
5375,1382,9,25,90,124,1.346774193548387,0.05497103025369925,652,"If you decide to go, would you mind bringing me back a slice of cake?"
8314,1386,10,32,108,150,1.3466666666666667,0.04914177696321292,652,"Oh, look, dessert on an island. If only there was an obvious joke I could make."
2882,1386,8,36,106,150,1.3466666666666667,0.04728576240134247,652,It's either death or give up my new year's resolution.
7907,1386,10,32,108,150,1.3466666666666667,0.04914177696321292,652,This time the grass may actually be greener.
8450,1386,12,28,110,150,1.3466666666666667,0.05093019890328443,652,Not until you finish your palm tree.
6632,1386,11,30,109,150,1.3466666666666667,0.050043977676790835,652,"Come on, what's so bad about diabetes?"
682,1386,10,32,108,150,1.3466666666666667,0.04914177696321292,652,"You're thinking about deserting me, aren't you."
3466,1386,8,36,106,150,1.3466666666666667,0.04728576240134247,652,But what if I'm right?
2338,1386,11,30,109,150,1.3466666666666667,0.050043977676790835,652,Damn autocorrect put us on the wrong island.
5608,1386,11,30,109,150,1.3466666666666667,0.050043977676790835,652,"I said dessert island, not desert."
5960,1395,12,20,95,127,1.3464566929133859,0.057418045860943207,652,"Just our luck to be trapped on a deserted island, not the desserted island."
1450,1396,14,25,114,153,1.34640522875817,0.05189914195333722,652,"The islands I fantasize about these days are heaped with scrambled eggs, crispy hash browns and those maple flavored sausages."
4200,1396,12,29,112,153,1.34640522875817,0.050214761888130455,652,"I would just walk over there, but I don't think this Jell-O would hold me."
7235,1396,9,35,109,153,1.34640522875817,0.047576510753365754,652,Dang! Just missed the dessert island
8490,1396,13,27,113,153,1.34640522875817,0.05106389745688379,652,Really?  Well I like to pretend I see pretty women reclining and drinking champagne.
8760,1400,13,28,115,156,1.3461538461538463,0.0503534621043378,652,Let's get off this desert island and get on that dessert one.
373,1400,10,25,95,130,1.3461538461538463,0.05428731451982511,652,I don't mind the hallucinations so much.  I just wish my subconscious mind would throw in a salad every once in a while.
3459,1400,10,34,112,156,1.3461538461538463,0.04782606180814604,652,"I said swim toward the dessert island, not the desert island."
3972,1400,9,27,94,130,1.3461538461538463,0.05317755102858302,652,We should have taken the Good Ship Lollipop....
3186,1404,9,28,96,133,1.3458646616541354,0.052337819003208684,652,You say “hallucination” like it’s a bad thing.
5798,1404,9,28,96,133,1.3458646616541354,0.052337819003208684,652,"I say we go for it.  Just a short swim, and we could be stranded on a desserted island."
14,1404,9,28,96,133,1.3458646616541354,0.052337819003208684,652,"Sorry, I thought it was a typo."
7339,1404,9,28,96,133,1.3458646616541354,0.052337819003208684,652,"Nah, processed sugar will kill you."
7760,1408,13,30,119,162,1.345679012345679,0.04900746932105317,652,I don't remember Candy Land being this challenging.
2235,1409,6,35,95,136,1.3455882352941178,0.04825797197915803,652,Sorry. I thought we'd be safe from temptation out here.
3128,1409,12,23,101,136,1.3455882352941178,0.054611597951195606,652,"He used to build erotic sand mermaids to torture me until he found out I was gay, then somehow he figured out I was diabetic."
3527,1409,13,21,102,136,1.3455882352941178,0.05559999184043708,652,"I mean, it's got to be a trap."
7520,1409,8,31,97,136,1.3455882352941178,0.05046480737393613,652,Remind me -- what day is our cheat day?
383,1413,11,16,83,110,1.3454545454545455,0.06252454215242269,652,It must be a dessert island.
6745,1413,12,33,120,165,1.3454545454545455,0.047599078179091814,652,If only I’d learnt how to spell “dessert.”
7452,1413,18,21,126,165,1.3454545454545455,0.0520493153033125,652,I told you to request the desserted island.
9652,1416,7,34,98,139,1.3453237410071943,0.048662895379320684,652,"Resist, Jim. Swimsuit season is year-round for us now."
7143,1416,10,28,101,139,1.3453237410071943,0.05177712458571495,652,There was a ferris wheel in the brochure.
4304,1416,15,18,106,139,1.3453237410071943,0.056587920116763515,652,"You're hallucinating again - I see two ears, two eyes a nose and  a row of teeth!"
4039,1416,14,20,105,139,1.3453237410071943,0.05565903600122712,652,"I swear to god, if you sing, ""Lolipop"" one more time, I will feed myself to the sharks."
2744,1416,7,34,98,139,1.3453237410071943,0.048662895379320684,652,We can do better.
1955,1416,13,22,104,139,1.3453237410071943,0.054714384525740435,652,It’s a deserted island
3421,1422,8,23,82,113,1.345132743362832,0.05729069461150207,652,"Sure it's tempting, but eventually we would just crash again."
1344,1423,11,27,104,142,1.3450704225352113,0.051976972771799246,652,No shade...No thank you!
1444,1423,9,31,102,142,1.3450704225352113,0.050018251236786236,652,It wouldn't kill us to have a cheat day.
7645,1423,11,27,104,142,1.3450704225352113,0.051976972771799246,652,Did you know one sugar donut takes two days off your life?
7843,1423,8,33,101,142,1.3450704225352113,0.049009543314738425,652,I think the sharks have us figured out.
7469,1427,13,24,108,145,1.3448275862068966,0.05304818739868656,652,Calorie High may call you.
2288,1427,9,32,104,145,1.3448275862068966,0.04930485192994763,652,As long as it keeps floating closer I'm actually ok with it being a mirage....
4774,1427,10,30,105,145,1.3448275862068966,0.050266826679700866,652,As far as being marooned goes I'm glad we went traditional.
267,1430,9,33,106,148,1.3445945945945945,0.04861837938016613,652,Candy Land looked a lot bigger on the map.
476,1430,8,35,105,148,1.3445945945945945,0.04766359355101678,652,"No, I said it's a desert island."
741,1430,10,31,107,148,1.3445945945945945,0.0495547724937871,652,It's a Dessert Island. Get it?
6132,1430,10,31,107,148,1.3445945945945945,0.0495547724937871,652,"Well, let's finish this last tree, and we can swim to dessert."
6672,1430,11,29,108,148,1.3445945945945945,0.050473796570777524,652,"Next year, I say we go all-inclusive."
5290,1435,11,30,110,151,1.3443708609271523,0.04976444080598481,652,It's a shame about the Good Ship Lollipop...
1387,1435,11,30,110,151,1.3443708609271523,0.04976444080598481,652,Better an empty stomach than empty carbs.
3520,1435,11,30,110,151,1.3443708609271523,0.04976444080598481,652,Maybe the remains of the good ship lollipop?
6331,1435,9,34,108,151,1.3443708609271523,0.047957263550282576,652,"I don't care if there are Sharks. If you Really love me you'll swim over there and get me some cake."""
8838,1435,13,26,112,151,1.3443708609271523,0.0515082518654387,652,"It gives new meaning to name, desserted island."
9934,1435,16,20,115,151,1.3443708609271523,0.05401852156885752,652,And I thought sharks weren't that smart.
5869,1441,13,27,114,154,1.344155844155844,0.05078107361397728,652,"Say 'dessert island' one more time and I'll drown you in this ocean of syrup"""
8440,1441,11,31,112,154,1.344155844155844,0.04908108150541256,652,"I think I saw a cartoon like this once, and I didn't think it was funny then either."
6431,1443,12,19,94,125,1.344,0.05803669584423401,652,Do you think it's the hunger or the acid?
4146,1443,8,27,90,125,1.344,0.05340532775162104,652,They're probably just as unhappy as we are.
8569,1443,8,27,90,125,1.344,0.05340532775162104,652,Funny. Always thought I'd be more of a hot chick hallucinator.
9217,1446,10,34,113,157,1.3439490445859872,0.04757158131041275,652,"After a week, it stops looking like a woman."
1706,1446,16,22,119,157,1.3439490445859872,0.05246914571766778,652,"There's two esses in ""dessert."" Once again, you've misspelled us into catastrophe."
8867,1448,13,29,118,160,1.34375,0.04940437288083341,652,Everything I want as always just out of reach.
2850,1449,12,32,119,163,1.343558282208589,0.047968949109091163,652,I knew the ocean was filling with junk...but junk food?
6040,1449,11,34,118,163,1.343558282208589,0.0471728705570442,652,"Could you please stop pointing out the irony of our being on a ""desert"" island?"
8630,1449,15,26,122,163,1.343558282208589,0.05028161855735523,652,"She’s right, though, I’ll never again misspell desert island."
110,1452,7,31,93,131,1.3435114503816794,0.050564624518149505,652,Let’s go for it. The swim over and back will burn up the extra calories.
1192,1452,9,27,95,131,1.3435114503816794,0.05283617015694881,652,"Dude, if you call that a sweet spot one more time, I'm going to vote you off the island."
9883,1452,10,25,96,131,1.3435114503816794,0.05393607965870664,652,It's either starve to death or get diabetes.
742,1455,9,39,118,166,1.3433734939759037,0.04498497207320381,652,"If the sharks don't kill you, the gluten will."
946,1455,12,33,121,166,1.3433734939759037,0.04735721447477964,652,But we've got fiber
2144,1455,14,29,123,166,1.3433734939759037,0.04887478350914555,652,Yelp reviews are like 'meh.'
7898,1455,17,23,126,166,1.3433734939759037,0.051066647760051743,652,If only we had landed on the desserted island. . .
8616,1455,13,31,122,166,1.3433734939759037,0.04812198159820585,652,Survivor: Candyland
7639,1460,5,36,93,134,1.3432835820895523,0.047498858714342916,652,"Swimming lessons are a waste of time, you said.  Who needs to be able to swim nowadays, you said."
8608,1460,10,26,98,134,1.3432835820895523,0.05307773386586271,652,"Hey, at least we are not desserted like those people over there."
5890,1462,12,23,102,137,1.3430656934306568,0.054270164670231116,652,Must be survivors from the good ship lollipop
7117,1462,11,25,101,137,1.3430656934306568,0.05327202423766368,652,These sharks are smarter than I thought.
4031,1462,8,31,98,137,1.3430656934306568,0.050158568016949026,652,Dude .... sweet view
2990,1462,9,29,99,137,1.3430656934306568,0.05121742040035477,652,"A few years ago, sure, but now that kind of thing is just a distraction."
2272,1462,12,23,102,137,1.3430656934306568,0.054270164670231116,652,I try to avoid highly processed foods.
162,1462,11,25,101,137,1.3430656934306568,0.05327202423766368,652,"Sure it is delicious, but you can't live on it."
139,1468,5,38,97,140,1.3428571428571427,0.046203700829501676,652,I'm giving up sweets for Lent.
1409,1468,9,30,101,140,1.3428571428571427,0.05045673059183804,652,Just missed a dessert island by that much!
6393,1468,9,30,101,140,1.3428571428571427,0.05045673059183804,652,At least we have shade.
404,1471,7,35,101,143,1.3426573426573427,0.047704001226050126,652,"We can't both be hallucinating, right?"
2631,1471,9,31,103,143,1.3426573426573427,0.049725826744801964,652,We're so lucky we washed up on the healthy island
3130,1471,11,27,105,143,1.3426573426573427,0.05166859740628859,652,I should have checked the spelling more closely before I booked our reservations.
5954,1471,10,29,104,143,1.3426573426573427,0.05070651734928753,652,It would be nice... but we have a shade tree!
6287,1471,12,25,106,143,1.3426573426573427,0.05261308786008161,652,I'm guessing it's from The Wreck of  the Good Ship Lollipop...?
9495,1471,10,29,104,143,1.3426573426573427,0.05070651734928753,652,"Then again, I'd miss the coconuts."
435,1477,12,26,108,146,1.3424657534246576,0.05183305580882922,652,Do you think that's what they meant when they said we would be receiving just desserts?
1635,1477,8,34,104,146,1.3424657534246576,0.04804968708871018,652,"We used to trade our coconuts for their candy, but now we’re in a tariff war with them."
3306,1477,8,34,104,146,1.3424657534246576,0.04804968708871018,652,The downside of peyote.
6852,1480,6,26,79,111,1.3423423423423424,0.055041486096646705,652,"For the last time, it's dessert island, not desert island."
8062,1481,10,31,108,149,1.342281879194631,0.04927536953178356,652,"Desert or dessert, the ultimate question."
7956,1481,11,29,109,149,1.342281879194631,0.05018721713804252,652,I wouldn't bother. They don't even use real cream.
8878,1481,12,27,110,149,1.342281879194631,0.05108279050353684,652,The cannibal on that islet is also a pastry chef. Very clever.
8323,1481,15,21,113,149,1.342281879194631,0.053679937130457295,652,What?? You don’t see it?
7830,1481,12,27,110,149,1.342281879194631,0.05108279050353684,652,"Just think, if you knew how to swim, you’d be overweight"
7602,1481,15,21,113,149,1.342281879194631,0.053679937130457295,652,You can go but I'm not fallin' for that old shark trick.
6870,1481,12,27,110,149,1.342281879194631,0.05108279050353684,652,I’ve always wondered what it would be like to live on a dessert island.
6111,1481,13,25,111,149,1.342281879194631,0.05196293108741498,652,Let's go. It looks dessert-ed.
4100,1481,5,41,103,149,1.342281879194631,0.04443634137345018,652,The property tax is the clincher.
908,1481,8,35,106,149,1.342281879194631,0.04739907804334821,652,"I know it’s a mirage, but I still want to go."
9877,1491,7,25,82,114,1.3421052631578947,0.055484692110497065,652,"Wait, your telling me it's been there the whole time!"
7686,1491,9,34,109,152,1.3421052631578947,0.04769455136450979,652,How many calories will we burn on the way?
3386,1491,13,26,113,152,1.3421052631578947,0.051218392524800774,652,Ever hallucinate a typo?
4508,1491,11,30,111,152,1.3421052631578947,0.049487846804475294,652,"At least, we've got shade."
1325,1491,8,36,108,152,1.3421052631578947,0.04677212689328107,652,I'm never playing Candyland stoned again
285,1491,12,28,112,152,1.3421052631578947,0.0503605535819841,652,Why couldn't we have been stranded on the dessert island?
1620,1491,14,24,114,152,1.3421052631578947,0.05206209858011146,652,Is that a desserted island or what?
762,1498,8,37,110,155,1.3419354838709678,0.046167496802299236,652,At low tide you get the gluten-free selection.
4561,1498,13,27,115,155,1.3419354838709678,0.05050122437918887,652,Do you want to get one and split it?
7507,1498,8,37,110,155,1.3419354838709678,0.046167496802299236,652,Maybe we'll be rescued by the Good Ship Lollipop!
7975,1501,11,32,115,158,1.3417721518987342,0.048164028018801555,652,"Yup, global warming. It used to be Rock Candy Mountain."
1040,1501,11,32,115,158,1.3417721518987342,0.048164028018801555,652,You go. I don’t want to ruin my appetite.
5232,1501,11,32,115,158,1.3417721518987342,0.048164028018801555,652,"The sharks in these waters are extremely clever and resourceful.  Last week it was women in bikinis."""
7854,1504,9,23,88,120,1.3416666666666666,0.05613089111569176,652,"And to think all that separates us is an ""S."""
2920,1505,7,43,117,167,1.341317365269461,0.04312018485528221,652,Just be patient. Tomorrow is our cheat day.
3160,1506,6,31,89,126,1.3412698412698412,0.05059982861216777,652,I had hoped for more from the season finale.
5677,1506,12,19,95,126,1.3412698412698412,0.05763894011417554,652,"Man, one S makes a lot of difference."
9489,1506,8,27,91,126,1.3412698412698412,0.05305007926053462,652,I guess flotsam from the Good Ship Lollipop
3709,1509,13,32,125,170,1.3411764705882352,0.047275865652883164,652,There it is! The wreck of the Good Ship Lollypop!!
9599,1510,9,26,94,129,1.3410852713178294,0.05334740158333645,652,"We could have visited Candy Land, but oh no, you wanted a desert island getaway."
2863,1511,8,29,95,132,1.3409090909090908,0.05138555087377326,652,Too bad we just ate.
5377,1511,10,25,97,132,1.3409090909090908,0.0535891377110045,652,I guess you're right. It's dessert island after all.
7541,1511,7,31,94,132,1.3409090909090908,0.05024753145774633,652,Guess we missed the boat.
7780,1511,8,29,95,132,1.3409090909090908,0.05138555087377326,652,Too bad it's Lent.
9542,1515,6,34,95,135,1.3407407407407408,0.04837087575300394,652,Don't even think of it. The sharks put it there.
7943,1515,9,28,98,135,1.3407407407407408,0.051685748322464815,652,The Diet Island sucks
2993,1515,9,28,98,135,1.3407407407407408,0.051685748322464815,652,"Sure, it looks good, but that swim is no piece of cake."
3712,1515,8,30,97,135,1.3407407407407408,0.050604923279653644,652,Are you sure you can't see the blonde in the skimpy bikini lying on deck chair?
4383,1515,14,18,103,135,1.3407407407407408,0.05678211141918634,652,"The next time I book our island vacation, remind me to use spell check"
936,1520,9,29,100,138,1.3405797101449275,0.05090566298579664,652,What would you bring to a dessert island?
7275,1520,8,31,99,138,1.3405797101449275,0.049855792052945165,652,"I don't know, I still kind of like ours."
8357,1520,6,35,97,138,1.3405797101449275,0.0476867587033604,652,Sometimes I feel like we landed on the wrong breast.
7883,1523,8,32,101,141,1.3404255319148937,0.04913619312252135,652,The swim back will burn off the sugar.
2488,1523,13,22,106,141,1.3404255319148937,0.05404582396024975,652,If only we’d washed up on the dessert island instead!
2316,1523,13,22,106,141,1.3404255319148937,0.05404582396024975,652,Next time ask the travel agent for a dessert island.
1293,1523,16,16,109,141,1.3404255319148937,0.05678822461851982,652,We're in luck. It's one of the Sarah Leeward Islands.
749,1527,13,23,108,144,1.3402777777777777,0.053221030550852366,652,"You understand that consuming those will shorten our life expectancy, don't you?"
4154,1527,7,35,102,144,1.3402777777777777,0.04743129252027798,652,I dunno...doesn't seem worth it without the glass of milk.
9454,1529,10,30,107,147,1.3401360544217686,0.0496906830020621,652,My mirage has a sense of humor today.
3629,1529,10,30,107,147,1.3401360544217686,0.0496906830020621,652,Big deal! Just another dessert island.
3289,1529,12,26,109,147,1.3401360544217686,0.05153193085304032,652,Do you see what I see?
5000,1529,11,28,108,147,1.3401360544217686,0.05061967934832239,652,"Oh, wow!  It's a dessert island!"
943,1529,12,26,109,147,1.3401360544217686,0.05153193085304032,652,"Your continual humming of Sammy Davis Jr.'s ' The Candy Man Can' is giving me a hallucinations."""
74,1529,14,22,111,147,1.3401360544217686,0.053309622186558735,652,"If we go for it, do you think we'll get our just deserts, or just desserts?"
2180,1529,15,20,112,147,1.3401360544217686,0.05417659806400905,652,We’d need a sweet ride to get over there
1259,1536,10,31,109,150,1.34,0.048998927075866984,652,I say it's a highly decorated Portuguese man-o-war
2362,1536,10,31,109,150,1.34,0.048998927075866984,652,"Now that wasn't there yesterday."""
4455,1536,10,31,109,150,1.34,0.048998927075866984,652,"As you typed in our destination, I told you there was another s."
6991,1536,4,43,103,150,1.34,0.043173859022657204,652,They told me in dental school there would be days like this.
7285,1536,13,25,112,150,1.34,0.05166576458763634,652,Just our luck we're on the DESERT island...
6169,1541,10,32,111,153,1.3398692810457515,0.0483325314804936,652,We look just as tasty to them.
5778,1541,12,28,113,153,1.3398692810457515,0.05008025782006232,652,"Larry, there’s a time and there’s a place to talk about New Year’s resolutions..."
9714,1541,11,30,112,153,1.3398692810457515,0.04921415356702184,652,Now it's just mocking us.
5223,1544,11,31,114,156,1.3397435897435896,0.04854951074451131,652,"Mirage or not, I've gained five pounds just looking at it."
206,1545,7,40,112,159,1.3396226415094339,0.04446086441168413,652,"But you have to admit, the coconuts were pretty good."
211,1545,12,30,117,159,1.3396226415094339,0.048732185911717525,652,"A desert island or a dessert island, that is the question."
2418,1545,9,36,114,159,1.3396226415094339,0.046216787599682604,652,"I was hoping for the land of milk and honey, but castaways can't be choosers."
2491,1545,10,34,115,159,1.3396226415094339,0.047070191755868004,652,We should've upgraded to the all-inclusive package.
2665,1545,10,34,115,159,1.3396226415094339,0.047070191755868004,652,Too bad we didn’t bring our suits.
8206,1545,11,32,116,159,1.3396226415094339,0.047908396423113474,652,Know what? I just don't know if I have yet another damn kids party in me.
3185,1551,9,39,120,168,1.3392857142857142,0.04454115875697887,652,I’ve always dreamed of living on a dessert island.
9691,1551,13,31,124,168,1.3392857142857142,0.0476346388790053,652,It's a pretty sweet island.
2942,1553,12,36,129,177,1.3389830508474576,0.04520576456758275,652,I'm just saying some puns are best left unspoken.
5592,1554,5,31,85,121,1.3388429752066116,0.0505530283843046,652,Reminds me of a woodland cottage I visited when I was a kid.
7679,1554,8,25,88,121,1.3388429752066116,0.05448698761466057,652,I didn't believe global sea levels were rising until I saw the Big Rock Candy Mountain.
6809,1556,11,20,93,124,1.3387096774193548,0.05712664483626097,652,So it IS possible to be stranded on a dessert island.
7356,1556,10,22,92,124,1.3387096774193548,0.055967161860208725,652,"We're so lucky to have found this 100% organic, non-GMO, Paleo friendly island."
8097,1556,10,22,92,124,1.3387096774193548,0.055967161860208725,652,Is it just deserts or just desserts?
2504,1559,10,23,94,127,1.3385826771653544,0.05501982058800191,652,I wish I'd persevered with swimming lessons.
2666,1559,10,23,94,127,1.3385826771653544,0.05501982058800191,652,Oh look! Its America.
5216,1559,12,19,96,127,1.3385826771653544,0.057246392125981885,652,"I’d swim over, but those are gummy shark infested waters."
9039,1562,10,24,96,130,1.3384615384615384,0.05411382486026369,652,"Well we better start swimming, because your head's beginning to look like a brownie."
4011,1562,9,26,95,130,1.3384615384615384,0.05300042883440123,652,Ironic. Childhood game meets iconic New Yorker cartoon.
2336,1562,9,26,95,130,1.3384615384615384,0.05300042883440123,652,If there was ice cream I'd consider it.
5274,1565,8,29,96,133,1.3383458646616542,0.0510621051156951,652,"WE'RE SAILORS, you said. 
REAL SAILORS DON'T NEED TO LEARN HOW TO SWIM, you said."
96,1566,10,26,100,136,1.338235294117647,0.05241508147825307,652,"Don't be fooled, it's protected by Gummi Bears."
880,1566,9,28,99,136,1.338235294117647,0.05136543881344994,652,If only we had The Good Ship Lollipop.
5807,1566,10,26,100,136,1.338235294117647,0.05241508147825307,652,"Next time, let’s go all-inclusive."
7547,1566,8,30,98,136,1.338235294117647,0.05029389468538534,652,Somewhere out there my mother is waiting to ask if I really think I need that cake.
85,1570,10,27,102,139,1.3381294964028776,0.05161751978664064,652,What a difference a letter makes
156,1570,10,27,102,139,1.3381294964028776,0.05161751978664064,652,Apparently spellcheck doesn't work in dreams.
9283,1570,8,31,100,139,1.3381294964028776,0.049556427633694645,652,I think I like the Hula Girl hallucination better.
7824,1573,10,28,104,142,1.3380281690140845,0.050851626499619204,652,I just want some sushi.
3917,1573,5,38,99,142,1.3380281690140845,0.045677536200210526,652,Remember Hansel and Gretel?
1964,1573,10,28,104,142,1.3380281690140845,0.050851626499619204,652,"I understand, but I think it’s important to be satisfied with what you have."
886,1576,12,25,108,145,1.3379310344827586,0.05199164541562593,652,Are you nuts? Haven't you ever read Hansel and Gretel?
3425,1576,10,29,106,145,1.3379310344827586,0.05011546978526813,652,Our last wish and you have to misspell dessert!
4700,1576,12,25,108,145,1.3379310344827586,0.05199164541562593,652,I don't know---looks like a lot less shade.
5534,1576,10,29,106,145,1.3379310344827586,0.05011546978526813,652,"I thought you said ""dessert island."""
5923,1576,7,35,103,145,1.3379310344827586,0.047161467215927906,652,"Oh, just for once, Claire, let the diet go."
8245,1576,11,27,107,145,1.3379310344827586,0.051062175359175115,652,It's not 'between meals' if it takes all day to get there.
8693,1582,7,36,105,148,1.337837837837838,0.04653270576522762,652,Probably too many kids over there.
7681,1582,10,30,108,148,1.337837837837838,0.04940727371455494,652,OK -- but I still see women drinking beer.
5319,1582,12,26,110,148,1.337837837837838,0.051234129470689956,652,"It’s a dessert mirage, John, and it’s much worse than a desert mirage."
327,1582,10,30,108,148,1.337837837837838,0.04940727371455494,652,I'm more a 'savoury' person.
1707,1582,12,26,110,148,1.337837837837838,0.051234129470689956,652,"And to think, we could be on a dessert island."
1685,1582,11,28,109,148,1.337837837837838,0.05032899124026018,652,Gene Wilder. You?
5213,1582,11,28,109,148,1.337837837837838,0.05032899124026018,652,I told you my fantasy was to be stuck on a desserted island.
639,1589,11,29,111,151,1.3377483443708609,0.049623231419971964,652,"You know it's two palm trees 
and a couple of guys just like us, right?"
2887,1589,8,35,108,151,1.3377483443708609,0.04687818719093601,652,"You go, you gorge, you wait a half hour, and then you swim back."
6969,1589,7,37,107,151,1.3377483443708609,0.04592672657133192,652,It's a mirage.  We've been living on sushi for weeks.
9616,1589,10,31,110,151,1.3377483443708609,0.04872540277729411,652,The sharks out here never stop trying.
416,1593,11,30,113,154,1.3376623376623376,0.0489433196416195,652,I said deserted island.
1080,1593,10,32,112,154,1.3376623376623376,0.0480683482108354,652,"No. See, this one is ""deserted"". No extra ""s""."
1703,1593,10,32,112,154,1.3376623376623376,0.0480683482108354,652,It's just as well; neither of us has a toothbrush.
257,1596,13,27,117,157,1.3375796178343948,0.0499502775202488,652,One ‘s’ makes a helluva difference.
6016,1597,10,34,116,160,1.3375,0.046823215630844676,652,The swim should cancel out the calories
6732,1597,7,40,113,160,1.3375,0.04423306981669715,652,"Yeah, but the wi-fi is lousy."
5506,1599,10,35,118,163,1.3374233128834356,0.04623265155504615,652,"I would, but I didn't bring my toothbrush."
5336,1599,16,23,124,163,1.3374233128834356,0.05091070852034858,652,If only there was a root beer float.
8515,1601,14,28,124,166,1.3373493975903614,0.04875538698012344,652,"No point, it looks deserted."
3065,1601,8,40,118,166,1.3373493975903614,0.044033755901749815,652,It's more fun than Easter Island
1532,1603,12,34,126,172,1.3372093023255813,0.04607609219284747,652,We've been dessert-ed.
4255,1604,14,31,130,175,1.3371428571428572,0.046945649120889325,652,"I saw sharks in the water, but now I'm thinking they're gummy sharks."
4902,1604,14,31,130,175,1.3371428571428572,0.046945649120889325,652,The Ancient Mariners called it Diabetes Island.
2334,1606,8,23,85,116,1.3362068965517242,0.05603592432697633,652,I had no idea stranded on a dessert island was even an option.
239,1607,13,16,96,125,1.336,0.05896308303752716,652,I always knew dessert island was more than just a typo.
9054,1608,7,29,92,128,1.3359375,0.05116427888487294,652,What lousy luck--we could've washed up on a dessert island.
9683,1608,8,27,93,128,1.3359375,0.05235279295197198,652,It’s our just desserts.
1733,1610,9,26,96,131,1.3358778625954197,0.05265771213634361,652,Well I think we’ve earned a cheat meal by now.
8907,1610,10,24,97,131,1.3358778625954197,0.053761272860027506,652,We're deserted. We could be desserted.
9953,1612,7,31,96,134,1.335820895522388,0.04962436595252058,652,"But no, you wanted the no-frills island vacation!"
9343,1612,11,23,100,134,1.335820895522388,0.05395795676937624,652,Why couldn't we have ended up on a dessert island?!?
193,1612,9,27,98,134,1.335820895522388,0.051836467833541476,652,"No, can't be.  New Yorker editors would have caught that typo."
5236,1612,8,29,97,134,1.335820895522388,0.05074247280950872,652,I was seriously hoping you could swim.
471,1616,10,26,101,137,1.3357664233576643,0.05208962396417183,652,"I'm not scared, I just don't have a toothbrush."
4197,1616,9,28,100,137,1.3357664233576643,0.05104886597930505,652,"Of all the desert islands cartoons clichés, in all the world, we had to wash up here."
4776,1616,8,30,99,137,1.3357664233576643,0.04998644327032355,652,The sharks are getting smarter every day.
7378,1616,11,24,102,137,1.3357664233576643,0.05310999088386854,652,"Francine was delicious, but I have a hankering for something sweet."
4306,1620,13,21,106,140,1.3357142857142856,0.05422604499100334,652,Is it worth burning our skin in the hot fudge to get there?
3762,1620,6,35,99,140,1.3357142857142856,0.047127905692218745,652,It evokes The Grass is Greener... but with the threat of drowning.
1179,1620,9,29,102,140,1.3357142857142856,0.05029278540398302,652,The Candy Man can.
930,1620,13,21,106,140,1.3357142857142856,0.05422604499100334,652,I knew we should have upgraded.....
3894,1624,12,24,107,143,1.3356643356643356,0.05246232432573511,652,I say here—that island is desserted.
4544,1624,9,30,104,143,1.3356643356643356,0.04956628193580806,652,The Rockettes. Why? What do you see?
6707,1624,11,26,106,143,1.3356643356643356,0.05151506980893147,652,It's really my fault--when I was seven I wished for this.
3487,1627,12,25,109,146,1.3356164383561644,0.051686162111617785,652,Learning to swim would've been sweet.
2737,1627,8,33,105,146,1.3356164383561644,0.0478911903033344,652,"I don't know, how do they pair with fish?"
4471,1627,11,27,108,146,1.3356164383561644,0.05076402311222854,652,I've got a craving for something salty.
99,1627,9,31,106,146,1.3356164383561644,0.048867570227705735,652,I said the DESSERT island would be fun.
1137,1627,9,31,106,146,1.3356164383561644,0.048867570227705735,652,"Just deserts, you say?"
164,1632,12,26,111,149,1.3355704697986577,0.05093960090020773,652,It's the wreck of the Good Ship Lollipop.
1143,1632,13,24,112,149,1.3355704697986577,0.05182217345345184,652,"'Let's take a cruise, Hansel,' you said. 'What could possibly happen?' you said."
5979,1632,13,24,112,149,1.3355704697986577,0.05182217345345184,652,We will totally burn off the calories when we swim back.
7344,1632,10,30,109,149,1.3355704697986577,0.04912691214332562,652,Did you run spell check when you booked our reservations for Dessert Island?
9406,1632,7,36,106,149,1.3355704697986577,0.04627493200466555,652,"Maybe it’s a typo, but desserted was a common misspelling in the days before autocorrect."
4467,1637,13,25,114,152,1.3355263157894737,0.0510810963324424,652,"Our island is deserted, theirs is desserted."
9098,1638,8,36,111,155,1.335483870967742,0.04602090502814394,652,"My bad.  When I saw 'dessert island' on the map, I thought it was a typo."
6982,1638,10,32,113,155,1.335483870967742,0.047806882984902835,652,It's all artificial. We have a tree.
1112,1638,8,36,111,155,1.335483870967742,0.04602090502814394,652,"Hal, is this your mirage or mine?"
407,1638,10,32,113,155,1.335483870967742,0.047806882984902835,652,At least we have a choice: death by starvation or death by diabetes.
3604,1638,8,36,111,155,1.335483870967742,0.04602090502814394,652,"I don't know Mark, I feel more like chips and guac."
1953,1643,7,39,112,158,1.3354430379746836,0.04454501774922074,652,I think it is a trap. Looks all artificially sweetened.
3151,1643,11,31,116,158,1.3354430379746836,0.048028754164689526,652,So it WAS the Good Ship Lollipop that went down in last night’s storm.
3483,1643,13,27,118,158,1.3354430379746836,0.04967909557126696,652,Let's wait for our cheat day
4239,1643,6,41,111,158,1.3354430379746836,0.04363064234222255,652,"Don’t worry, we’ll work the calories off on the way back"
9885,1643,6,41,111,158,1.3354430379746836,0.04363064234222255,652,That other island looks pretty sweet.
1133,1648,8,38,115,161,1.3354037267080745,0.044880880450782396,652,"On the other hand, the swim over would burn off the calories."
8954,1648,11,32,118,161,1.3354037267080745,0.047404774914514745,652,"Well we’d burn off the calories swimming over, right?"
2227,1650,15,26,126,167,1.3353293413173652,0.0492427165877266,652,You said if we built this people would come.
4040,1650,12,32,123,167,1.3353293413173652,0.046993728690762585,652,Bring me back one with sprinkles.
1479,1652,11,35,124,170,1.3352941176470587,0.04565653462528092,652,But how do you KNOW it's a mirage?
6473,1653,11,24,103,138,1.3333333333333333,0.052779842430491886,652,Surviving over there would be a cakewalk.
6207,1653,12,24,108,144,1.3333333333333333,0.05214885156456199,652,"I know it looks good, but trust me, it's all coconut."
6022,1653,13,23,111,147,1.3333333333333333,0.05228301346252807,652,Are you sure those last painkillers were advil?
5892,1653,11,26,107,144,1.3333333333333333,0.05120915564991892,652,What if they're wrong about sugar?
4521,1653,8,39,118,165,1.3333333333333333,0.0441168016768513,652,I don’t see it.
5609,1653,13,18,101,132,1.3333333333333333,0.056567997263842845,652,"It used to be 'The Big Rock Candy Mountain', before global warming."
5291,1653,7,33,101,141,1.3333333333333333,0.04792203507216295,652,What is the one thing you’d want with you if you were stranded on a desserted island?
4803,1653,11,23,101,135,1.3333333333333333,0.0536145158268927,652,"As hallucinations go, this is a great one."
6846,1653,12,25,110,147,1.3333333333333333,0.05138409809082317,652,I try to avoid the candy isle.
5782,1653,10,25,100,135,1.3333333333333333,0.05257335815637598,652,I’m finally at my perfect weight so it’s a good thing that I can’t swim.
7063,1653,12,24,108,144,1.3333333333333333,0.05214885156456199,652,Just empty calories.
8114,1653,11,27,109,147,1.3333333333333333,0.05046917451763784,652,It was the good ship Lollipop until it sank.
7283,1653,7,31,97,135,1.3333333333333333,0.04931818152870151,652,Still think those swim lessons are 'dumb and unnecessary?'
7307,1653,8,29,98,135,1.3333333333333333,0.05042659366655156,652,We finally found the world’s most dessert-ed island!
7320,1653,10,31,112,153,1.3333333333333333,0.04818694246524266,652,We should have specified 'desserted.'
8094,1653,9,29,103,141,1.3333333333333333,0.04999155619347184,652,The question is...do the sharks want us as much as we want candy.
8670,1653,9,26,97,132,1.3333333333333333,0.052319180330223085,652,"Exactly. That's where Louis Stevenson wrote ""Dessert Island""."
9045,1653,13,23,111,147,1.3333333333333333,0.05228301346252807,652,I'll pass.  I'm still queasy from eating this island.
9428,1653,9,32,109,150,1.3333333333333333,0.04792487285046288,652,Five dollar delivery fee? Forget about it.
9457,1653,9,33,111,153,1.3333333333333333,0.047286172525835744,652,"Don’t get me wrong, it’s nice.   I’m just uncomfortable with the gentrification."
9803,1653,11,23,101,135,1.3333333333333333,0.0536145158268927,652,At least we don't have an ant problem
7169,1653,5,34,93,132,1.3333333333333333,0.047693342789226593,652,It was settled in 1934 when Shirley Temple ran aground.
4390,1653,9,30,105,144,1.3333333333333333,0.04927603299909022,652,"I heard it’s for “Survivor”, the pastry chef season"
4450,1653,9,31,107,147,1.3333333333333333,0.04858766979657162,652,Trust me. It’s time to eat gluten again.
475,1653,10,37,124,171,1.3333333333333333,0.04466748301088491,652,Please don't try to sugar-coat our situation.
203,1653,9,28,101,138,1.3333333333333333,0.05073597068543737,652,And I thought “Dessert Island” was a typo.
248,1653,9,35,115,159,1.3333333333333333,0.04607573356985444,652,Maybe we should consider a cheat day.
458,1653,9,33,111,153,1.3333333333333333,0.047286172525835744,652,I may have not proofread the email to the travel agent
470,1653,11,28,111,150,1.3333333333333333,0.04975705331869026,652,"No, you’ll ruin your appetite for Dinner Island."
4336,1653,10,30,110,150,1.3333333333333333,0.048849553696487434,652,Kind of ironic that both of us are diabetic.
688,1653,11,30,115,156,1.3333333333333333,0.04841006715135932,652,"Finally, I have imagined something that might possibly be tastier than you."
1429,1653,9,33,111,153,1.3333333333333333,0.047286172525835744,652,After you do your chores.
1583,1653,9,24,93,126,1.3333333333333333,0.05404289889185184,652,I always forget.  Are we stranded on the ‘desert’ or ‘dessert’ island?
1929,1653,10,28,106,144,1.3333333333333333,0.050251890762960605,652,I can't believe I'm stuck here with my dentist!
2003,1653,10,24,98,132,1.3333333333333333,0.05341307940411538,652,I still don't get why you swam to THIS island.
959,1653,14,19,108,141,1.3333333333333333,0.054824641390652476,652,Wow! Who'd think fermented coconut milk could do this.
2083,1653,11,27,109,147,1.3333333333333333,0.05046917451763784,652,Where's the beef?
2030,1653,10,24,98,132,1.3333333333333333,0.05341307940411538,652,Just my luck. Stranded here with my dentist.
3682,1653,9,29,103,141,1.3333333333333333,0.04999155619347184,652,"Cavities, diabetes or starvation ? At least we have choices!"
3525,1653,11,29,113,153,1.3333333333333333,0.049071180301212554,652,You wished for candy?
3409,1653,7,34,103,144,1.3333333333333333,0.04726391048016693,652,"Aww, you remembered."
3323,1653,8,29,98,135,1.3333333333333333,0.05042659366655156,652,Spelling and pronunciation are vital. It thinks it's a dessert island.
4323,1653,8,32,104,144,1.3333333333333333,0.04828045495852676,652,"Just as well, my insulin went down with the ship."
2835,1653,10,31,112,153,1.3333333333333333,0.04818694246524266,652,Sweet dreams are made of this....
2305,1653,11,27,109,147,1.3333333333333333,0.05046917451763784,652,It takes will power.
2188,1653,10,26,102,138,1.3333333333333333,0.05176799439992394,652,Really? Wish I had your imagination. I'm just seeing the old cliche turkey and all the trimmings.
2944,1653,7,32,99,138,1.3333333333333333,0.04860623083308938,652,You leave out one lousy ‘S’!
5097,1700,16,26,133,175,1.3314285714285714,0.04821174657304731,652,"Spelling Bee Champion, eh?"
9203,1700,14,30,131,175,1.3314285714285714,0.04682958058364562,652,"Regardless, it’s all just empty calories."
4010,1702,11,35,126,172,1.3313953488372092,0.04520773677190416,652,So. What do you want to talk about?
7546,1702,12,33,127,172,1.3313953488372092,0.045953660572821915,652,Hopefully we'll burn it all off swimming back here.
3032,1704,9,36,118,163,1.3312883435582823,0.04526777836641852,652,The bright side is that we’ll burn all the calories on the swim back
5985,1704,14,26,123,163,1.3312883435582823,0.04927345703749475,652,I'd rather have savory.
8021,1706,13,27,120,160,1.33125,0.04914510906777011,652,That genie is just trolling us now
2548,1706,10,33,117,160,1.33125,0.04668396607700813,652,I just don't want to have to deal with the ants.
3141,1706,13,27,120,160,1.33125,0.04914510906777011,652,"Look,Hansel,we fell for that trap once before and ended up with a homicide charge to answer for."
7597,1706,15,23,122,160,1.33125,0.05071956673400844,652,On second thought I’d prefer diabetes to rising sea levels.
3207,1710,12,28,117,157,1.3312101910828025,0.04898824050702167,652,"Yeah, but the sweets are always sweeter on the other side."
8090,1710,10,32,115,157,1.3312101910828025,0.0472919556935171,652,You think they need any shredded coconut?
574,1710,7,38,112,157,1.3312101910828025,0.0446267982420122,652,And here I thought it was only a board game...
9244,1710,12,28,117,157,1.3312101910828025,0.04898824050702167,652,We're fine as long as the iced caps don't melt.
8019,1714,9,33,112,154,1.3311688311688312,0.04702795395330427,652,Only a fool would embrace socialism when we enjoy all this freedom.
7567,1714,10,31,113,154,1.3311688311688312,0.04792192494941873,652,I guess this is better than being stranded AND getting diabetes.
9836,1714,10,31,113,154,1.3311688311688312,0.04792192494941873,652,Is it a mirage or a merengue?
295,1714,12,27,115,154,1.3311688311688312,0.049661612604756905,652,Why'd we have to have the cartoonist with spell check?
4993,1714,9,33,112,154,1.3311688311688312,0.04702795395330427,652,I would rather DIE than eat processed sugar.
4249,1719,8,34,109,151,1.3311258278145695,0.046721999020400654,652,Life sucks.
8424,1719,9,32,110,151,1.3311258278145695,0.0476575850543528,652,Nice One! My turn. I wish it was a huge flat screen TV.
8455,1719,7,36,108,151,1.3311258278145695,0.045767291505088736,652,"It’s called the North Beach Diet. If you survive the swim, you can eat whatever the hell you want...

Leslie Hardin
summit, NJ"
9869,1719,7,36,108,151,1.3311258278145695,0.045767291505088736,652,"I always thought ""dessert-ed island"" was just a typo."
9137,1723,9,31,108,148,1.3310810810810811,0.04831078670363784,652,"No, it's not a mirage, just another dessert island."
8072,1723,11,27,110,148,1.3310810810810811,0.050177579043222675,652,"Great, now I'll be stranded AND diabetic."
7294,1723,14,21,113,148,1.3310810810810811,0.05285428486613516,652,"Sure it’s sweet, but we’re iconic."
6591,1723,9,31,108,148,1.3310810810810811,0.04831078670363784,652,The quality of our mirages has improved.
3895,1723,7,35,106,148,1.3310810810810811,0.046368898900124,652,This is why diabetics should avoid hallucinogens.
1976,1723,14,21,113,148,1.3310810810810811,0.05285428486613516,652,"This is a diabetic's version of Hell, right?"
9358,1729,12,24,109,145,1.3310344827586207,0.05183895302887211,652,I always hallucinate on day 3 of the keto diet.
9014,1729,8,32,105,145,1.3310344827586207,0.04800140923637036,652,"That's mine, so it's your turn to hallucinate."
8328,1729,9,30,106,145,1.3310344827586207,0.048988985795692164,652,"You couldn’t hallucinate a comely waitress with the dessert cart?
And a friend?  And a boat?"
7785,1729,7,34,104,145,1.3310344827586207,0.04699308298105664,652,"I don't like the way they're looking at us, Carl."
6789,1729,11,26,108,145,1.3310344827586207,0.05090669514431852,652,"'Desert, dessert.' Big difference."
7191,1729,8,32,105,145,1.3310344827586207,0.04800140923637036,652,Tough call. Death by starvation or diabetes?
5707,1729,7,34,104,145,1.3310344827586207,0.04699308298105664,652,How many calories do you suppose we can burn off swimming there and back?
5456,1729,13,22,110,145,1.3310344827586207,0.05275473904534678,652,"Want to hop over to the dessert island?""
""Nah, it's clearly a typo."
1542,1729,7,34,104,145,1.3310344827586207,0.04699308298105664,652,This temptation island diet is tough.
888,1729,13,22,110,145,1.3310344827586207,0.05275473904534678,652,And not a stitch of clothes! What do you see?
6114,1729,12,24,109,145,1.3310344827586207,0.05183895302887211,652,I always thought it was spelled ‘deserted’.
1083,1740,9,29,104,142,1.3309859154929577,0.04969372883209497,652,This makes clear the important difference between desert and dessert.
5529,1740,9,29,104,142,1.3309859154929577,0.04969372883209497,652,Here comes the dessert tray- let's split something!
9013,1740,12,23,107,142,1.3309859154929577,0.05262259066065568,652,"Honestly, I'm more of a Chutes and Ladders guy."
2077,1743,12,22,105,139,1.330935251798561,0.05343823343723684,652,Salt. Fat. Sugar. Definitely from USA.
1090,1743,11,24,104,139,1.330935251798561,0.05245360214834921,652,Don't worry. We'll burn it off swimming back.
2168,1743,8,30,101,139,1.330935251798561,0.04938205275878442,652,I must be hypoglycemic Joe.  I think I'm seeing a dessert island.
4621,1743,8,30,101,139,1.330935251798561,0.04938205275878442,652,...but you just know the cake has a soggy bottom.
7761,1743,12,22,105,139,1.330935251798561,0.05343823343723684,652,"Is it correct to say ""desserted' island?"
6446,1748,6,33,97,136,1.3308823529411764,0.047891429340009714,652,They say the Good Ship Lollipop went down in these parts.
5465,1748,7,31,98,136,1.3308823529411764,0.049015522705595845,652,I just look and I gain 10 pounds!
6944,1748,11,23,102,136,1.3308823529411764,0.053275241093751376,652,Either that's a mirage or we're suddenly in a Far Side cartoon.
3700,1748,10,25,101,136,1.3308823529411764,0.052242883263882905,652,"When will you realize that dessert has two ""s's"" and not one?"
3240,1748,10,25,101,136,1.3308823529411764,0.052242883263882905,652,I sure wish we had ended up on the dessert island instead.
4927,1748,8,29,99,136,1.3308823529411764,0.0501144083869741,652,At least we've got a sweet view...
5185,1754,6,32,95,133,1.330827067669173,0.04858654281797334,652,Just our luck. We could have been marooned on a dessert island.
5555,1754,12,20,101,133,1.330827067669173,0.055174080348649485,652,"“No, it’s not your imagination, it’s your grammar.”"
2404,1754,9,26,98,133,1.330827067669173,0.05198476356261508,652,Why couldn't we have landed on a dessert island?
5062,1757,10,23,97,130,1.3307692307692307,0.05393127270081415,652,"Sure we could, but it would spoil our supper."
5745,1757,10,23,97,130,1.3307692307692307,0.05393127270081415,652,Why couldn't we get stranded on the dessert island?
8835,1757,6,31,93,130,1.3307692307692307,0.049310646290858205,652,"Sure, it looks like a good idea now, but you'll feel terrible in the morning."
1889,1760,6,30,91,127,1.330708661417323,0.05006572122444969,652,"They did try to offer us a sweeter package, Jim."
6546,1761,11,18,92,121,1.3305785123966942,0.057959363735613986,652,Just our luck to have washed up on the desert island instead of the dessert island.
2765,1762,10,18,87,115,1.3304347826086957,0.05887547672018421,652,Maybe I should have just wished for a rescue ship.
988,1763,13,29,125,167,1.3293413173652695,0.04762834510883663,652,You go on ahead. I’m more of a ‘savory’ person.
632,1763,13,29,125,167,1.3293413173652695,0.04762834510883663,652,I wish we were stranded on the dessert island.
6858,1763,9,37,121,167,1.3293413173652695,0.04449584014529403,652,"Until now, I never realized how important an s could be."
657,1766,11,31,119,161,1.329192546583851,0.04726724398238232,652,Really?  I see Kate Upton and Jennifer Lawrence.
1156,1766,12,29,120,161,1.329192546583851,0.04808151521367492,652,I believe those are the Dutch West Candies.
8612,1766,9,35,117,161,1.329192546583851,0.045595096782268904,652,I won’t tell if you won’t.
8052,1769,12,28,118,158,1.3291139240506329,0.04872231751831683,652,Still prefer the tropical vibe?
8029,1769,10,32,116,158,1.3291139240506329,0.047038419554538476,652,"I don't have to swim faster than the sharks.
I just have to swim faster than you."
8475,1769,10,32,116,158,1.3291139240506329,0.047038419554538476,652,Is it deserted or desserted?
5080,1769,13,26,119,158,1.3291139240506329,0.04954280855421027,652,How was I to know that wishes came with spellcheck?
7587,1769,10,32,116,158,1.3291139240506329,0.047038419554538476,652,That Lollipop.  She sure was a good ship.
1430,1769,8,36,114,158,1.3291139240506329,0.045291959595737216,652,That's the Pinterest version.
1087,1769,15,22,121,158,1.3291139240506329,0.05114431727578368,652,I hated that game
581,1769,14,24,120,158,1.3291139240506329,0.05034993082937233,652,"Well, at least the realtor wasn't lying about the sweet view."
1680,1769,9,34,115,158,1.3291139240506329,0.046173447554902596,652,You'll spoil your appetite.
827,1778,10,31,114,155,1.3290322580645162,0.04765966257639778,652,"We could get there, if only we had some chutes and ladders."
2249,1778,12,27,116,155,1.3290322580645162,0.04938641309124241,652,"Hmm...choices, choices: a desert island or a  dessert island?"
2901,1778,9,33,113,155,1.3290322580645162,0.046772387755327584,652,"If the sharks don't get you, the diabetes will."
5178,1778,12,27,116,155,1.3290322580645162,0.04938641309124241,652,We'd probably die faster there.
2037,1782,8,34,110,152,1.3289473684210527,0.04646469535822661,652,"If anyone deserves a pass on breaking New Year's resolutions, it's us."
1649,1782,15,20,117,152,1.3289473684210527,0.05262068552306724,652,Here me out. The candy canes will work as paddles and I’m pretty sure the donut will float.
2635,1782,11,28,113,152,1.3289473684210527,0.049197388568447756,652,"Big Rock Candy Mountain,  post climate change."
9123,1782,11,28,113,152,1.3289473684210527,0.049197388568447756,652,But no! You wouldn’t take the upgrade!
9453,1782,6,38,108,152,1.3289473684210527,0.0445498727635832,652,"If we swim there and back, we ‘ll work off the sugar and carbs."
9895,1782,10,30,112,152,1.3289473684210527,0.04830367135336772,652,I was thinking maybe a nine iron.
4581,1788,12,25,112,149,1.3288590604026846,0.050790015797498644,652,They’re the survivors of the Good Ship Lollipop.
3646,1788,10,29,110,149,1.3288590604026846,0.04897179046732671,652,Let's grab a treat and then wait for the girl mirage to return.
5391,1788,9,31,109,149,1.3288590604026846,0.04803687687608914,652,"Just our luck to land on the DESERT island, rather than the DESSERT island!"
2061,1788,9,31,109,149,1.3288590604026846,0.04803687687608914,652,"Given a choice, I'd rather be stranded on a dessert island."
2840,1788,8,33,108,149,1.3288590604026846,0.04708340279165624,652,Is that the good ship lollipop or am I hallucinating again?
6595,1788,11,27,111,149,1.3288590604026846,0.049889187036300325,652,"It's a simple plan. Let me spell it out. We leave this desert island, and go to the dessert island!"
4834,1794,9,30,107,146,1.3287671232876712,0.04870509236037227,652,Must be American
9246,1794,7,34,105,146,1.3287671232876712,0.04672514739680628,652,Could be shark bait.
4478,1794,7,34,105,146,1.3287671232876712,0.04672514739680628,652,We’re on the wrong desserted island.
1475,1794,11,26,109,146,1.3287671232876712,0.050607634250293854,652,"Well, we have the tree."
3091,1794,8,32,106,146,1.3287671232876712,0.0477253885321307,652,Candy Crush withdrawal will do that to you.
2364,1794,12,24,110,146,1.3287671232876712,0.051532571793973914,652,It's a common typo mirage.
3337,1794,5,38,103,146,1.3287671232876712,0.04465750526702259,652,I'm waiting until Lent is over.
948,1801,12,23,108,143,1.3286713286713288,0.05230454254186266,652,"Mirage or not, I'm going for it."
2675,1801,11,25,107,143,1.3286713286713288,0.0513543777517943,652,Talk about a Desserted Island....
4065,1801,10,27,106,143,1.3286713286713288,0.05038629831645157,652,"That mirage must be yours because mine is wine ,women and song."
5852,1801,10,27,106,143,1.3286713286713288,0.05038629831645157,652,Ok ok that’s your fantasy. Now let’s do mine again.
6061,1801,9,29,105,143,1.3286713286713288,0.04939925102463513,652,It hasn’t moved in at least twenty minutes.  Maybe we should go for it.
2490,1806,12,22,106,140,1.3285714285714285,0.053107791589643384,652,"You know, I just don't have the sweet tooth that I used to."
4272,1806,10,26,104,140,1.3285714285714285,0.051135972482112636,652,"I didn't think they were serious when they said ""dessert-ed island vacation""..."
4373,1806,9,28,103,140,1.3285714285714285,0.05012098122316215,652,"What did you expect, The Good Ship Lollipop?"
443,1809,9,27,101,137,1.3284671532846715,0.05087205287110615,652,Must be part of the Pacific Ocean garbage patch.
2493,1809,6,33,98,137,1.3284671532846715,0.04760188171126531,652,I’m more of a savory guy.
2781,1809,10,25,102,137,1.3284671532846715,0.05191635551804841,652,I meant THAT kind of desserted island.
9027,1809,9,27,101,137,1.3284671532846715,0.05087205287110615,652,"I'd love to, but I have to keep my beach body."
9758,1813,7,30,97,134,1.328358208955224,0.04943414450470018,652,"The next time we order a vacation package, we really have to double-check our spelling."
9955,1813,10,24,100,134,1.328358208955224,0.05272947178584024,652,Russian sub?
3439,1813,15,14,105,134,1.328358208955224,0.05780572158518533,652,"Now THAT'S what I call a ""desserted"" island! Ha Ha Ha. Am I right? Jeff? Jeffery?"
1153,1816,10,23,98,131,1.3282442748091603,0.0535775302061888,652,"Sweet view, isn’t it?"
4657,1816,6,31,94,131,1.3282442748091603,0.048997882552309045,652,I would try but I’m afraid of the Gummi sharks.
6404,1816,9,25,97,131,1.3282442748091603,0.05247010511613992,652,Not interested. Swimsuit Season is right around the corner.
7693,1816,8,27,96,131,1.3282442748091603,0.0513387974031577,652,Looks tempting but maybe we should wait for Bill to come back.
8972,1816,11,21,99,131,1.3282442748091603,0.05466252422904905,652,Now we know what happened to the Good Ship Lollipop.
9882,1816,9,25,97,131,1.3282442748091603,0.05247010511613992,652,"God, I'm sick of coconut."
8736,1822,8,26,94,128,1.328125,0.05215505232734137,652,"You go ahead, I'm watching my sugar."
8264,1822,8,26,94,128,1.328125,0.05215505232734137,652,That whale will do anything for attention.
6733,1824,6,28,88,122,1.3278688524590163,0.051323920589337,652,Amazon's same day dessert tray delivery anywhere on earth is here.
3650,1825,11,34,126,171,1.327485380116959,0.04530249160053703,652,"Frankly, I'm more of a savory guy."
869,1826,11,32,122,165,1.3272727272727274,0.046427140834147104,652,"Yeah,
 that's where the Good Ship Lollipop ran aground."
9734,1826,12,30,123,165,1.3272727272727274,0.04721640854661778,652,"Although clearly tempting, they were not sure they should visit Hansel and Gretel Island"
3778,1828,13,27,122,162,1.3271604938271604,0.04862202631162742,652,Taxes are cheaper here.
5175,1828,12,29,121,162,1.3271604938271604,0.04782698199287786,652,That second 'S' makes all the difference.
6212,1828,11,31,120,162,1.3271604938271604,0.0470184960461895,652,Honestly I was hoping I’d see naked ladies.
5750,1831,10,31,115,156,1.3269230769230769,0.047400116163145614,652,It's Weight Watchers new desert island program.
5190,1831,9,33,114,156,1.3269230769230769,0.046519437081083706,652,We're so close I can almost taste it.
6629,1831,11,29,116,156,1.3269230769230769,0.04826472830358097,652,"Desert the deserted desert island for the deserted desserts island - say it ten times fast. And then, let's do it."
1431,1831,8,35,113,156,1.3269230769230769,0.04562176060173602,652,"The Realtor did say we were ""Candyland adjacent."""
5057,1831,12,27,117,156,1.3269230769230769,0.04911412204404435,652,"Yes, I see the irony - you're diabetic and I can't swim. So, move it."
4175,1836,12,26,115,153,1.326797385620915,0.04979323032289373,652,That wasn't a typo after all.
4828,1836,10,30,113,153,1.326797385620915,0.04803506179841696,652,"As mirages go, this one is pretty lush."
7386,1836,8,34,111,153,1.326797385620915,0.04621004801952416,652,"Yeah, but think of the ants."
8156,1836,5,40,108,153,1.326797385620915,0.04332863489599247,652,Some dessert islands are better than others.
5694,1840,13,23,114,150,1.3266666666666667,0.051376285815741204,652,We could try Uber Eats
3187,1840,10,29,111,150,1.3266666666666667,0.048693596790356376,652,It's probably just a misspelling.
6175,1840,10,29,111,150,1.3266666666666667,0.048693596790356376,652,Go ahead if you want. I'm waiting for the Good Ship Lollipop
1870,1840,13,23,114,150,1.3266666666666667,0.051376285815741204,652,"Yeah, I thought I typed Dessert Isle too."
724,1840,10,29,111,150,1.3266666666666667,0.048693596790356376,652,Would it have killed anyone to strand us on the dessert island instead?
3110,1840,12,25,113,150,1.3266666666666667,0.050497893872989946,652,"Of course it's a figment of my imagination, but I'm still gonna post it on Instagram."
1013,1846,10,28,109,147,1.3265306122448979,0.04937713361303561,652,"They look great from a distance, but up close it's just seeds and flower petals pasted on to styrofoam shapes."
2520,1846,11,26,110,147,1.3265306122448979,0.050311919899315355,652,Lucky we're in their delivery area
6569,1846,11,26,110,147,1.3265306122448979,0.050311919899315355,652,"Before climate change, it was a sugar candy mountain."
7891,1846,10,28,109,147,1.3265306122448979,0.04937713361303561,652,"I told you when you booked, ""Dessert Island,"" two s's. But no."
2512,1850,11,25,108,144,1.3263888888888888,0.05104755494898393,652,Let's see who can go longer without thinking about it.
9423,1850,12,23,109,144,1.3263888888888888,0.051990171796163845,652,It's all yours; I'm waiting for the Good Ship Lollipop.
9293,1850,8,31,105,144,1.3263888888888888,0.048109017604751,652,"If we're not rescued soon, I'm going to have to rethink the low carb diet."
8451,1850,12,23,109,144,1.3263888888888888,0.051990171796163845,652,I say no. They don't have milk.
9535,1850,10,27,107,144,1.3263888888888888,0.050087201650166446,652,"You're being tested, bro.  Keto is a commitment!"
3589,1850,8,31,105,144,1.3263888888888888,0.048109017604751,652,The neighbor's island always looks sweeter.
2503,1850,12,23,109,144,1.3263888888888888,0.051990171796163845,652,Ironic that we're on a desert island and that is a dessert island
774,1850,11,25,108,144,1.3263888888888888,0.05104755494898393,652,Is it a trick or treat?
1906,1850,11,25,108,144,1.3263888888888888,0.05104755494898393,652,Looks like Global Warming really hit the North Pole hard...
1462,1850,12,23,109,144,1.3263888888888888,0.051990171796163845,652,It's technically not a homophone.
1238,1850,9,29,106,144,1.3263888888888888,0.04910807135308145,652,"When you said South Beach diet, this isn’t what I had in mind."
405,1850,5,37,102,144,1.3263888888888888,0.04497890931891246,652,I’m rethinking my diet.
214,1850,7,33,104,144,1.3263888888888888,0.04708877231112683,652,"I've heard of desert islands, but never dessert islands."
178,1850,8,31,105,144,1.3263888888888888,0.048109017604751,652,See - a good decorator makes the square footage look so much bigger.
1956,1850,13,21,110,144,1.3263888888888888,0.05291600004270663,652,I call it desserted island.
1700,1865,11,24,106,141,1.326241134751773,0.05181258986150916,652,I think we chose the wrong desserted island. This is why spelling is important.
3833,1865,8,30,103,141,1.326241134751773,0.04879132197815311,652,Looks like the Good Ship Lollipop sunk too.
7076,1865,9,28,104,141,1.326241134751773,0.049818773800340825,652,I'm going to wait for the Sandwich Isle.
7089,1865,10,26,105,141,1.326241134751773,0.05082545961979334,652,"It’s too commercial for me anyway. Ours is more gritty and real, like the old Times Square"
8257,1865,11,24,106,141,1.326241134751773,0.05181258986150916,652,I really don’t think the palm tree will care.
4750,1870,8,29,101,138,1.326086956521739,0.0495008871330691,652,"Boy, that island sure looks sweet..."
2150,1870,8,29,101,138,1.326086956521739,0.0495008871330691,652,I’d rather be marooned on a dessert island.
228,1872,10,39,132,181,1.3259668508287292,0.04283104407362277,652,Somebody else's island always looks sweeter.
8359,1873,8,28,99,135,1.325925925925926,0.05023948135648347,652,I just don't feel like I have room for dessert.
6746,1873,10,24,101,135,1.325925925925926,0.0523939130624497,652,I don’t know. What do you think men fantasize about?
6518,1873,9,26,100,135,1.325925925925926,0.05132800216725753,652,Let's hope it's a stopover for the Good Ship Lollipop.
7198,1873,9,26,100,135,1.325925925925926,0.05132800216725753,652,"As your dentist, sometimes I’m going to suggest things you’re not going to like."
1912,1873,6,32,97,135,1.325925925925926,0.04798842410354151,652,Look closely...two of those little tarts are eyes.
1417,1873,11,22,102,135,1.325925925925926,0.0534385670233501,652,"You were the one who said ""we'll need shade."""
6511,1873,6,32,97,135,1.325925925925926,0.04798842410354151,652,And you call this a desserted island?
1058,1873,8,28,99,135,1.325925925925926,0.05023948135648347,652,"What a different one ""s"" can make."
5864,1881,8,27,97,132,1.3257575757575757,0.05100903218973246,652,I wish we were on dessert island
2826,1882,11,33,125,169,1.3254437869822486,0.045624479337524976,652,I told you there was a second S
4752,1882,13,29,127,169,1.3254437869822486,0.04714316356683772,652,Do you think sharks can bake?
6468,1882,10,35,124,169,1.3254437869822486,0.044845855289932395,652,And you thought shade would be more important.
7029,1885,7,27,92,126,1.3253968253968254,0.05142955123503252,652,Nah... I'm good. I've just started the Keto Diet.
1113,1885,6,29,91,126,1.3253968253968254,0.050179822770240114,652,Guess our island isn't as dessert-ed as we thought
5150,1885,4,33,89,126,1.3253968253968254,0.047581996167504935,652,"So, I have this idea for a boardgame...."
6015,1888,14,25,124,163,1.3251533742331287,0.04914125511307037,652,As a mirage it doesn’t have to meet the Dietary Guidelines.
5011,1889,10,32,118,160,1.325,0.046539021295517756,652,Survivors from the good ship Lollypop
1895,1890,13,25,119,157,1.3248407643312101,0.04967357147632564,652,I'll race you!
3085,1890,9,33,115,157,1.3248407643312101,0.046269065625979565,652,...are you kidding?  all that processed sugar? no way.
8369,1892,8,34,112,154,1.3246753246753247,0.04595802021071944,652,One s makes all the difference in the world.
2361,1892,13,24,117,154,1.3246753246753247,0.05036419175174925,652,"So, we underestimated the sharks."
4220,1892,13,24,117,154,1.3246753246753247,0.05036419175174925,652,I wished to be on a 'dessert' island too. Damn spellcheck!
444,1892,7,36,111,154,1.3246753246753247,0.04502507283575765,652,You go for it.  I’m cutting back on sugar.
317,1892,6,38,110,154,1.3246753246753247,0.04407238076212434,652,"You see it too, right?"
740,1892,10,30,114,154,1.3246753246753247,0.047769284036252045,652,"Careful, it's an iced-berg. Most of the sugar is below the surface."
7687,1898,9,19,86,114,1.3245614035087718,0.05776945603406374,652,If we just had a chute and ladders.
1566,1899,11,27,113,151,1.3245033112582782,0.04932181913913976,652,I thought you said to swim for the desert island.
2307,1899,6,37,108,151,1.3245033112582782,0.04462220007396827,652,"It's just one of those ""the grass is greener"" situations."
2774,1899,10,29,112,151,1.3245033112582782,0.04841840169236755,652,We don't have dental coverage.
3440,1899,13,23,115,151,1.3245033112582782,0.0510807427970181,652,It's always sweeter on the other side.
6266,1899,10,29,112,151,1.3245033112582782,0.04841840169236755,652,S w e e t !
9976,1899,9,31,111,151,1.3245033112582782,0.04749780417759235,652,I’m so happy it came in time for your birthday!
9364,1905,10,28,110,148,1.3243243243243243,0.049091972001957924,652,We were off by one 's'.
8927,1905,10,28,110,148,1.3243243243243243,0.049091972001957924,652,I liked The Food Network better when they were just on cable.
8659,1905,9,30,109,148,1.3243243243243243,0.048146578815984276,652,"Your right, the view is better from over here."
4850,1905,8,32,108,148,1.3243243243243243,0.04718224653751187,652,"Really, George? Of all the times not to use spellcheck?"
2937,1905,7,34,107,148,1.3243243243243243,0.04619778917837212,652,Dang auto correct!
4335,1905,8,32,108,148,1.3243243243243243,0.04718224653751187,652,Is it still considered a cheat meal if you haven't eaten in six days?
3991,1905,10,28,110,148,1.3243243243243243,0.049091972001957924,652,Since I started my cleanse everything looks like junk food.
3354,1905,12,24,112,148,1.3243243243243243,0.050930138835030586,652,It looks like the island is deserted.
4599,1905,9,30,109,148,1.3243243243243243,0.048146578815984276,652,"Okay, so pretend you were stranded on a dessert island..."
6289,1914,13,21,111,145,1.3241379310344827,0.05259798247654046,652,It's a shame what climate change did to the Big Rock Candy Mountain.
8354,1914,6,35,104,145,1.3241379310344827,0.04578263509575732,652,"I’m diabetic and I can’t swim, so it’s a win-win for me!"
4199,1914,7,33,105,145,1.3241379310344827,0.0468170387457846,652,"I say we swim for it. What do you think, Gretel?"
1260,1914,11,25,109,145,1.3241379310344827,0.05074423001067613,652,So it's just another birthday when you can't quite get my gift right.
223,1914,8,31,106,145,1.3241379310344827,0.047829076486352144,652,"We have coconuts, they don't!"
4088,1914,8,31,106,145,1.3241379310344827,0.047829076486352144,652,If only it wasn’t shark week.
2020,1920,10,26,106,142,1.323943661971831,0.050518533658425714,652,The Good Ship Lollipop shipwrecked there.
5673,1920,9,28,105,142,1.323943661971831,0.04952001738822842,652,"Don't be ridiculous, it's swimsuit season."
6117,1920,12,22,108,142,1.323943661971831,0.052458578752493705,652,"Well, Steve, this year you've really gone overboard for Valentine's Day."
6899,1920,10,26,106,142,1.323943661971831,0.050518533658425714,652,You SERIOUSLY didn't see that one when we landed? SERIOUSLY
849,1924,10,25,104,139,1.3237410071942446,0.051274881520466824,652,"I know it's a mirage, but I just like looking at it."
1763,1924,6,33,100,139,1.3237410071942446,0.04703249745353378,652,"On the other hand, dates are higher in fiber, and the palm fronds provide more shade."
2837,1924,6,33,100,139,1.3237410071942446,0.04703249745353378,652,Now look at where your dyslexia has landed us --
6648,1924,10,25,104,139,1.3237410071942446,0.051274881520466824,652,I call it the Mediterranean Diet.
9437,1924,10,25,104,139,1.3237410071942446,0.051274881520466824,652,I don't know...I've been doing really well with my cleanse
9921,1924,8,29,102,139,1.3237410071942446,0.04919943745437834,652,Have we got a chute or a ladder laying around here?
7962,1930,9,26,101,136,1.3235294117647058,0.05100552422255338,652,"'I mean, it's okay. But it's really nothing compared to the Spice Island.'"
8622,1930,9,26,101,136,1.3235294117647058,0.05100552422255338,652,Do you think the ingredients are locally sourced ?
2708,1930,9,26,101,136,1.3235294117647058,0.05100552422255338,652,Brings new meaning to a deserted island
7435,1930,8,28,100,136,1.3235294117647058,0.049926256011680284,652,We never should have skipped those swim lessons
1508,1930,8,28,100,136,1.3235294117647058,0.049926256011680284,652,You go ahead. I don't want to spoil my appetite.
1012,1930,8,28,100,136,1.3235294117647058,0.049926256011680284,652,"You do realize there's not a dentist in 5,000 miles, right?"
2115,1930,7,30,99,136,1.3235294117647058,0.04882313567838718,652,It's either a misspelling or a mirage.
8866,1937,10,34,123,167,1.3233532934131738,0.04516078505285336,652,"""We could call it the Mediterranean Diet, but no one will believe us."
7341,1938,9,25,99,133,1.3233082706766917,0.05179493208604958,652,Looks like it's either climate change or diabetes that will be the end of us!
1705,1938,4,35,94,133,1.3233082706766917,0.04596856705439882,652,Nutritionally we’d still be starving.
2381,1938,13,17,103,133,1.3233082706766917,0.0560214214029729,652,Do you think they want to eat us too?
3914,1938,11,21,101,133,1.3233082706766917,0.053949581304250906,652,I have a sinking feeling it's not gluten-free.
4568,1938,7,29,97,133,1.3233082706766917,0.04954667149963756,652,Some cartoonists just can't spell
2451,1943,9,24,97,130,1.323076923076923,0.05261825097591534,652,Don’t fall for it... the sharks put it there as bait.
4693,1944,14,24,123,161,1.3229813664596273,0.049533918105284194,652,Now we just need the Good Ship Lolipop to get us there
6095,1944,12,28,121,161,1.3229813664596273,0.0479408963178142,652,"Don't blame the travel agent, learn how to spell."
7228,1946,6,29,92,127,1.3228346456692914,0.04984902812264091,652,My survival instinct says yes but my love handles say no.
8512,1946,10,21,96,127,1.3228346456692914,0.054633900763018634,652,Is that a desserted island?
6970,1948,12,27,119,158,1.3227848101265822,0.04857809463183497,652,"I said book the 'dessert' island, not the 'desert' island."
7413,1948,9,33,116,158,1.3227848101265822,0.04602123762796011,652,Did you wish for a desert or a dessert island?
6223,1948,10,31,117,158,1.3227848101265822,0.04688901756160624,652,We probably couldn’t afford the rent anyway.
9046,1948,12,27,119,158,1.3227848101265822,0.04857809463183497,652,Good thing the sharks in these waters don't have any teeth
3584,1952,9,22,93,124,1.3225806451612903,0.05437626087510704,652,"Ya, it’s kinda like
the greener grass thing."
3558,1952,8,34,113,155,1.3225806451612903,0.04570857566673902,652,"Yeah, but do you see any shade?"
2821,1952,8,24,92,124,1.3225806451612903,0.05315681897175748,652,Your third item can't be another island.
2463,1952,11,28,116,155,1.3225806451612903,0.048380114005303135,652,I wonder where Savory island is...
508,1952,6,28,90,124,1.3225806451612903,0.050629899427840026,652,Nah. I'm in the mood for something savory.
3052,1957,9,31,112,152,1.3223684210526316,0.047232556596034904,652,"Sure, it's tempting, but it's a short-term fix."
3410,1957,8,33,111,152,1.3223684210526316,0.04630092900641373,652,Calories don't count when you're far out into international waters
3500,1957,8,33,111,152,1.3223684210526316,0.04630092900641373,652,Just my luck. Stranded and a diabetic!
5943,1957,12,25,115,152,1.3223684210526316,0.04992323637165031,652,I can't believe we're stuck here because you can't spell!
6154,1957,13,23,116,152,1.3223684210526316,0.05078846232718948,652,Even here I have this feeling that the neighbor’s lawn is greener than mine.
9205,1957,10,29,113,152,1.3223684210526316,0.048146160577332814,652,I'm never booking through Expedia ever again.
6361,1963,9,21,91,121,1.322314049586777,0.05531636539068268,652,We could never survive there. Those are all empty calories.
8504,1964,6,36,107,149,1.3221476510067114,0.044940309864732325,652,Stop overthinking it Bob! Just go over there and ask if we can borrow a cup of brown sugar.
7762,1964,12,24,113,149,1.3221476510067114,0.05063397851385358,652,Rising sea levels are even impacting Candy Land!
7118,1964,10,28,111,149,1.3221476510067114,0.048809940965001956,652,You know I can't swim and you're on a diet.
737,1964,12,24,113,149,1.3221476510067114,0.05063397851385358,652,My mother said never take candy from strange islands.
5028,1964,8,32,109,149,1.3221476510067114,0.046915039101258,652,It’s Survivor Candyland...your turn.
4589,1964,8,32,109,149,1.3221476510067114,0.046915039101258,652,"I swear Burt, if you sing “0n the Good Ship Lollipop” one more time, I’ll throw you into the sea."
5826,1964,10,28,111,149,1.3221476510067114,0.048809940965001956,652,Now if only there was an island with gluten free options.
7261,1971,11,25,110,146,1.321917808219178,0.05044434724336882,652,"Sometimes, I just hate being a dentist."
8683,1971,9,29,108,146,1.321917808219178,0.048535405079492736,652,I don't see any chocolate.
5237,1971,12,23,111,146,1.321917808219178,0.05137222479218836,652,I knew that Atkins Island was the wrong choice.
4066,1971,11,25,110,146,1.321917808219178,0.05044434724336882,652,"Personally, I consider 'Dessert Island' to be CBS's most innovative reality series yet."
3474,1971,11,25,110,146,1.321917808219178,0.05044434724336882,652,Maby we should wait 'till after dinner.
3163,1971,8,31,107,146,1.321917808219178,0.04755220536358844,652,"Just our luck, we had to land on the deserted island and not the dessert island."
4813,1971,10,27,109,146,1.321917808219178,0.0494990793603276,652,"Damn you, auto correct."
7095,1978,12,32,130,174,1.3218390804597702,0.045375104658000494,652,But this island had a better Yelp review!
9798,1978,7,42,125,174,1.3218390804597702,0.0415535351377967,652,"If we go there, we can die from gluttony instead of starvation."
6013,1980,10,26,107,143,1.3216783216783217,0.050215137082938524,652,I bet you will burn all these extra calories swimming there and back
848,1980,9,28,106,143,1.3216783216783217,0.04922465780499416,652,"I'm just not into puns, that's all."
3930,1980,8,30,105,143,1.3216783216783217,0.04821383494163514,652,Even the mirage seems contrived.
4509,1980,10,26,107,143,1.3216783216783217,0.050215137082938524,652,"Wrong--I see burgers,fries and a shake."
7264,1980,9,28,106,143,1.3216783216783217,0.04922465780499416,652,Herein lies the difference between desert and dessert.
8802,1980,11,24,108,143,1.3216783216783217,0.05118645375973846,652,I say flotsam from The Good Ship Lollipop.
9672,1980,11,24,108,143,1.3216783216783217,0.05118645375973846,652,"Honestly, it's for the best. I'm trying to get in shape before the summer starts."
3511,1987,10,25,105,140,1.3214285714285714,0.0509598083805325,652,Yeah. That would be sweet.
5091,1987,9,27,104,140,1.3214285714285714,0.04994123694164755,652,I'm still full from the buffet.
7241,1987,10,25,105,140,1.3214285714285714,0.0509598083805325,652,"You go ahead, I'm more of savory guy."
6806,1990,12,29,124,165,1.3212121212121213,0.047078647213937314,652,What do you think? Cheat day?”
9684,1991,9,26,102,137,1.3211678832116789,0.05068689464851234,652,"Sure it's a short swim, but it's through syrup"
5654,1991,6,32,99,137,1.3211678832116789,0.04740395203189354,652,Hey since I left that place I have lost more than 20 pounds ...
2197,1991,13,18,106,137,1.3211678832116789,0.054758835971306846,652,"Careful - it's just a lure. If the sharks don't get you, the dentists will."
861,1991,6,32,99,137,1.3211678832116789,0.04740395203189354,652,"Nah, if we had washed up there we wouldn't be enjoying our Mediterranean fish diet."
977,1995,11,30,121,162,1.3209876543209877,0.04687482003147566,652,Jetsam from the Good Ship Lollipop?
2949,1995,9,34,119,162,1.3209876543209877,0.04520936054380973,652,"Let's just leave it as, ""The Promised Land."""
3164,1995,10,32,120,162,1.3209876543209877,0.0460496201600155,652,I say swim. If it turns out to be rock candy we can still use it to break the coconut up.
6623,1995,11,30,121,162,1.3209876543209877,0.04687482003147566,652,"Every time I think about swimming over there, I remember Hansel and Gretel."
9499,1999,8,27,99,134,1.3208955223880596,0.05036144329974012,652,I'm glad we're on the lo-cal island.
7348,1999,9,25,100,134,1.3208955223880596,0.051463538761602735,652,I think it's part of Mar-a-Lago.
9012,1999,7,29,98,134,1.3208955223880596,0.04923468412205862,652,I have a bad feeling about this.
5679,1999,8,27,99,134,1.3208955223880596,0.05036144329974012,652,"If we start swimming now, we can get there before they start building a wall."
7314,1999,7,29,98,134,1.3208955223880596,0.04923468412205862,652,your last wish just keeps getting better and better
616,2004,9,33,117,159,1.320754716981132,0.045775917863392517,652,Why did I let an English major buy our tickets to a dessert island?
843,2004,10,31,118,159,1.320754716981132,0.046637390065655114,652,"No, I don't see it,either..."
8852,2004,8,35,116,159,1.320754716981132,0.044897919331925065,652,Definitely a trap
1371,2007,10,30,116,156,1.3205128205128205,0.04724606012622367,652,"If we only had shoots and ladders"""
2324,2007,13,24,119,156,1.3205128205128205,0.04980290308071528,652,You go ahead I'm on a diet.
4202,2007,11,28,117,156,1.3205128205128205,0.04811344077687164,652,"Yeah, but the views don’t get much sweeter"
7074,2007,12,26,118,156,1.3205128205128205,0.0489654589412611,652,The bad news is it's all kale.
7942,2011,7,27,94,128,1.3203125,0.05074929907927204,652,Race you for the strawberry.
8846,2011,10,21,97,128,1.3203125,0.054264038231838015,652,"I had requested the dessert island, but my spelling was off."
7485,2011,12,17,99,128,1.3203125,0.05648582864181389,652,"Just think, we could have landed on a dessert isle."
82,2011,10,21,97,128,1.3203125,0.054264038231838015,652,Sharks will do anything to get their next meal
617,2015,6,37,110,153,1.3202614379084967,0.0441383457412971,652,"Until  right now, I never thought it was that important to learn how to swim..."
5903,2015,11,27,115,153,1.3202614379084967,0.04876669073051605,652,That's just silly.
1656,2017,14,12,99,125,1.32,0.05967654750888865,652,Goddamn socialists. At least we have our freedom.
1709,2017,9,30,111,150,1.32,0.04760012407631451,652,I'm waiting for a low-carb mirage.
5280,2017,8,24,93,125,1.32,0.052792961407687175,652,"Dessert-ed island, they said. Gluten-free option, they said."
5511,2017,10,28,112,150,1.32,0.04853099288798357,652,The Good Ship Lollipop has to be nearby.
7480,2017,8,32,110,150,1.32,0.046650684383699674,652,It has sharks written all over it.
8321,2017,8,24,93,125,1.32,0.052792961407687175,652,"For the last time,is it one ""S"" or two?"
9103,2023,7,41,124,172,1.319767441860465,0.04180933986029598,652,I'm a meat and potatoes man myself.
9221,2024,9,29,109,147,1.3197278911564625,0.04825381994708703,652,It was just one letter
2369,2024,12,23,112,147,1.3197278911564625,0.051068532579589106,652,That is a dessert island. We are on a desert island because Hooked on Phonics was replaced with spellcheck.
5777,2024,14,19,114,147,1.3197278911564625,0.052861809844760896,652,I always thought it was spelled “desert island...”
7987,2024,8,31,108,147,1.3197278911564625,0.047278358467382736,652,I told you we should have bought the deluxe package
3766,2028,10,26,108,144,1.3194444444444444,0.049915213444351805,652,Never thought I'd see the Good Ship Lollipop sink like the Titanic.
6087,2028,8,30,106,144,1.3194444444444444,0.047929931555813904,652,"Well yes, but ‘Diet Island’ was the cheaper vacation package"
2926,2028,8,30,106,144,1.3194444444444444,0.047929931555813904,652,This is the healthy one
9822,2028,11,24,109,144,1.3194444444444444,0.05087881317719878,652,"Alas, our just deserts for skipping swimming lessons."
4504,2032,6,26,87,119,1.319327731092437,0.05192872130584115,652,Do you think they have a Happy Hour?
4029,2033,12,29,125,166,1.319277108433735,0.046834172302435126,652,We picked the wrong travel agent!
7472,2033,10,33,123,166,1.319277108433735,0.04524821537915737,652,Hansel and Gretel: An Inconvenient Truth.
2615,2035,13,19,109,141,1.3191489361702127,0.05356505096157125,652,What a difference an “s” can make.
3122,2035,9,27,105,141,1.3191489361702127,0.04963815260604339,652,"If you go, bring me back a maple bar."
5616,2035,11,23,107,141,1.3191489361702127,0.051638943050069185,652,We were one ‘S’ away from landing on a desserted island.
5941,2035,12,21,108,141,1.3191489361702127,0.05261081221500013,652,``Just once I'd like to be stranded on a dessert island.''
6576,2035,9,27,105,141,1.3191489361702127,0.04963815260604339,652,I told you when we booked the trip that dessert is spelled with TWO S's!
8260,2035,8,29,104,141,1.3191489361702127,0.04860688296473179,652,AirBnB really needs spell-check.
9322,2035,9,27,105,141,1.3191489361702127,0.04963815260604339,652,I told you dessert was spelled with  two ss
9781,2035,6,33,102,141,1.3191489361702127,0.04647574449494808,652,Let’s wait till tomorrow. That’s my cheat day.
13,2043,9,34,120,163,1.3190184049079754,0.04497428003601004,652,"Now I know why 'Fantasy Island' was more popular than ""Survivor'"
2436,2043,7,38,118,163,1.3190184049079754,0.043257428734028915,652,And we've got the coconut milk to go with it.
4121,2045,12,20,106,138,1.318840579710145,0.05342942052378383,652,Does this mirage make my ass look fat?
3161,2045,11,22,105,138,1.318840579710145,0.052430110191666934,652,"Of all the genies in the world, Harold, you find one who can't spell"
1674,2045,8,28,102,138,1.318840579710145,0.04931081916090372,652,I could really use a cup of coffee right now.
6384,2045,11,22,105,138,1.318840579710145,0.052430110191666934,652,Kind of gives new meaning to 'desserted' island.
517,2045,9,26,103,138,1.318840579710145,0.05037204988003114,652,This is a desert isle . . . THAT is a dessert isle.
323,2045,10,24,104,138,1.318840579710145,0.0514113794009978,652,Because the candyman can.
121,2045,9,26,103,138,1.318840579710145,0.05037204988003114,652,That's odd!  No salt-water toffee!
1225,2045,7,30,101,138,1.318840579710145,0.04822624144096608,652,"With our luck, this tree will drop another coconut as soon as we get over there."
1877,2053,10,31,119,160,1.31875,0.046388327900548476,652,You'll live much longer on this island without the extra sugar
4236,2054,6,24,83,113,1.3185840707964602,0.05372573795417391,652,"Well, I must say, America does look great again."
335,2055,6,31,98,135,1.3185185185185184,0.04778319825611717,652,They must be survivors from the Good Ship Lollypop.
3685,2055,9,25,101,135,1.3185185185185184,0.051136180871512386,652,I think it's debris from the Good Ship Lollipop
7360,2055,5,33,97,135,1.3185185185185184,0.04661196966520355,652,What time is low tide?
9113,2055,9,25,101,135,1.3185185185185184,0.051136180871512386,652,Well at least its much healthier over here
9474,2055,8,27,100,135,1.3185185185185184,0.05004348783418763,652,I see roast beef and pizza.
9824,2060,11,28,118,157,1.3184713375796178,0.04784957286568857,652,I thought it was only a typo.
4860,2060,13,24,120,157,1.3184713375796178,0.04952676304873006,652,"No, not a desert island."
7325,2060,11,28,118,157,1.3184713375796178,0.04784957286568857,652,Do you think it comes in peace?
744,2063,12,25,117,154,1.3181818181818181,0.04936103518769198,652,Dessert has two ‘S’s you idiot.
789,2063,13,23,118,154,1.3181818181818181,0.050213486561123996,652,It's an inflatable island. The sharks use it to trick us into swimming to it.
1210,2063,7,28,97,132,1.3181818181818181,0.049655512122314144,652,"Six days on low-carb island, then one day over there..."
6718,2063,12,25,117,154,1.3181818181818181,0.04936103518769198,652,A lifetime on the hips doesn't seem like such a bad deal right now.
9687,2063,12,25,117,154,1.3181818181818181,0.04936103518769198,652,Why couldn't we have been stranded on that desserted island?
5790,2068,10,28,113,151,1.3178807947019868,0.04825508098894511,652,Calling it a Land seems generous.
7328,2068,11,26,114,151,1.3178807947019868,0.04916149979404823,652,Ever been desserted before?
6779,2068,8,32,111,151,1.3178807947019868,0.04638914096799539,652,That island looks pretty sweet.
4519,2068,12,24,115,151,1.3178807947019868,0.050051506298519684,652,I was never good at spelling.
2908,2068,9,30,112,151,1.3178807947019868,0.047331306980677175,652,"If this is a desert island, that's a dessert island."
3569,2068,9,30,112,151,1.3178807947019868,0.047331306980677175,652,Reminds me. Need to see a dentist.
3738,2068,10,28,113,151,1.3178807947019868,0.04825508098894511,652,Those sharks are clever little buggers aren’t they?
2502,2068,5,38,108,151,1.3178807947019868,0.04344020876442576,652,So this is how fasting feels like.
911,2068,8,32,111,151,1.3178807947019868,0.04638914096799539,652,My shrink told me there'd be days like this.
6837,2077,8,25,96,129,1.317829457364341,0.05160281765773003,652,"Don't blame me, blame Autocorrect."
6413,2077,9,23,97,129,1.317829457364341,0.05276338523279839,652,That place looks pretty sweet.
8870,2077,9,23,97,129,1.317829457364341,0.05276338523279839,652,"You have your mirage, I’ll have mine"
1574,2077,9,23,97,129,1.317829457364341,0.05276338523279839,652,"Just my  luck, it's the Good Ship Lollipop."
922,2077,10,21,98,129,1.317829457364341,0.05389896893478054,652,"Now, that's what I had in mind when I told the genie I'd like to be stranded with you on a dessert island."
2024,2077,11,19,99,129,1.317829457364341,0.05501111599704364,652,And Mexico paid for it.
6615,2083,6,35,107,148,1.3175675675675675,0.04500940859147338,652,It's kind of a look but don't touch sort of thing.
6811,2083,8,31,109,148,1.3175675675675675,0.047007490769755696,652,How is your dental coverage?
9276,2083,11,25,112,148,1.3175675675675675,0.04985469063729482,652,"Great, now I feel like some cold milk."
9305,2083,14,19,115,148,1.3175675675675675,0.05254784646978481,652,I would have chosen the dessert island.
9879,2083,11,25,112,148,1.3175675675675675,0.04985469063729482,652,"On the plus side, our island is 100% gluten-free."
5125,2088,7,26,93,126,1.3174603174603174,0.05120862235283609,652,To hell what they think -- I prefer our minimalism.
8968,2089,6,34,105,145,1.3172413793103448,0.045594674644364834,652,I wish WE lived on a desserted island
6480,2089,6,34,105,145,1.3172413793103448,0.045594674644364834,652,"Weird, I’ve never really noticed that strawberry before."
5948,2089,10,26,109,145,1.3172413793103448,0.04961870734287214,652,This is why I didn't want to buy an amusement park in a flood zone.
1328,2089,7,32,106,145,1.3172413793103448,0.04663324775885241,652,I’m rethinking your comment about this being our just deserts.
2222,2089,12,22,111,145,1.3172413793103448,0.05151297894321048,652,But it's almost swimsuit season.
434,2089,10,26,109,145,1.3172413793103448,0.04961870734287214,652,Let's give Gretel another hour.
5174,2089,9,28,108,145,1.3172413793103448,0.04864391717126167,652,"Well, at least we have these hallucinogens!"
152,2096,7,38,119,164,1.3170731707317074,0.04303683889174222,652,"Just like I said, only a matter of time before gentrification starts to change this place."
3182,2096,9,34,121,164,1.3170731707317074,0.04474151204383071,652,I think it's symbolic.
6283,2096,6,27,90,123,1.3170731707317074,0.05074031852607854,652,Mirage? No. It’s climate change. That’s Big Rock Candy Mountain.
20,2099,10,25,107,142,1.3169014084507042,0.05034068164352512,652,A desserted island never sounded so good.
1103,2099,7,31,104,142,1.3169014084507042,0.04727064486267993,652,I should've booked 'desserted' island instead of  'deserted' island!
2229,2099,10,25,107,142,1.3169014084507042,0.05034068164352512,652,"You’re in luck, I’m a dentist."
6185,2099,9,27,106,142,1.3169014084507042,0.0493385661269934,652,Nice but no shade.
6999,2099,9,27,106,142,1.3169014084507042,0.0493385661269934,652,I think I’m still full from lunch.
8152,2099,11,23,108,142,1.3169014084507042,0.05132323400957692,652,That's why you should always use spell check.
8877,2099,10,25,107,142,1.3169014084507042,0.05034068164352512,652,This always happens as soon as I hit my goal weight.
9589,2106,10,31,120,161,1.3167701863354038,0.04614179490094294,652,What three things would you want on a desserted island?
2470,2106,7,37,117,161,1.3167701863354038,0.04354475837597791,652,"Really, I'd rather enjoy it from here than swim the channel and discover it's a mirage."
7774,2108,12,20,107,139,1.316546762589928,0.05309321718922874,652,Even my mirages spell desert wrong.
9534,2108,8,28,103,139,1.316546762589928,0.04900848960416313,652,Those castaways are getting their just desserts .
4552,2108,12,20,107,139,1.316546762589928,0.05309321718922874,652,The sand is always sweeter on the other mirage
5379,2111,8,34,116,158,1.3164556962025316,0.04497538685184743,652,"Would you stop humming ""Big Rock Candy Mountain""?"
7790,2111,11,28,119,158,1.3164556962025316,0.04758846906261719,652,"Finally, you're using the term ""dessert island"" properly!"
671,2113,18,20,139,177,1.3163841807909604,0.048831520502355626,652,You really need to learn how to spell.
9716,2114,11,21,104,136,1.3161764705882353,0.05291317947683559,652,"If you could take one thing to a desert island, take a homonym"
8290,2114,5,33,98,136,1.3161764705882353,0.04632720357528593,652,"Casting did say it's like ""The Biggest Loser"" meets ""Temptation Island."""
7646,2114,10,23,103,136,1.3161764705882353,0.05187361661263051,652,"Oh,look--a dessert-ed island."
8620,2114,5,33,98,136,1.3161764705882353,0.04632720357528593,652,"If you stare long enough, a sexy dental hygienist appears, too."
3602,2114,7,29,100,136,1.3161764705882353,0.048621751458100125,652,"Nice try. Now, try wishing for the whole cruise ship, not just the dessert buffet."
669,2114,10,23,103,136,1.3161764705882353,0.05187361661263051,652,It’s the mushrooms.
5866,2114,6,31,99,136,1.3161764705882353,0.047488338073464136,652,If I had 2 cannibals and a canoe I could work this out.
2927,2121,7,35,113,155,1.3161290322580645,0.04461334957357563,652,I’d rather be on that desserted island.
3519,2121,10,29,116,155,1.3161290322580645,0.047346726411212244,652,I don't care that you're a dentist. I'm going anyway.
7168,2121,9,31,115,155,1.3161290322580645,0.04645347480325674,652,This is what Hell must feel like.
10010,2121,13,23,119,155,1.3161290322580645,0.04993069239998886,652,How come we didn't wash up  on a dessert island?
8254,2125,14,20,118,152,1.3157894736842106,0.05148631968433376,652,Shouldn’t Hansel and Gretel be back by now?
9874,2125,8,26,99,133,1.3157894736842106,0.05048006161108345,652,I was just one S off.
8363,2125,12,24,116,152,1.3157894736842106,0.0497650918129974,652,"No, actually I prayed for the good SHIP Lollipop."
8304,2125,8,26,99,133,1.3157894736842106,0.05048006161108345,652,"That's strange, the mirage I see is covered in mate, kombucha and kale"
5632,2125,8,32,112,152,1.3157894736842106,0.04613036809080713,652,It's a lifeboat from the Good Ship Lollipop!
1498,2125,8,32,112,152,1.3157894736842106,0.04613036809080713,652,I had always hoped to live in the Sandwich Isles.
2048,2125,11,26,115,152,1.3157894736842106,0.04888175515890755,652,There's no way of escaping these cravings.
954,2125,8,26,99,133,1.3157894736842106,0.05048006161108345,652,"If you don't think it's a mirage, then swim to it."""
686,2125,9,30,113,152,1.3157894736842106,0.047065371940886995,652,"I don't mind that it's junk food, but no way it's locally sourced."
293,2125,11,26,115,152,1.3157894736842106,0.04888175515890755,652,"No Hansel, we are not going over there! Don't you ever learn?"
3534,2125,8,32,112,152,1.3157894736842106,0.04613036809080713,652,If the gummy sharks don’t get you the cavities will.
8162,2136,11,25,113,149,1.3154362416107384,0.04956481054739255,652,I'm on the Castaway Diet..
6819,2136,13,21,115,149,1.3154362416107384,0.05136204715286692,652,I swear I spelled it with two s’s in the GPS
4903,2136,8,31,110,149,1.3154362416107384,0.04673955797712791,652,"Don’t do it, Jerry. It’s loaded with high fructose corn sugar. You’ll never make it back."
4321,2136,10,27,112,149,1.3154362416107384,0.048641296477702066,652,I've been over there once.   The guy who lives there is really creepy.
4196,2136,9,29,111,149,1.3154362416107384,0.04769990567563531,652,Race you for the donut.
2722,2136,10,27,112,149,1.3154362416107384,0.048641296477702066,652,I wouldn't. It's just empty calories.
2325,2136,11,25,113,149,1.3154362416107384,0.04956481054739255,652,"No man is an island, but I'm claiming that one."
1594,2136,9,29,111,149,1.3154362416107384,0.04769990567563531,652,Too bad we weren't marooned on a Dessert Island.
986,2136,9,29,111,149,1.3154362416107384,0.04769990567563531,652,You’re lucky-you landed on the healthy island.
2931,2136,7,33,109,149,1.3154362416107384,0.04575905984971825,652,Come on! At least we’ll die in a diabetic coma with a smile on our faces and red dye on our lips.
8548,2136,7,33,109,149,1.3154362416107384,0.04575905984971825,652,So you misspelled dessert on our destination vacation request
6085,2147,8,25,97,130,1.3153846153846154,0.05126266777381622,652,Is deserted spelled with one s or two?
5403,2147,5,31,94,130,1.3153846153846154,0.04764534976425365,652,"No kale, no carrots, no Évian--who needs it, really?"
468,2147,9,23,98,130,1.3153846153846154,0.052412991630563496,652,I wouldn't.  I hear there are gummy sharks in these waters.
2522,2150,10,32,123,165,1.3151515151515152,0.04533366533349307,652,I bet their coffee sucks.
2559,2150,6,40,119,165,1.3151515151515152,0.04194641692134844,652,"You don't suppose this is some kind of maritime variation on 'Hansel and Gretel', do you?"
4650,2150,10,32,123,165,1.3151515151515152,0.04533366533349307,652,"You go, I’m not doing sugar this month."
308,2153,11,24,111,146,1.3150684931506849,0.050274094877312735,652,"Ever get Sugar cravings, Mike?” “Yeh, I guess they come in waves"
1539,2153,10,26,110,146,1.3150684931506849,0.049325564410794956,652,"Don't try to sugarcoat it, we missed the sweet spot."
2526,2153,5,36,105,146,1.3150684931506849,0.044279168329991,652,"Naw, not for a cupcake, but maybe for that doughnut with sprinkles!"
4309,2153,7,32,107,146,1.3150684931506849,0.04636368590367681,652,"I'm dieting right now, but you go ahead."
4628,2153,12,22,112,146,1.3150684931506849,0.05120505763127899,652,You realize that I will still cannibalize you eventually.
7160,2153,10,26,110,146,1.3150684931506849,0.049325564410794956,652,"Even if we get over there, eat everything, and get rescued, we'll still hate our jobs."
2555,2159,8,24,95,127,1.31496062992126,0.05207935668547331,652,Ever wish you'd taken swimming lessons as a kid?
6139,2159,7,26,94,127,1.31496062992126,0.050865263351523825,652,You can argue with the facts all you want. Desert Island is not spelled the same as Dessert Island.
5384,2161,9,33,120,162,1.3148148148148149,0.045054663713696555,652,I think it's just a mirage brought on by our carb-free lifestyle.
6992,2161,11,29,122,162,1.3148148148148149,0.04672563744409847,652,"Desert, dessert. I always get them confused."
3916,2163,8,29,106,143,1.3146853146853146,0.04802776333926085,652,I ordered it yesterday on Amazon Prime.
8516,2163,6,33,104,143,1.3146853146853146,0.04593125231139446,652,"My father was a coconut farmer, I’m a coconut farmer, and some day you will be a coconut farmer."
2028,2163,10,25,108,143,1.3146853146853146,0.050036508309944244,652,"I'm sorry, Fred, I thought it was just a typo on the map."
1247,2163,6,33,104,143,1.3146853146853146,0.04593125231139446,652,"All things considered, avoiding tooth decay and diabetes doesn't concern me now."
1200,2163,12,21,110,143,1.3146853146853146,0.051967665680980796,652,No way. It'll rot my tooth.
9160,2168,7,25,92,124,1.314516129032258,0.051679040696349106,652,Don’t even think about it. Let’s wait ‘til some healthier food choices float by.
9861,2168,6,27,91,124,1.314516129032258,0.05039437373093753,652,"I guess I could learn to swim, but who’s got the time?"
3292,2170,9,32,118,159,1.3144654088050314,0.045617039804286615,652,"You can't swim, and I'm a diabetic."
6609,2170,9,32,118,159,1.3144654088050314,0.045617039804286615,652,I wish we had landed on the dessert island!
6971,2170,13,24,122,159,1.3144654088050314,0.048983265551674905,652,I'm ready to try the North Beach diet.
505,2173,9,26,105,140,1.3142857142857143,0.049753466503940344,652,We shoulda gone all inclusive.
1750,2173,7,30,103,140,1.3142857142857143,0.04764302239909952,652,At least we have a view...
3131,2173,8,28,104,140,1.3142857142857143,0.04870967569425921,652,It's the subscription bonus from Blue Apron.
3735,2173,9,26,105,140,1.3142857142857143,0.049753466503940344,652,Let’s swim to the dessert island.
3905,2173,7,30,103,140,1.3142857142857143,0.04764302239909952,652,And I thought it couldn't get any better than Appetizer Island!
5157,2173,10,24,106,140,1.3142857142857143,0.05077580479005254,652,"In hindsight, we should have saved the bridge for last."
5310,2173,7,30,103,140,1.3142857142857143,0.04764302239909952,652,At least we're not on that desserted island.
7493,2173,9,26,105,140,1.3142857142857143,0.049753466503940344,652,Do you ever wish we'd washed up on a desserted island?
9825,2173,9,26,105,140,1.3142857142857143,0.049753466503940344,652,What ain't it got?  It ain't got dames!
6030,2182,7,35,114,156,1.314102564102564,0.044372741783183595,652,It's that Milton Bradley timeshare option again.....
4355,2182,7,35,114,156,1.314102564102564,0.044372741783183595,652,Are hallucinations part of a low carb diet?
7935,2182,7,35,114,156,1.314102564102564,0.044372741783183595,652,We're on the glutton free island.
408,2182,11,27,118,156,1.314102564102564,0.04795614827227325,652,Why couldn't we be stranded on a desserted island.
1120,2182,13,23,120,156,1.314102564102564,0.04965096302177674,652,I thought you meant deserted island
8637,2187,11,21,105,137,1.313868613138686,0.052576208583834834,652,Even God can't spell any more.
8719,2187,10,23,104,137,1.313868613138686,0.05154527623454096,652,I doubt the natives are canibals.
2264,2187,10,23,104,137,1.313868613138686,0.05154527623454096,652,"Bob? Don't panic, but you're starting to look like a Twizzler."
7751,2187,8,27,102,137,1.313868613138686,0.04941893451080853,652,"It may taste good, but you can't live on it."
1361,2191,9,30,114,153,1.3137254901960784,0.04680227627595454,652,"Why didn't we opt for ""dessert island'?"
4997,2191,9,30,114,153,1.3137254901960784,0.04680227627595454,652,"Maybe later, but now I couldn’t eat another thing."
8463,2191,8,32,113,153,1.3137254901960784,0.04587432563651779,652,"And then as we swim back, we can work off the calories."
4246,2194,7,39,123,169,1.3136094674556213,0.042123599741049296,652,There’s so much you can blame on spell check.
9642,2195,3,36,95,134,1.3134328358208955,0.04421145470028586,652,So Harry.... What are you giving up for Lent ?
7042,2195,11,20,103,134,1.3134328358208955,0.053408047444067935,652,I don't know. Does the term  Trojan Horse come to mind here.
5420,2195,9,24,101,134,1.3134328358208955,0.05126380624299873,652,I wonder when we’re going to start hallucinating?
5771,2195,5,32,97,134,1.3134328358208955,0.04668077150158858,652,"My guess, the food is overpriced and drinks are watered down."
1818,2199,8,31,111,150,1.3133333333333332,0.04647451652309233,652,It’s too bad that I’m a dentist and that you’re a nutritionist.
5791,2199,11,25,114,150,1.3133333333333332,0.04927816009039002,652,This is what I get for letting you book our vacation over the phone.
6060,2199,9,29,112,150,1.3133333333333332,0.047427483010045526,652,So what will it be then Edward? Starvation or tooth decay?
8492,2199,5,37,108,150,1.3133333333333332,0.0434905082772811,652,All because of a silly spelling error!
4844,2203,12,28,126,166,1.3132530120481927,0.046690721662416064,652,I now see low-carb for the elitist cultural imperialism it really is.
6307,2203,10,32,124,166,1.3132530120481927,0.04509972049915211,652,But this island has the better view
9202,2205,8,25,98,131,1.3129770992366412,0.05092678297699789,652,"So THAT'S the ""Good Ship Lollipop!"
6116,2205,9,23,99,131,1.3129770992366412,0.05206704366950886,652,"No, Thomas, it's not a mirage--just a typo."
4096,2205,10,21,100,131,1.3129770992366412,0.053182862357895364,652,It's my hallucination cheat day.
2170,2205,8,25,98,131,1.3129770992366412,0.05092678297699789,652,Yesterday's mirage was the entree list .Today it's the desert tray.
1416,2205,7,27,97,131,1.3129770992366412,0.04976040004149827,652,That gluten-free diet is getting to you- I see only a palm tree.
815,2210,9,28,110,147,1.3129251700680271,0.04807613736092265,652,You had to pick Jumanji over Candy Land...
2471,2210,9,28,110,147,1.3129251700680271,0.04807613736092265,652,Probably not a good time to start the keto diet
7203,2210,6,34,107,147,1.3129251700680271,0.04507494984134362,652,Dude... that is one sweet looking island.
7877,2210,8,30,109,147,1.3129251700680271,0.047096995906647274,652,I call dibs on the strawberry
7088,2214,10,31,122,163,1.312883435582822,0.045656174641146144,652,I hope the Sugar Plum Ferry arrives on schedule.
7740,2214,10,31,122,163,1.312883435582822,0.045656174641146144,652,"I heard that everyone goes through this, but day 3 of the juice cleanse gets better."
5767,2214,12,27,124,163,1.312883435582822,0.04728601280442979,652,"Well-argued mate, but I still think Brexit was the way to go."
5898,2214,9,33,121,163,1.312883435582822,0.04481903525092777,652,"As advertised, the view is spectacular."
4837,2218,5,35,104,144,1.3125,0.04458732254553229,652,"Well, we do get a cheat day..."
10008,2218,8,29,107,144,1.3125,0.04774311074023794,652,I can’t.  My cheat day isn’t until Sunday.
9811,2218,9,27,108,144,1.3125,0.04874966379658141,652,The genie couldn't spell.
8309,2218,10,20,98,128,1.3125,0.05405550879879,652,"No, Monopoly is the most popular board game I don’t understand how Candy Land even popped into your head"
7689,2218,7,31,106,144,1.3125,0.0467148747834084,652,"Yeah I know, but we have to wait til ""cheat"" day"
7271,2218,11,23,110,144,1.3125,0.05070285903703966,652,Guys look - we're saved! Humans!
5525,2218,11,28,121,160,1.3125,0.04707439248331258,652,"Dude, we can't play 'I spy' if you're just going to make things up"
5100,2218,9,27,108,144,1.3125,0.04874966379658141,652,I've read somewhere that deaths due to sugar intake vastly outnumber deaths due to shark attacks. I believe the safest play here is to wait it out.
4310,2218,12,21,111,144,1.3125,0.05165176678154399,652,Looks like  the Big Rock Candy Mountain is experiencing climate change.
2372,2218,10,20,98,128,1.3125,0.05405550879879,652,Having dessert first could spoil our appetites.
2671,2218,8,29,107,144,1.3125,0.04774311074023794,652,Dibs on the donut.
2508,2218,12,21,111,144,1.3125,0.05165176678154399,652,The wreck of the Good Ship Lollipop
3804,2218,10,25,109,144,1.3125,0.0497358504240635,652,"Can you swim, Hansel?"
2283,2218,15,20,125,160,1.3125,0.05030371593111176,652,type one or two?
1589,2218,10,25,109,144,1.3125,0.0497358504240635,652,"So, you can't swim either?"
1045,2218,7,31,106,144,1.3125,0.0467148747834084,652,"Dude, sugar'll kill ya."
784,2218,8,34,118,160,1.3125,0.044498869323491605,652,You go first
260,2218,10,30,120,160,1.3125,0.04623182967903929,652,"You know, if it wasn't for global warming it'd be one island."
58,2218,11,23,110,144,1.3125,0.05070285903703966,652,Don’t fall for the shark’s silly games.
4540,2237,12,30,131,173,1.3121387283236994,0.04533059867444544,652,"I look forward to these hypoglycemic hallucinations , they really breakup the day"""
5498,2237,12,30,131,173,1.3121387283236994,0.04533059867444544,652,How can we get to the desserted island?
4474,2239,11,27,119,157,1.3121019108280254,0.04769169796998167,652,"When I agreed, I thought Candy Land was a board game."
8785,2239,9,31,117,157,1.3121019108280254,0.04594757252133935,652,They won't last stranded in the hot sun.
5099,2241,9,26,106,141,1.3120567375886525,0.04944960671389644,652,I bet ya ten bucks theres a witch in a bikini over there.
5646,2241,5,34,102,141,1.3120567375886525,0.04516630507119393,652,The dessert island was already booked
9265,2241,12,20,109,141,1.3120567375886525,0.05243295692539365,652,"Don't get excited. That's where props for ""The Nutcracker"" stay from New Year's to Thanksgiving."
2064,2244,7,25,93,125,1.312,0.051325652267118445,652,"Sure I’m tempted, but I’ve almost reached my target weight."
6410,2245,10,28,116,154,1.3116883116883118,0.04744510676886874,652,Let me know when you smell or see the Italian sub.
6855,2245,9,30,115,154,1.3116883116883118,0.04654197802506615,652,I would guess that the natives are friendly.
448,2247,12,19,107,138,1.3115942028985508,0.05324617796480852,652,"On a positive note, we get to keep our beach bodies."
5061,2247,9,25,104,138,1.3115942028985508,0.05017764342283398,652,"Here's an easy way to remember the difference: on ""Dessert Island,"" you always want a second."
3606,2249,11,30,126,167,1.311377245508982,0.0456649653107643,652,It’s rumored to mark the last resting place of the Good Ship Lollipop.
216,2250,10,27,114,151,1.3112582781456954,0.04808512545873204,652,"Because I'm a dentist, damn it."""
656,2250,6,35,110,151,1.3112582781456954,0.04426034802596781,652,"No, I have not read Roald Dahl, and why do you ask?"
1380,2250,8,31,112,151,1.3112582781456954,0.04621232356072238,652,"Nah! That stuf'll kill ya, Buddy!"
1598,2250,5,37,109,151,1.3112582781456954,0.04325133739700127,652,This is the last time I'll take your advice
2172,2250,12,23,116,151,1.3112582781456954,0.049887671141105636,652,That island melts in your mouth not on your hands
2315,2250,10,27,114,151,1.3112582781456954,0.04808512545873204,652,That's the one with two S's.
3668,2250,13,21,117,151,1.3112582781456954,0.05076494807082595,652,"Is this acid hitting you, too?"
9752,2250,12,23,116,151,1.3112582781456954,0.049887671141105636,652,Talk about being in the wrong place at the wrong time
8568,2258,8,26,101,135,1.3111111111111111,0.04983850832175466,652,"Yes Bob, it is ironic that if you add an ""s"" to the middle of ""desert"" you get ""dessert""."
8495,2258,11,20,104,135,1.3111111111111111,0.053061774096596494,652,I am begging you: can you please stop with the “dessert island” jokes?
8288,2258,13,30,137,180,1.3111111111111111,0.04476914291089727,652,It sucks to be one consonant away from making it to dessert island.
9131,2258,13,30,137,180,1.3111111111111111,0.04476914291089727,652,"Maybe you should swim over there first, Gretel."
1609,2258,8,26,101,135,1.3111111111111111,0.04983850832175466,652,So that’s what they mean by dessert island.
1521,2258,11,20,104,135,1.3111111111111111,0.053061774096596494,652,"Do you suppose it could be, ""the good ship, lollypop?"
653,2258,10,22,103,135,1.3111111111111111,0.052009552495332005,652,How does the five second rule apply here?
3472,2258,9,24,102,135,1.3111111111111111,0.05093559886023872,652,I guess we got our just deserts
2116,2266,7,37,120,164,1.3109756097560976,0.042874880997631794,652,"No thanks, I'm still trying to keep my beach body"
3197,2266,12,27,125,164,1.3109756097560976,0.04703550697076911,652,"Now, whaddaya say we go fatten you up?"
142,2268,10,26,112,148,1.3108108108108107,0.0487491556409747,652,Now is not the time to lecture me about empty calories.
1285,2268,10,26,112,148,1.3108108108108107,0.0487491556409747,652,"I thought you said ""meet me by the candy aisle."""
3651,2268,9,28,111,148,1.3108108108108107,0.04779698225150559,652,The candy cane means that it must be Christmas Island
7233,2268,8,30,110,148,1.3108108108108107,0.04682545086802161,652,I'm a cannibal.
7542,2268,6,34,108,148,1.3108108108108107,0.04481925392372162,652,"Yes, we have no bananas"
8032,2273,6,29,97,132,1.3106060606060606,0.04825497060422663,652,"Whereever we go,tempation follows"
7730,2273,6,29,97,132,1.3106060606060606,0.04825497060422663,652,"If the gummy sharks don't kill you, the diabetes will."
3671,2273,6,29,97,132,1.3106060606060606,0.04825497060422663,652,Where bon  bons play on the sunny beach of peppermint bay
5783,2273,8,25,99,132,1.3106060606060606,0.0505950889911525,652,"Don't fall for it, Jake. Those aliens think they can fool us."
2242,2277,7,36,118,161,1.31055900621118,0.04337832347580376,652,You better think twice - life expectancy over there is 5.3 years lower than here.
4038,2277,11,28,122,161,1.31055900621118,0.04682134079437119,652,I wonder if there are gummy sharks?
4165,2277,9,32,120,161,1.31055900621118,0.04513267608592535,652,"Well, at least the view is pretty sweet..."
4402,2280,8,38,128,174,1.3103448275862069,0.04205590406650257,652,"We can swim over tomorrow, on my cheat day."
6901,2280,6,33,106,145,1.3103448275862069,0.04539866128306092,652,I hear the old lady who lives there likes to bake.
6001,2280,7,31,107,145,1.3103448275862069,0.04644161804790097,652,The last things you want out here are diabetes and rotten teeth.
5590,2280,4,37,104,145,1.3103448275862069,0.04323733993977938,652,THEY NEED A FLOAT THRU WINDOW.
4851,2280,9,27,109,145,1.3103448275862069,0.04846023904329379,652,"You always see the cheesecake on the next island, and never the cheesecake sitting right next to you."
3983,2280,10,25,110,145,1.3103448275862069,0.0494386509600151,652,Crusoe's birthday already? That year flew.
3116,2280,6,24,86,116,1.3103448275862069,0.05254225557783599,652,Meh. I'm more a savory guy.
3298,2280,8,29,108,145,1.3103448275862069,0.04746166165991397,652,"On the bright side, I'm doing a great job keeping my New Year's resolutions."
1874,2280,10,25,110,145,1.3103448275862069,0.0494386509600151,652,But are they local?
1086,2280,9,27,109,145,1.3103448275862069,0.04846023904329379,652,Trees are overrated.
143,2280,9,27,109,145,1.3103448275862069,0.04846023904329379,652,I hear Wonka wants a foothold in the South China Sea...
3637,2280,6,33,106,145,1.3103448275862069,0.04539866128306092,652,"Sure, it's probably a hallucination, but if I have to eat one more coconut, I'm going to scream."
3221,2292,11,27,120,158,1.3101265822784811,0.04743004178276733,652,It's all that's left of the big rock-candy mountain after the great climate-change floods.
7479,2292,8,33,117,158,1.3101265822784811,0.044807721413442934,652,"I'm telling you, it's the sharks."
9275,2292,9,31,118,158,1.3101265822784811,0.04569855088893038,652,"I have heard of  ""pie in the sky""  but this view ""takes the cake"""
9579,2295,12,16,101,129,1.310077519379845,0.0559000197746355,652,We've definitely entered the hallucination phase of keto.
3639,2295,7,26,96,129,1.310077519379845,0.05019155362972818,652,Have you noticed your hallucinations getting more and more elaborate?
116,2295,10,20,99,129,1.310077519379845,0.05368951619067856,652,Hard to believe that adding an 's' to desert makes such a difference.
5117,2298,13,27,131,171,1.3099415204678362,0.0463950148173685,652,The sharks do that.
6826,2298,6,41,124,171,1.3099415204678362,0.04087665902043634,652,"Ok, so our options are either A), i eat you on this deserted island, or B), I eat myself to death on that deserted island."
8611,2300,8,28,106,142,1.3098591549295775,0.0481223702697873,652,That's not what we ordered!
9475,2300,7,30,105,142,1.3098591549295775,0.04707305385797126,652,"Yeah, but are they happy?"
8905,2300,10,24,108,142,1.3098591549295775,0.05015518679176264,652,"I'm telling you, the sharks put it there."
10015,2300,7,30,105,142,1.3098591549295775,0.04707305385797126,652,"But if both of us can see it, how can it be a mirage?"
8809,2300,8,28,106,142,1.3098591549295775,0.0481223702697873,652,Somewhere out there there's a pastry chef working without measuring cups.
8165,2300,7,30,105,142,1.3098591549295775,0.04707305385797126,652,"That's what I meant when I said I wanted to be on a ""desserted"" island!"
6538,2300,9,26,107,142,1.3098591549295775,0.04914928932598675,652,Next time I choose the Airbnb.
7858,2300,11,22,109,142,1.3098591549295775,0.05114130310212722,652,It’s been on the market for years.
6845,2300,9,26,107,142,1.3098591549295775,0.04914928932598675,652,"And that's what's left of the Good Ship Lollipop."""
4520,2300,8,28,106,142,1.3098591549295775,0.0481223702697873,652,In 1885 the good ship Lollypop hit a coral reef yonder.
2337,2300,5,34,103,142,1.3098591549295775,0.04490091488802172,652,That’s just the tip of the icecream.
7920,2300,8,28,106,142,1.3098591549295775,0.0481223702697873,652,So I'm not a good speller! Whoever heard of a genie requiring wishes to be submitted in writing?
8134,2312,7,34,114,155,1.3096774193548386,0.044437311450764606,652,"It's just a hunch, but life seems sweeter over on that desserted island."
6032,2312,9,30,116,155,1.3096774193548386,0.04628443593795871,652,"Yes, better than another mobile phone shop. But still overdone."
6277,2312,11,26,118,155,1.3096774193548386,0.04806062183552926,652,"You say ""desert"" I say ""dessert""."
5999,2312,11,26,118,155,1.3096774193548386,0.04806062183552926,652,"On the bright side, we aren’t pre-diabetic."
2874,2312,11,26,118,155,1.3096774193548386,0.04806062183552926,652,Really? You see a burger and fries there?
6003,2312,8,32,115,155,1.3096774193548386,0.04537027473504684,652,"What could go wrong?"""
870,2318,13,26,129,168,1.3095238095238095,0.046973092413845376,652,I told you the oceans were filling up with garbage.
4259,2318,10,19,97,126,1.3095238095238095,0.054585637641550847,652,I always wondered what happens to day-old pastries.
4443,2318,9,21,96,126,1.3095238095238095,0.05340980911546648,652,I still think we were right about our zoning decision.
4777,2318,10,19,97,126,1.3095238095238095,0.054585637641550847,652,But it doesn't have a tree!
6557,2318,6,27,93,126,1.3095238095238095,0.04971574528052642,652,"When you said ""desserted"" island- that's what I thought you meant."
7503,2318,8,23,95,126,1.3095238095238095,0.05220750504253616,652,What....You've never heard of a Dessert Island before?
4986,2324,13,17,109,139,1.3093525179856116,0.053885540080898985,652,"Say, it’s only a fibreglass cake
sailing by on a cardboard sea,
but it wouldn’t be make-believe
if you believed in me."
6702,2324,5,33,101,139,1.3093525179856116,0.045492154415543704,652,Is it just me or are we on the wrooooooong island?
4778,2324,6,31,102,139,1.3093525179856116,0.046624033801495386,652,"I don't know about you, but I think they're mocking us."
565,2324,7,29,103,139,1.3093525179856116,0.0477290785840068,652,"We do get an occasional Swedish Fish, but that's about it."
2681,2324,6,31,102,139,1.3093525179856116,0.046624033801495386,652,Tempting yes but it sure looks like a cane mutiny is looming.
2257,2324,16,11,112,139,1.3093525179856116,0.05671370798560175,652,"It's called Trump Tax Cuts Island....looks tempting, but ultimately little guys like you and me end up with a lot of pain."
2962,2324,6,31,102,139,1.3093525179856116,0.046624033801495386,652,Oh! With TWO S’s!
691,2331,13,21,118,152,1.3092105263157894,0.05047142056100027,652,Of course. The one time you spell 'desert' correctly.
2359,2331,10,27,115,152,1.3092105263157894,0.047811600749434566,652,"In retrospect, I’d rather die of type two diabetes."""
4642,2331,9,29,114,152,1.3092105263157894,0.046891478868581825,652,We're in the wrong cartoon.
5276,2331,9,29,114,152,1.3092105263157894,0.046891478868581825,652,"Alexa, book me a trip to a dessert island."
5323,2331,12,23,117,152,1.3092105263157894,0.04960066448853971,652,There's plenty of nice treats here on the vegan island too
9639,2331,9,29,114,152,1.3092105263157894,0.046891478868581825,652,That must be the one I saw in the brochure.
4026,2337,14,23,128,165,1.309090909090909,0.048341436090838255,652,Did The Good Ship Lollipop sink?
7269,2337,11,29,125,165,1.309090909090909,0.04599092250979998,652,You go. I don't want to put back all the weight I lost on the island diet.
7317,2337,6,22,82,110,1.309090909090909,0.054406272245260894,652,Imagine being stranded on a dessert island!
220,2340,7,24,92,123,1.3089430894308942,0.05179708162669383,652,You explore the island. I’ll try to catch a Swedish fish.
7728,2341,7,28,101,136,1.3088235294117647,0.04841125776358175,652,And to think my greatest dream was always to be stranded on an island alone with you.
6774,2341,6,30,100,136,1.3088235294117647,0.047272797848004686,652,Too bad!  You can't swim and I gave up sweets for Lent.
9548,2341,8,26,102,136,1.3088235294117647,0.0495235533875104,652,Who knew the genie couldn't spell dessert when I made the wish?
3383,2341,5,32,99,136,1.3088235294117647,0.046106235527363086,652,I'll check it out and see if its real. There is no reason for you to come along.
4932,2341,7,28,101,136,1.3088235294117647,0.04841125776358175,652,Should we invite them over?
2909,2341,8,26,102,136,1.3088235294117647,0.0495235533875104,652,This low carb diet makes me see things.
6302,2347,7,32,110,149,1.308724832214765,0.04557245061381208,652,"Lucky for us, we got the gluten free island."
6238,2347,10,26,113,149,1.308724832214765,0.048465786072753994,652,"Yeah, but how many calories would we burn swimming there?"
5196,2347,9,28,112,149,1.308724832214765,0.04752091853155566,652,"... I'm still going to eat you Karl, I just don't have much of a sweet tooth."
6564,2347,10,26,113,149,1.308724832214765,0.048465786072753994,652,"You know what they say, a moment on the lips a lifetime on the hips."
4699,2347,8,30,111,149,1.308724832214765,0.04655687893872983,652,"I don’t care if it is a mirage. 
I’m swimming over!"
4141,2347,9,28,112,149,1.308724832214765,0.04752091853155566,652,"Those desserted islands are the leading cause of castaway obesity."""
3468,2347,10,26,113,149,1.308724832214765,0.048465786072753994,652,Do you think the cupcakes are debating whether they should come here and eat us?
5008,2347,8,30,111,149,1.308724832214765,0.04655687893872983,652,I don’t want to spoil my appetite.
1381,2355,12,26,124,162,1.308641975308642,0.04738701859443552,652,"So, it's not just a spelling mistake after all..."
4404,2355,13,24,125,162,1.308641975308642,0.04818932213022822,652,"I told you there were two S's when you booked our trip, but you just wouldn't listen."
1857,2355,6,38,118,162,1.308641975308642,0.04225449224236663,652,We're not going to fall for the old Hansel and Gretel trick!
8977,2358,8,21,91,120,1.3083333333333333,0.05396833978682692,652,I told you to grab your insulin.
9222,2359,9,23,101,133,1.3082706766917294,0.05138817017271687,652,But I booked us on the dessert island.
5031,2359,9,23,101,133,1.3082706766917294,0.05138817017271687,652,You go ahead. I’m watching my weight.
8293,2359,10,21,102,133,1.3082706766917294,0.05248490449884475,652,"Yeah, before the floods that used to be the big rock candy mountain."
8184,2362,6,33,107,146,1.3082191780821917,0.04513671929520491,652,"I’m really more of savory guy, anyway"
2791,2362,7,31,108,146,1.3082191780821917,0.04617138442827639,652,What do you say we swim over to Dessert Island after dinner?
9868,2362,11,23,112,146,1.3082191780821917,0.050096806137536615,652,I thought we already got our just desserts.
8178,2362,11,23,112,146,1.3082191780821917,0.050096806137536615,652,Those flying saucers will do anything to get attention.
8381,2362,12,21,113,146,1.3082191780821917,0.0510310032869381,652,"It's a shame, but thanks to global warming, that's all that's left of Big Rock Candy Mountain."
5279,2362,11,23,112,146,1.3082191780821917,0.050096806137536615,652,"Maybe if we declared a state of emergency we could afford to build a big, beautiful bridge."
2224,2362,7,31,108,146,1.3082191780821917,0.04617138442827639,652,I'm waiting for my cheat day.
3672,2362,9,27,110,146,1.3082191780821917,0.048174094310145625,652,I see the sharks have upscaled their bait.
2945,2362,9,27,110,146,1.3082191780821917,0.048174094310145625,652,"No, I clearly said swim to the dessert island!"
1813,2362,6,33,107,146,1.3082191780821917,0.04513671929520491,652,"Listen, I've been thinking, this island is getting a bit small for the two of us..."
4685,2362,11,23,112,146,1.3082191780821917,0.050096806137536615,652,I still don’t understand what a homonym is.
1565,2373,11,27,121,159,1.3081761006289307,0.04717113816035839,652,"I'd prefer the ""Good Ship, Lollipop."""
3426,2373,9,31,119,159,1.3081761006289307,0.045452098780404,652,The only problem will be swimming back
4585,2373,8,33,118,159,1.3081761006289307,0.04456772136472309,652,"On the other hand, the swimming would count against the calorie gain....."
4849,2373,7,35,117,159,1.3081761006289307,0.0436654358932049,652,"Yeah, but the view is pretty sweet."
3853,2377,6,32,105,143,1.3076923076923077,0.04572836480626379,652,Last week it was entrees
9223,2377,10,32,127,169,1.3076923076923077,0.04441155916843275,652,And how much did you pay for this desserted island getaway?
8815,2377,11,22,110,143,1.3076923076923077,0.050828620176554276,652,It's just as well. I have sensitivities to imaginary gluten.
7972,2377,10,32,127,169,1.3076923076923077,0.04441155916843275,652,I’d rather die of starvation than of diabetes.
5558,2377,7,26,97,130,1.3076923076923077,0.04986105183108662,652,It looks as though Global Warming has gotten to the Big Rock Candy Mountain.
5552,2377,8,28,107,143,1.3076923076923077,0.04783376903750963,652,They say it's bigger below the surface.
9465,2377,11,22,110,143,1.3076923076923077,0.050828620176554276,652,Bet it's all past the expiration date!
3839,2377,10,20,100,130,1.3076923076923077,0.0533282874545292,652,"A mirage, or just plastic? I'm guessing plastic."
3355,2377,11,22,110,143,1.3076923076923077,0.050828620176554276,652,Who ever heard of a dessert island?
2221,2377,8,32,116,156,1.3076923076923077,0.045122189237339475,652,"If your not here in the morning, I will understand ."""
1802,2377,10,28,118,156,1.3076923076923077,0.04691948351642267,652,At least ours is all-inclusive
1737,2377,7,30,106,143,1.3076923076923077,0.04679290976306432,652,"Feels more desserted today, doesn’t it?"
160,2377,10,20,100,130,1.3076923076923077,0.0533282874545292,652,"No, I’m Keto...I see bacon, eggs, and butter."
151,2377,9,30,117,156,1.3076923076923077,0.04602960946509395,652,"If we knew how to swim, we would die happy!"
3372,2377,6,28,96,130,1.3076923076923077,0.04865042554105198,652,"It appears they're baking, too."
459,2392,7,37,122,166,1.3072289156626506,0.0424390228117724,652,Are you kidding? I just got beach-body ready.
6965,2392,10,31,125,166,1.3072289156626506,0.044945841938954595,652,We seemed to have chosen the wrong island.
8642,2392,9,33,124,166,1.3072289156626506,0.044126062111565154,652,"As your life coach, therapist and dentist, I advise against it, but hey, what have you got to lose?"
4944,2395,12,23,118,153,1.3071895424836601,0.04931683766662968,652,For once a positive effect of global warming.
2753,2395,7,33,113,153,1.3071895424836601,0.04474543459850608,652,Do you think there might be jellyfish?
2528,2395,12,23,118,153,1.3071895424836601,0.04931683766662968,652,How sweet it is!
564,2395,5,37,111,153,1.3071895424836601,0.04278031432093711,652,Whaddaya say? Do you still have room?
1263,2395,12,23,118,153,1.3071895424836601,0.04931683766662968,652,Before global warming that was the Big Rock Candy Mountain
1141,2395,10,27,116,153,1.3071895424836601,0.04754105439959968,652,"Just think, Gloria, we've discovered an uncharted dessert island"
2462,2395,12,23,118,153,1.3071895424836601,0.04931683766662968,652,You remembered!
8836,2402,10,23,107,140,1.3071428571428572,0.05058387616011822,652,"Well, they say the glacé is always greener..."
8554,2402,9,25,106,140,1.3071428571428572,0.0495575786783754,652,What I'd give to be stranded on a dessert island.
8389,2402,3,37,100,140,1.3071428571428572,0.04288710840043335,652,"I prefer savory, thanks."
7861,2402,11,21,108,140,1.3071428571428572,0.05158976109947577,652,I thought “dessert island” was a typo
7637,2402,6,31,103,140,1.3071428571428572,0.0463425165016634,652,"Dang Spell Check! I know I typed ""Dessert Island""!"
5993,2402,10,23,107,140,1.3071428571428572,0.05058387616011822,652,Should we build a wall?
3237,2402,13,17,110,140,1.3071428571428572,0.05354487180056181,652,The lingerie photo shoot is still #1.
2864,2402,7,29,104,140,1.3071428571428572,0.047438420701218044,652,"Eh, the whole pun thing kind of puts me off."
249,2402,8,27,105,140,1.3071428571428572,0.04850957309175747,652,Pinch me.
6625,2402,6,31,103,140,1.3071428571428572,0.0463425165016634,652,Why couldn’t we have washed ashore a desserted island?!
4069,2412,11,17,99,127,1.3070866141732282,0.05534973738667744,652,If only we’d been stranded on that dessert island.
4891,2412,8,23,96,127,1.3070866141732282,0.051852100226659245,652,I prefer coconuts.
9731,2412,11,17,99,127,1.3070866141732282,0.05534973738667744,652,"I'd love to, but I've only got one refill left on my Insulin prescription."
9794,2412,8,23,96,127,1.3070866141732282,0.051852100226659245,652,All of a sudden I have a craving for double consonants.
7560,2416,13,28,135,176,1.3068181818181819,0.04538143470950206,652,apparently the last residents died of diabetes.
3574,2416,12,30,134,176,1.3068181818181819,0.04466026815143113,652,they all died from hyperglycemia
5361,2418,8,34,121,163,1.3067484662576687,0.04380183729084483,652,If you sing Big Rock Candy Mountain one more time I’ll smack you.
1433,2419,6,34,110,150,1.3066666666666666,0.04431599634096887,652,I'm not gonna bother.  I don't see any chocolate.
6489,2419,11,24,115,150,1.3066666666666666,0.04910534415679868,652,"Yeah, but they're just empty calories."
8580,2419,11,24,115,150,1.3066666666666666,0.04910534415679868,652,No one told me that dessert island was an option
9389,2419,9,28,113,150,1.3066666666666666,0.04724789844566308,652,It's the downside of being a good speller
9112,2423,9,24,104,137,1.3065693430656935,0.050291170014332774,652,You on a diet?
9776,2423,9,24,104,137,1.3065693430656935,0.050291170014332774,652,Can we reconsider the Paleo thing?
5633,2423,7,28,102,137,1.3065693430656935,0.04810943116997928,652,"Don't bother. It's just empty calories. 
Besides, sharks."
560,2423,9,24,104,137,1.3065693430656935,0.050291170014332774,652,Hard to believe that's all that remains of the Good Ship Lollipop.
3788,2423,7,28,102,137,1.3065693430656935,0.04810943116997928,652,I'm pretty sure I saw the donut wink at me.
15,2423,4,34,99,137,1.3065693430656935,0.04463732459088077,652,"I get that the rule is no dessert until after dinner, but we haven't eaten anything in weeks."
4505,2423,9,24,104,137,1.3065693430656935,0.050291170014332774,652,"If it looks too good to be true, it probably is too good to be true."
6812,2430,7,24,93,124,1.3064516129032258,0.051438039738937,652,"Tempting, but swimsuit season *is* just around the corner."
1391,2431,12,29,132,173,1.30635838150289,0.045188960326381845,652,"As a diabetic dentist, I find God’s sense of humor disillusioning."
9498,2431,11,31,131,173,1.30635838150289,0.04443904589720197,652,One “S” really matters.
3595,2433,10,29,121,160,1.30625,0.04606946747394995,652,It's the island of unwanted carbs.
5600,2433,6,37,117,160,1.30625,0.04251976510434061,652,"Don't worry, we'll burn off the carbs swimming back."
353,2433,8,33,119,160,1.30625,0.04433016048843966,652,They're just empty calories.
1771,2433,13,23,124,160,1.30625,0.04856176366172368,652,"No insulin, they all died"
2871,2437,11,23,113,147,1.3061224489795917,0.04979900416811918,652,Flotsam from the Good Ship Lollipop
5638,2437,9,27,111,147,1.3061224489795917,0.047891177641662196,652,Sure it's tempting but look at all we'd be leaving behind.
6247,2437,11,23,113,147,1.3061224489795917,0.04979900416811918,652,Don't dessert me!
7702,2437,7,31,109,147,1.3061224489795917,0.045904128089684255,652,It’s “Survivor Candyland”
7860,2437,10,25,112,147,1.3061224489795917,0.048854404673691385,652,I should’ve taken those swimming lessons more seriously.
8163,2437,6,33,108,147,1.3061224489795917,0.0448776226593899,652,Ooh. Glad I saved room for dessert!
8732,2437,7,31,109,147,1.3061224489795917,0.045904128089684255,652,You should see the salad bar!
9159,2444,9,23,102,134,1.3059701492537314,0.05105509152021827,652,"Believe me, I will NEVER mix up ""desert"" and ""dessert"" again!"
9136,2444,8,25,101,134,1.3059701492537314,0.049943983816910474,652,Looks like we were an S short of a dessert island getaway.
3053,2444,8,25,101,134,1.3059701492537314,0.049943983816910474,652,I told you not to waste your one wish for our old Candyland game
6753,2444,9,23,102,134,1.3059701492537314,0.05105509152021827,652,I thought you said we were going to a dessert island.
3514,2448,4,29,88,121,1.3057851239669422,0.0481660568940759,652,"She was a good ship, the Lollipop was."
4013,2448,5,27,89,121,1.3057851239669422,0.04957529711010628,652,Damn this Jello Sea.
135,2450,9,30,118,157,1.305732484076433,0.04577745874766909,652,I'm glad we didn't go for anything so tasteless.
2839,2450,10,28,119,157,1.305732484076433,0.046660851328738664,652,O.K. Just this once.
3698,2450,9,30,118,157,1.305732484076433,0.04577745874766909,652,Another dessert island
6624,2450,10,28,119,157,1.305732484076433,0.046660851328738664,652,I dunno. How many calories do you think we'd burn swimming over?
734,2454,9,26,109,144,1.3055555555555556,0.04855905193316886,652,Its huge mouth is just below the waterline.
976,2454,10,24,110,144,1.3055555555555556,0.049549032500880254,652,Disney is everywhere.
1587,2454,12,20,112,144,1.3055555555555556,0.05147190317079292,652,"Just a little advice from a lifelong vegan, that crap will kill you."
4253,2454,8,28,108,144,1.3055555555555556,0.047548463987000605,652,"Sure, we could swim over there. But then we’d feel awful about ourselves the next day."
6372,2454,5,34,105,144,1.3055555555555556,0.044378836579475604,652,Aren’t you glad we cut out sugar?
8040,2454,9,26,109,144,1.3055555555555556,0.04855905193316886,652,"Good stealth design, but the periscopes are a bit too obvious."
8997,2454,6,32,106,144,1.3055555555555556,0.0454599409730468,652,Nothing tastes as good as mirages look.
3139,2461,10,31,126,167,1.3053892215568863,0.04471375653900493,652,I vote for leaving Low Carb Island.
2625,2462,8,24,99,131,1.3053435114503817,0.05070626239928623,652,It's what happens when Titanic meets a Shirley Temple film.
9425,2462,9,22,100,131,1.3053435114503817,0.051851372774513585,652,It is the quintessental desserted island.
7,2462,7,26,98,131,1.3053435114503817,0.04953468718392161,652,The sand shark spent all night setting that up for us.
2190,2462,11,18,102,131,1.3053435114503817,0.054068886457871224,652,This is why he's Moby-Dick and not Moby-Nice
3984,2466,9,29,116,154,1.3051948051948052,0.04636696853343518,652,I'd kill to have all that.
5460,2466,8,31,115,154,1.3051948051948052,0.04544241777411226,652,I say it’s more Koons than it is Christo.
3060,2468,4,28,86,118,1.305084745762712,0.048902891201046676,652,"Plastic garbage vortex, or the big rock candy mountain?"
6257,2468,5,26,87,118,1.305084745762712,0.05036226086531086,652,"I knew I should have spell- checked ""dessert."""
7747,2468,8,20,90,118,1.305084745762712,0.05450643057840294,652,Those sharks really mean to get us this time.
9448,2471,9,25,107,141,1.3049645390070923,0.049253045114226846,652,"Well, at least it’s not deserted."
8761,2471,6,31,104,141,1.3049645390070923,0.046064206117580164,652,I always pass on dessert islands.
7619,2471,10,23,108,141,1.3049645390070923,0.050271061015436935,652,I really would have preferred the Good Ship Lollipop.
7278,2471,7,29,105,141,1.3049645390070923,0.04715112096055223,652,That’s one sweet island
7216,2471,7,29,105,141,1.3049645390070923,0.04715112096055223,652,It can only be described as a horrid pun.
6930,2471,8,27,106,141,1.3049645390070923,0.04821353887063618,652,We probably shouldn’t have eaten the banana float first.
7003,2471,10,23,108,141,1.3049645390070923,0.050271061015436935,652,Our mirages have grown so cliché.
6698,2471,8,27,106,141,1.3049645390070923,0.04821353887063618,652,"A.  I have been in the sun too long and it's a mirage.
B. The sharks have gotten sophisticated."
3865,2471,9,25,107,141,1.3049645390070923,0.049253045114226846,652,I regret asking for the sugar-free option.
7207,2471,8,27,106,141,1.3049645390070923,0.04821353887063618,652,looks sweet over there
6859,2471,10,23,108,141,1.3049645390070923,0.050271061015436935,652,"And here we are, so close to a desserted island."
5741,2482,8,34,122,164,1.3048780487804879,0.043574095963438635,652,The presentation is a little tacky...
8182,2483,9,21,98,128,1.3046875,0.05268223171183776,652,"No, no. We’re on a desert island, that’s a dessert island."
2074,2483,6,27,95,128,1.3046875,0.04905428676426544,652,I don’t like the way they’re looking at us.
1318,2483,4,31,93,128,1.3046875,0.04647859784701775,652,We really lucked out. That other island would have ruined my diet.
3361,2486,10,26,115,151,1.304635761589404,0.047908464490531356,652,"That's the icing on the cake, Larry"
4295,2486,6,34,111,151,1.304635761589404,0.04406835697911027,652,I'm praying it's a loading port for the Good Ship Lollipop.
4780,2486,7,32,112,151,1.304635761589404,0.04505907575160468,652,They’re never as good as they look.
5828,2486,8,30,113,151,1.304635761589404,0.04602847519024936,652,"Not much of a dessert man, myself.  I prefer savory."
7820,2486,9,28,114,151,1.304635761589404,0.046977875101902516,652,Why did it have to be the Good Ship Lollipop that crashed?
8375,2486,8,30,113,151,1.304635761589404,0.04602847519024936,652,"You see two women? Where are your priorities, dude?"
4611,2492,8,37,129,174,1.3045977011494252,0.041903547699243246,652,It’s the Galollilopagos island
9762,2493,11,27,123,161,1.3043478260869565,0.04666142609104571,652,What if we just don't tell your doctor?
9668,2493,7,28,103,138,1.3043478260869565,0.04781117835006826,652,I think I'd prefer THAT desserted island.
9649,2493,6,30,102,138,1.3043478260869565,0.046691779280993786,652,I don’t know.  These coconuts are almost ripe.
9630,2493,6,30,102,138,1.3043478260869565,0.046691779280993786,652,The Good Ship Lollypop's surviving crew members wait for rescue on the sunny beach of Peppermint Bay.
9017,2493,8,26,104,138,1.3043478260869565,0.04890496189569144,652,"All I’m saying is, if I’m going to die, I might as well die of diabetes."
4061,2493,9,31,121,161,1.3043478260869565,0.044966756406755994,652,"You go first, I'll let you know if I see any sharks."
6164,2493,9,24,105,138,1.3043478260869565,0.049974811863738186,652,The second s is important.
5457,2493,9,17,89,115,1.3043478260869565,0.0568347841025052,652,I saw some sharks build that last night.
5367,2493,10,29,122,161,1.3043478260869565,0.04582192633769696,652,"Damn, and me with no toothbrush."
2544,2493,9,31,121,161,1.3043478260869565,0.044966756406755994,652,That’s the real  temptation island!
8237,2493,10,22,106,138,1.3043478260869565,0.05102223381637679,652,None of it will taste as good as thin feels.
8209,2504,10,25,113,148,1.304054054054054,0.04856724921812574,652,"Desert"",""dessert"",whoever knew it would make such a difference"
7614,2504,6,33,109,148,1.304054054054054,0.04462132946458001,652,I have to admit I thought Temptation Island would be different.
8908,2504,9,27,112,148,1.304054054054054,0.0476114380507279,652,I like this place better.Its classic
4713,2504,9,27,112,148,1.304054054054054,0.0476114380507279,652,"Dessert, not desert."
1296,2504,6,33,109,148,1.304054054054054,0.04462132946458001,652,They all pair beautifully with coconut.
2859,2504,10,25,113,148,1.304054054054054,0.04856724921812574,652,"It's amazing what a single ""s"" can do to your life."
3887,2504,14,17,117,148,1.304054054054054,0.052215824709033125,652,Maybe I should've swam over to you.
27,2504,11,23,114,148,1.304054054054054,0.049504609482075204,652,"I don’t know if I spelled it wrong, or if my Genie mis-read it, but the bottom line is Dessert Island is over there, and I am here."
6355,2512,10,18,97,125,1.304,0.05474162183649954,652,Obviously a typo.
21,2513,13,22,123,158,1.3037974683544304,0.048941764991846236,652,Stupid autocorrect.
168,2513,7,34,117,158,1.3037974683544304,0.043721189714101105,652,"I just don't think anyone would buy a memoir called ""Stranded on a Dessert Island."""
1837,2513,10,28,120,158,1.3037974683544304,0.04640495011598184,652,At least we'll live longer.
2067,2513,7,34,117,158,1.3037974683544304,0.043721189714101105,652,Why is our island only deserted?
2302,2513,12,24,122,158,1.3037974683544304,0.04811102478053921,652,Nice try dessert shark!
3726,2513,9,30,119,158,1.3037974683544304,0.045527944607497005,652,The swim should burn off the calories.
9536,2519,8,25,102,135,1.3037037037037038,0.04962443146626282,652,"Unless there is an insulin island nearby, I suggest we stay here."
8263,2519,8,25,102,135,1.3037037037037038,0.04962443146626282,652,"I'm afraid I'm starting to hallucinate. You don't see kale, do you?"
7289,2519,6,29,100,135,1.3037037037037038,0.04734413965130984,652,I’m more of a savory kind of guy.
6216,2519,6,29,100,135,1.3037037037037038,0.04734413965130984,652,But what are its tax policies?
6166,2519,9,23,103,135,1.3037037037037038,0.05072615220833686,652,"At least we're stranded on the ""healthy-choices"" island."
8912,2519,9,23,103,135,1.3037037037037038,0.05072615220833686,652,A little gaudy if you ask me.
4428,2519,10,21,104,135,1.3037037037037038,0.05180444804625277,652,I never would have expected  that our final Survivor competition  would be an Atkins diet challenge.
4388,2519,8,25,102,135,1.3037037037037038,0.04962443146626282,652,"Well, now there's more for us, and the shark is probably full."
1581,2519,4,33,98,135,1.3037037037037038,0.04494831387600253,652,"I understand son, I just feel this island is more authentic and besides, coconut milk is a healthy alternative."
1230,2519,9,23,103,135,1.3037037037037038,0.05072615220833686,652,"The Good Ship Lollipop""  would have been sufficient."
1041,2519,7,27,101,135,1.3037037037037038,0.048497689417499795,652,Trick or Treat?
6086,2519,6,29,100,135,1.3037037037037038,0.04734413965130984,652,"Our coconuts are healthier, son."
4292,2531,13,25,130,168,1.3035714285714286,0.04682607141968468,652,"I'd rather not, every time we go there I gain ten pounds."
9629,2532,8,28,109,145,1.303448275862069,0.0472664027470163,652,I thought the option with the extra ‘s’ was a typo
8581,2532,7,30,108,145,1.303448275862069,0.046242052160669976,652,I always wondered where the Good Ship Lollipop docked.
7439,2532,10,24,111,145,1.303448275862069,0.04925123054167483,652,"Someday I'll learn to spell ""dessert."""
6988,2532,9,26,110,145,1.303448275862069,0.04826901976688751,652,"You go, I’m gluten free."
6121,2532,11,22,112,145,1.303448275862069,0.050214232548971914,652,I always wondered what happened to the Good Ship Lollipop.
6037,2532,10,24,111,145,1.303448275862069,0.04925123054167483,652,"For the next wish, can you please turn off the auto-correct?"
5455,2532,7,30,108,145,1.303448275862069,0.046242052160669976,652,There must be easier ways to explain trade with China to me.
4929,2532,7,30,108,145,1.303448275862069,0.046242052160669976,652,"Dang, at least we got a sweet view."
3812,2532,6,32,107,145,1.303448275862069,0.04519449023295977,652,"Yes, they said the rehab is going to be hard."
3781,2532,7,30,108,145,1.303448275862069,0.046242052160669976,652,I didn’t realize Weight Watchers would be so literal.
3542,2532,6,32,107,145,1.303448275862069,0.04519449023295977,652,what was the name of that board game we played as a kid?
5053,2532,7,30,108,145,1.303448275862069,0.046242052160669976,652,Now all we need is to survive a sugar crash.
1461,2544,9,19,94,122,1.3032786885245902,0.05445763454722344,652,"I don't care if it's a mirage. That's how I met you, isn't it?"
6981,2544,9,19,94,122,1.3032786885245902,0.05445763454722344,652,I’ve always fantasized about spending time on a desserted island.
8169,2544,6,25,91,122,1.3032786885245902,0.050588387697447626,652,Never let a dyslexic book your vacation.
8014,2547,8,31,116,155,1.303225806451613,0.04519120440834244,652,It sure looks sweeter on the other side!
9172,2548,8,24,100,132,1.303030303030303,0.05037379814547864,652,Let's try the desserted island.
6383,2548,8,24,100,132,1.303030303030303,0.05037379814547864,652,Methinks it be jetsam from The Good Ship Lollipop.
2832,2548,11,28,126,165,1.303030303030303,0.045834822195189424,652,The Good Ship Lollipop stopped there last night.
3378,2548,9,22,101,132,1.303030303030303,0.05150902795244111,652,"Yeah, but it doesn't have you"
9482,2552,7,29,106,142,1.3028169014084507,0.04686712581054992,652,"I don't see any bacon, do you??"
668,2552,11,21,110,142,1.3028169014084507,0.05095182003824887,652,How was I suppose to know Desserted Island wasn't a typo?
2452,2552,8,27,107,142,1.3028169014084507,0.047920951603750116,652,Sharks? I'm worried about diabetes.
2880,2552,3,37,102,142,1.3028169014084507,0.04239064753307891,652,"Yeah, but there's like, zero nutritional value over there."
4883,2552,6,31,105,142,1.3028169014084507,0.04578905284972455,652,I thought these were desert islands
5239,2552,11,21,110,142,1.3028169014084507,0.05095182003824887,652,"I know they say ""the grass is always greener"" but I'm struggling to see the downfall of the other side right now."
5994,2552,9,25,108,142,1.3028169014084507,0.048952096211255416,652,You’re right. It wasn’t there yesterday. It must be an ile flottant.
6754,2552,6,31,105,142,1.3028169014084507,0.04578905284972455,652,I recommend The tiramisu.
7124,2552,7,29,106,142,1.3028169014084507,0.04686712581054992,652,Another one of God's little jokes.
7402,2552,9,25,108,142,1.3028169014084507,0.048952096211255416,652,Are we just deserted or did we get our just desserts?
1443,2562,5,36,111,152,1.3026315789473684,0.0428175847436635,652,"Even if I could swim, I’m still a diabetic."
2925,2562,9,28,115,152,1.3026315789473684,0.046710802457713245,652,Darn gerrymandering!
7982,2562,8,30,114,152,1.3026315789473684,0.045768555696054404,652,Are you sure this isn't a board game?
9865,2562,12,22,118,152,1.3026315789473684,0.04942989169991715,652,I think we should lay off the LSD.
6310,2566,7,35,120,162,1.3024691358024691,0.04297921719166919,652,"No, I’m pretty sure it’s not vegan."
396,2566,13,23,126,162,1.3024691358024691,0.04803436818589194,652,It's crazy that neither of us can swim.
1651,2568,9,21,99,129,1.302325581395349,0.05232558139534884,652,There's just no way to know if it's my cheat day.
9129,2569,5,32,102,139,1.3021582733812949,0.045269010519538425,652,Do you think it's an all inclusive?
7366,2569,11,20,108,139,1.3021582733812949,0.051719143464968115,652,"If you had remembered the extra 's', we'd be vacationing on dessert island."
7215,2569,13,16,110,139,1.3021582733812949,0.05369728698789705,652,"I always wondered why they called them ""desserted."
513,2569,8,26,105,139,1.3021582733812949,0.048601199132161516,652,"Yes, you have done some amazing things with fish and coconuts."
2368,2569,7,28,104,139,1.3021582733812949,0.04751644076031689,652,"But that’s what this one looked like from a distance, too!"
6889,2569,5,32,102,139,1.3021582733812949,0.045269010519538425,652,"Sharks"" hell! What about the gluten??"
9603,2575,9,27,113,149,1.3020134228187918,0.04733482550189134,652,We need to update the spelling on our GPS.
1637,2575,11,23,115,149,1.3020134228187918,0.049213566711110386,652,Harold and Karen would never mistake desert for dessert again.
3339,2575,3,39,107,149,1.3020134228187918,0.0411875876435034,652,It looks much better from a distance.
4018,2575,7,31,111,149,1.3020134228187918,0.04537836777761066,652,I left cuz I’m on a low-carb diet.  What about you?
4974,2575,10,25,114,149,1.3020134228187918,0.04828333487717794,652,Just another deserted island.
5036,2575,8,29,112,149,1.3020134228187918,0.04636691690987549,652,"You know, I've been rethinking this whole Paleo thing."
7591,2575,7,31,111,149,1.3020134228187918,0.04537836777761066,652,These are a few of my favorite things.
7996,2575,12,21,116,149,1.3020134228187918,0.05012653857983929,652,"Funny, I once said I'd rather be marooned on a deserted island than play Candy Land ever again..."
8034,2575,12,21,116,149,1.3020134228187918,0.05012653857983929,652,But is it artisanal?
2541,2584,7,34,118,159,1.3018867924528301,0.04348733785309519,652,Either that's a dessert island or my eyes made a typo.
7224,2584,10,28,121,159,1.3018867924528301,0.04615173930903655,652,It’s just Fake Food!
479,2584,8,32,119,159,1.3018867924528301,0.04439324328599178,652,No way! Refined sugars will kill you.
6300,2587,8,22,96,126,1.3015873015873016,0.05197049378966634,652,Not until you finish your dinner island.
591,2587,7,24,95,126,1.3015873015873016,0.05073409206596311,652,Coconuts are much healthier you said.
1972,2589,12,17,107,136,1.3014705882352942,0.05354518070783283,652,That good ship tragically went down somewhere in this area.
3724,2589,8,25,103,136,1.3014705882352942,0.04930878754887327,652,Looks like they're going all out for this year's Fyre festival.
6165,2589,9,23,104,136,1.3014705882352942,0.050401279660476465,652,"Before climate change, it was called Big Rock Candy Mountain."
6871,2589,8,25,103,136,1.3014705882352942,0.04930878754887327,652,"No, No, I told you to book us on a DESSERT island."
7116,2589,6,29,101,136,1.3014705882352942,0.047047758775446924,652,"Yes, but were they made in a plant that processes peanuts?"
8073,2589,6,29,101,136,1.3014705882352942,0.047047758775446924,652,"What, no coffee?"
8551,2595,7,30,109,146,1.3013698630136987,0.045971241358027104,652,"Nah, you go ahead. I'm really trying to cut down on sugar."
7362,2595,6,32,108,146,1.3013698630136987,0.04493196769237266,652,That’s ok. You go. I’m on a diet.
8160,2595,5,34,107,146,1.3013698630136987,0.04386807961854337,652,"So if I swim butterfly, I'd burn an extra 200 calories?"
610,2595,10,24,112,146,1.3013698630136987,0.048956868423814276,652,That cruise ruined sweets for me.
1820,2595,7,30,109,146,1.3013698630136987,0.045971241358027104,652,"Dude, if it's just a mirage how come we both see it?"
973,2600,6,35,115,156,1.3012820512820513,0.04306291374859299,652,"Some get stranded on a tropical island, some on a desert, and some  on a... dessert?"
1933,2600,9,29,118,156,1.3012820512820513,0.04585360943628251,652,"Dessert Island""? Must be a typo"
3549,2600,12,23,121,156,1.3012820512820513,0.04848394018797888,652,Thi is where a U-Boat sunk the Good Ship Lollipop.
6550,2600,11,25,120,156,1.3012820512820513,0.047623308056168476,652,"As a third grade teacher, I'm a little conflicted about seeing a dessert island."
5743,2604,9,32,125,166,1.3012048192771084,0.04396377372758592,652,Aspartame.
6186,2605,10,33,133,176,1.3011363636363635,0.043034180286876625,652,Wish we had a cakewalk
944,2606,7,23,93,123,1.3008130081300813,0.05154543439746056,652,"Yup, climate change:  the Big Rock Candy Mountain is almost under water."
8574,2607,7,26,100,133,1.300751879699248,0.04889408345964512,652,"We finally found a diet that seems to work, and now this!"
5933,2607,11,18,104,133,1.300751879699248,0.05335087687723347,652,We should have played Candy Land instead of survivor
5980,2607,10,20,103,133,1.300751879699248,0.05227231482359452,652,So that’s what you meant when you said you wanted a taste of paradise
1856,2607,3,34,96,133,1.300751879699248,0.04398802940741675,652,Do you think there's an island with pizza and beer?
1658,2607,7,26,100,133,1.300751879699248,0.04889408345964512,652,You go ahead---I'm running short of insulin.
4980,2607,5,30,98,133,1.300751879699248,0.04650579602859467,652,Hypoglycemia can really play games with your mind.
83,2613,10,23,110,143,1.3006993006993006,0.04965652242297689,652,"At least, our island is non-GMO, vegan and gluten-free."
718,2613,7,29,107,143,1.3006993006993006,0.04658638267160267,652,"If you can keep the sharks distracted, I’ll save you a cupcake."
1971,2613,8,27,108,143,1.3006993006993006,0.04763175523392495,652,It's a mirage; they're really fruits and vegetables.
3325,2613,8,27,108,143,1.3006993006993006,0.04763175523392495,652,Why'd we have to land on the Desert Island?!
3335,2613,7,29,107,143,1.3006993006993006,0.04658638267160267,652,"Nah, dream us a boat."
6723,2613,9,25,109,143,1.3006993006993006,0.048654672570104425,652,Shall we desert the desert for the dessert?
9996,2619,9,28,116,153,1.3006535947712419,0.04644663530572514,652,Just our luck; we didn't land on the Dessert Island
8069,2619,9,28,116,153,1.3006535947712419,0.04644663530572514,652,"Well ,I was fantasizing something a little more nutritious"
6878,2619,10,26,117,153,1.3006535947712419,0.04736337449156824,652,That’s a sweet view.
1938,2619,10,26,117,153,1.3006535947712419,0.04736337449156824,652,"In retrospect, I'm not sure that choosing 'a friend' as the one thing I would bring to a deserted island was the best choice."
2778,2619,11,24,118,153,1.3006535947712419,0.04826270356324893,652,It's gotta be the wreckage of the Good Ship Lollipop!
2683,2624,9,31,123,163,1.3006134969325154,0.04449125800158343,652,I think they 're from  the wreck of the Good Ship Lollipop.
4716,2624,8,33,122,163,1.3006134969325154,0.04363177370362716,652,"Oh, The difference one ‘s’ can make!"
5713,2626,9,24,107,140,1.3,0.04935347680939759,652,Tell me again why we didn’t opt for the “desserted island” package.
9856,2626,11,20,109,140,1.3,0.05139373034732311,652,What with your diabetes and my gluten allergy.....seriously?
9234,2626,6,30,104,140,1.3,0.0461241900136937,652,They're deserters from the Good Ship Lollipop.
8898,2626,5,26,89,120,1.3,0.04964862530219501,652,"Oh, that's the Good Ship Lollipop's home port."
8368,2626,5,35,110,150,1.3,0.04309087219144258,652,I think it's a trick that looks like a treat
6920,2626,9,24,107,140,1.3,0.04935347680939759,652,"Sweet view. Pity about the commute, though."
6158,2626,10,22,108,140,1.3,0.05038393192372498,652,"After the Atkins and South Beach tribes fought to a standstill, another group took over."
5678,2626,9,27,114,150,1.3,0.047061290894652906,652,"""Who was it that said, 'Life is short.  Eat dessert first!'?"""
406,2626,6,24,90,120,1.3,0.05103961223213517,652,We have two choices- poor nutrition or no nutrition
4379,2626,9,27,114,150,1.3,0.047061290894652906,652,Go ahead. You can swim over but I think they look like antennae.
3404,2626,9,24,107,140,1.3,0.04935347680939759,652,It's a trap John...
3367,2626,6,30,104,140,1.3,0.0461241900136937,652,I can't help but think this is all just my dentist trolling me.
2019,2626,8,35,127,170,1.3,0.04242066364980727,652,Forget the sharks . . . sugar is the real killer.
1734,2626,6,30,104,140,1.3,0.0461241900136937,652,Mirage or meringue either way I’m going for it!
584,2626,12,21,117,150,1.3,0.04983193229757468,652,It's just a typo.
4539,2626,7,28,105,140,1.3,0.047225160956190816,652,I picked the wrong week to go carb-free.
310,2626,7,25,98,130,1.3,0.04962591124989274,652,Who knew there was such a thing as a desserted island?
6350,2643,10,30,127,167,1.2994011976047903,0.04455405539933768,652,And then what? Die from type 2 diabetes?
6567,2643,12,26,129,167,1.2994011976047903,0.04614491939870187,652,"Damn, these sharks have an imagination!"
5077,2645,9,29,119,157,1.2993630573248407,0.04560100783036541,652,Think you can learn to swim before they build a wall?
2556,2645,8,31,118,157,1.2993630573248407,0.04469667322986063,652,I'd like to buy an S.
6670,2645,9,29,119,157,1.2993630573248407,0.04560100783036541,652,"On paper, the difference seems negligible."
1949,2645,11,25,121,157,1.2993630573248407,0.0473578984943511,652,"I didn't notice that yesterday, did you?"
654,2645,12,23,122,157,1.2993630573248407,0.0482123414400231,652,Lucky for me I'm a cannibal
2497,2645,10,27,120,157,1.2993630573248407,0.04648775357524984,652,So much for your mirage. Now it's my turn.
9780,2651,10,24,113,147,1.2993197278911566,0.04866588986834901,652,Just our luck: I’m diabetic and you’re watching your weight.
8116,2651,9,26,112,147,1.2993197278911566,0.04769885613474102,652,"If I'm going to hallucinate about food, I'd prefer Katz's deli."
6354,2651,9,26,112,147,1.2993197278911566,0.04769885613474102,652,They’re stale
9778,2651,6,32,109,147,1.2993197278911566,0.0446723292007039,652,Isn't it crazy how much difference a single letter makes?
1471,2651,7,30,110,147,1.2993197278911566,0.04570344578181841,652,Sweet view.
941,2651,10,24,113,147,1.2993197278911566,0.04866588986834901,652,That's where the Good Ship Lollipop ran aground.
148,2651,10,24,113,147,1.2993197278911566,0.04866588986834901,652,"I'm pretty sure it's a mirage, not meringue."
4604,2651,11,22,114,147,1.2993197278911566,0.0496140786147826,652,Candy is in isle one.  Palm oil is in this isle.
2957,2659,8,25,104,137,1.2992700729927007,0.04899698501915311,652,I'm glad we left.
3047,2659,8,25,104,137,1.2992700729927007,0.04899698501915311,652,I don’t know about you but maybe it’s time to reconsider this whole Paleo thing.
4352,2659,8,25,104,137,1.2992700729927007,0.04899698501915311,652,"It's probably a mirage, but how do you explain the smell?"
5526,2659,8,25,104,137,1.2992700729927007,0.04899698501915311,652,Don't bother. It's all store-bought.
7084,2659,7,27,103,137,1.2992700729927007,0.04788906278067403,652,It is clearly a mirage: look at all those empty calories!
4035,2664,11,16,100,127,1.2992125984251968,0.05512703696884621,652,Damn spell checker.
425,2664,4,30,93,127,1.2992125984251968,0.046519883558478206,652,Relax...they're probably not kosher for Passover.
9018,2666,7,35,122,164,1.298780487804878,0.04253303022289477,652,You're the one who said 'No-one uses travel agents in 2019'.
8125,2666,11,27,126,164,1.298780487804878,0.04591650527087863,652,This desert island is boring. We should upgrade to the dessert island package.
2689,2668,9,28,117,154,1.2987012987012987,0.04618532925956254,652,do you think they're a mirage or we are?
5987,2668,9,28,117,154,1.2987012987012987,0.04618532925956254,652,Last week my hallucination was BBQ Island.
7863,2668,8,30,116,154,1.2987012987012987,0.04525706796723126,652,Id rather have a Continental Breakfast
8576,2668,8,30,116,154,1.2987012987012987,0.04525706796723126,652,"So, this is what Hell looks like."
8189,2672,8,27,109,144,1.2986111111111112,0.0473458947750533,652,They call that a dessert island.
6407,2672,9,25,110,144,1.2986111111111112,0.048360715970460114,652,Apparently it's an offshore sugar-tax haven.
4861,2672,7,29,108,144,1.2986111111111112,0.046308839922042114,652,"There's that ""Dessert Island"" you're always hearing about."
7404,2672,9,25,110,144,1.2986111111111112,0.048360715970460114,652,Good luck. I've been trying to beat this Candy Crush level for the last nine years.
2350,2672,5,33,106,144,1.2986111111111112,0.04416173072554027,652,Terrible time to be diabetic.
1945,2672,6,31,107,144,1.2986111111111112,0.045248022694922535,652,If  I didn't love coconuts so much I'd say we go for it!
55,2672,10,23,111,144,1.2986111111111112,0.0493546750197042,652,Must be for people marooned on a desert island who can't spell.
2921,2672,8,27,109,144,1.2986111111111112,0.0473458947750533,652,I'd prefer a savory mirage.
1625,2680,5,30,99,134,1.2985074626865671,0.04621196855994383,652,I hated candyland
4238,2680,8,24,102,134,1.2985074626865671,0.04972130921533926,652,"I think our genie had a hearing problem. I really did say ""dessert island""."
4741,2680,5,30,99,134,1.2985074626865671,0.04621196855994383,652,Do you want to go out for lunch?
6315,2680,10,20,104,134,1.2985074626865671,0.051929281637198454,652,"I'm just saying, as our diet stands, we have room for one cheat day"
8897,2680,12,16,106,134,1.2985074626865671,0.05404712751500834,652,I had a dream like this once...without you.
2735,2685,9,19,96,124,1.2983870967741935,0.053686346508459305,652,Sometimes I wish we were stranded on a dessert island.
9673,2686,11,29,131,171,1.2982456140350878,0.04458634310190635,652,"We can sail across on The Good Ship Lollipop""."
9487,2687,10,28,123,161,1.2981366459627328,0.045653230223973267,652,Travelocity autocorrected when I misspelled desert.
7006,2687,5,38,118,161,1.2981366459627328,0.0411827472628907,652,Did you know there are two S's in dessert?
1547,2687,9,30,122,161,1.2981366459627328,0.04479483986275999,652,I think the dessert chef went overboard.
802,2687,13,22,126,161,1.2981366459627328,0.04813664596273292,652,Even Candyland couldn't avoid Climate Change
8797,2691,7,31,113,151,1.2980132450331126,0.044863985749969956,652,"No, you go ahead. I'm on a cleanse."
8478,2691,10,25,116,151,1.2980132450331126,0.047725023621001623,652,"Don't get excited, it's just a dessert mirage."
7839,2691,8,29,114,151,1.2980132450331126,0.04583751125578329,652,A mirage? I thought that only happened in the desert.
6706,2691,7,31,113,151,1.2980132450331126,0.044863985749969956,652,Is this our just desert?
9858,2691,6,33,112,151,1.2980132450331126,0.04386886135544158,652,Your inability to spell has really cost us this vacation.
3214,2691,7,31,113,151,1.2980132450331126,0.044863985749969956,652,The hallucinations are becoming more unhealthy.
1900,2691,8,29,114,151,1.2980132450331126,0.04583751125578329,652,"My luck, I just started going paleo."
1181,2691,11,23,117,151,1.2980132450331126,0.048641320915202485,652,If only it were organic.
5932,2691,11,23,117,151,1.2980132450331126,0.048641320915202485,652,"Looks good to me, and I'm a dentist."
345,2700,9,24,108,141,1.297872340425532,0.04904837143816246,652,Not until tomorrow; that's my cheat day.
4234,2700,9,24,108,141,1.297872340425532,0.04904837143816246,652,You know you'll just end up ruining your appetite.
4353,2700,11,20,110,141,1.297872340425532,0.05107227218289184,652,You go.  I'm on a low-sugar diet.
5032,2700,12,18,111,141,1.297872340425532,0.05205472224992758,652,Nouveau riche.
8135,2700,7,28,106,141,1.297872340425532,0.046937282575246236,652,"As your dentist, I advice against it."
605,2705,5,29,97,131,1.297709923664122,0.04685613028430916,652,The last thing we need is empty calories.
8627,2706,8,34,126,168,1.2976190476190477,0.04268531597293645,652,"Sure, but it's just empty calories."
8900,2707,6,35,117,158,1.2974683544303798,0.04260097032711705,652,Sometimes I’m sorry I gave up carbs
7672,2707,9,29,120,158,1.2974683544303798,0.045351070969297406,652,Tell me again. Is it dessert or desert?
5706,2707,5,37,116,158,1.2974683544303798,0.04164393134333573,652,"They say Sammy Davis, Jr. used to live there."
5839,2707,12,23,123,158,1.2974683544303798,0.047943681578625066,652,I really wish I could swim.
9615,2711,8,28,112,148,1.2972972972972974,0.04643917259374186,652,Is this a climate change issue?
7178,2711,9,26,113,148,1.2972972972972974,0.047418618859563805,652,Too much sugar.  My fantasy island is all carbs and pizza.
6682,2711,7,30,111,148,1.2972972972972974,0.045438618903242536,652,"Not without my toothbrush, Jim."
6167,2711,13,18,117,148,1.2972972972972974,0.051149194206531925,652,It was the summit of the Big Rock Candy Mountain before climate change.
9003,2711,7,30,111,148,1.2972972972972974,0.045438618903242536,652,"Bummer, I thought it was Taco Tuesday."
3045,2711,11,22,115,148,1.2972972972972974,0.04931919242306234,652,Big deal. They don't have a desalination plant either.
2454,2711,11,22,115,148,1.2972972972972974,0.04931919242306234,652,Dessert island. Get it
1463,2711,9,26,113,148,1.2972972972972974,0.047418618859563805,652,"So close, yet so far."
199,2711,10,24,114,148,1.2972972972972974,0.04837823971483269,652,It's just empty calories.
3297,2711,5,34,109,148,1.2972972972972974,0.04336831517501736,652,The frosting is always greener on the other island.
9318,2721,12,28,135,175,1.2971428571428572,0.044592138677221865,652,It was a floating-island competition that got out of hand.
2495,2722,5,31,102,138,1.2971014492753623,0.04531285779962708,652,Well yeah but I gave up sweets for Lent
4139,2722,11,19,108,138,1.2971014492753623,0.05184567695335068,652,Just another example of the importance of spelling.
6284,2722,9,23,106,138,1.2971014492753623,0.0497634521828742,652,We should have asked for the dessert not desert island
6795,2722,9,23,106,138,1.2971014492753623,0.0497634521828742,652,Did the brochure say desert or dessert island?
7125,2722,8,25,105,138,1.2971014492753623,0.04868895819752371,652,Only after we find a dinner island
9859,2722,7,27,104,138,1.2971014492753623,0.04759021041730343,652,"And you know, 90% of those dessertbergs are under water!"
8145,2728,9,31,125,165,1.2969696969696969,0.044025325662036485,652,I'm sure glad I left plenty of room for a desserted island.
4897,2728,8,33,124,165,1.2969696969696969,0.04317776591766852,652,"Yeah, it's fun, but parking's a nightmare."
5345,2728,7,35,123,165,1.2969696969696969,0.04231323244132485,652,At least we have our insulin.
1138,2731,7,24,97,128,1.296875,0.05004842020641091,652,The off-axis symmetry really irks me.
1250,2731,5,28,95,128,1.296875,0.047526638562299946,652,Is it election time again already?
1347,2731,5,28,95,128,1.296875,0.047526638562299946,652,Only on my cheat day
6772,2731,12,14,102,128,1.296875,0.05585697669470163,652,"I would, but I don't want to ruin my appetite."
8372,2731,6,26,96,128,1.296875,0.04880382023053614,652,"Well, what do *you* want to watch?"
9807,2731,6,26,96,128,1.296875,0.04880382023053614,652,"Empty carbs, dude."
660,2737,7,32,116,155,1.2967741935483872,0.0440647289700384,652,Yet another sign we've received our just desserts.
3208,2737,9,28,118,155,1.2967741935483872,0.045926840739655604,652,"But if it’s still there on Holy Thursday, I’m doing it."
3820,2737,6,34,115,155,1.2967741935483872,0.043103516778118786,652,You'll spoil your dinner Andy......
5895,2737,6,34,115,155,1.2967741935483872,0.043103516778118786,652,Did last night's sea urchin taste funny to you?
9990,2737,9,28,118,155,1.2967741935483872,0.045926840739655604,652,I say we stay here.  That kind of stuff will kill you.
6453,2742,7,29,109,145,1.296551724137931,0.04603444688390985,652,Oh look. Now the Ferguson's have coconut macaroons.
2246,2742,6,31,108,145,1.296551724137931,0.04498205041229769,652,The Diet Works Only If You Can't Swim
8845,2742,8,27,110,145,1.296551724137931,0.04706331629327182,652,Survivor: Diabetes Edition
8177,2745,7,26,102,135,1.2962962962962963,0.04826918494167436,652,"''Thanks to global warming, that's all that's left of the big rock candy mountain''"
8941,2745,9,30,123,162,1.2962962962962963,0.04455549350299086,652,"Yeah, looks too good to be true."
7571,2745,10,20,105,135,1.2962962962962963,0.05159059190854659,652,Which island has two esses?
1791,2745,10,20,105,135,1.2962962962962963,0.05159059190854659,652,"The ocean is made of soda, but unfortunately I peed in it."
497,2745,8,24,103,135,1.2962962962962963,0.049401138999491764,652,This is the best mirage yet!
4762,2745,7,34,121,162,1.2962962962962963,0.04279987767613371,652,The mainland never looked so sweet.
3686,2751,10,25,117,152,1.2960526315789473,0.04745052622423986,652,"He said, ""Piece of candy? Go for a ride?"" and I end up here. What's your story?"
5115,2751,11,23,118,152,1.2960526315789473,0.04836001255891019,652,"That gives a whole new meaning to “desserted island,” doesn’t it?"
8497,2751,10,25,117,152,1.2960526315789473,0.04745052622423986,652,I think they spelled it wrong.
8499,2751,7,31,114,152,1.2960526315789473,0.04461095506414591,652,"Is mirage spelt with one 'r', or two?"
9698,2751,7,31,114,152,1.2960526315789473,0.04461095506414591,652,Have you ever heard the one about the two diabetics stranded on a remote archipelago?
6379,2756,8,21,96,125,1.296,0.052084298915780626,652,"Get it? It's a--."" ""Shut up, Steve."""
5963,2756,8,21,96,125,1.296,0.052084298915780626,652,Just our luck... we end up on the wrong desserted island.
7134,2756,8,21,96,125,1.296,0.052084298915780626,652,They came over on the Good Ship Lollipop.
6521,2759,8,34,127,169,1.2958579881656804,0.04246851741621404,652,"Now that we have both lost some weight, why not?"
4653,2760,5,32,105,142,1.295774647887324,0.044460081766443844,652,Carbs. Nothing but carbs.
6081,2760,10,22,110,142,1.295774647887324,0.04976092317284823,652,"Chad, we used your last insulin shot yesterday."
8796,2760,8,26,108,142,1.295774647887324,0.04771131137665376,652,You think it’s sundae tomorrow? Hard to keep track on a dessert island.
4522,2760,9,24,109,142,1.295774647887324,0.048746890712609126,652,That island looks sweeter than this one!
7196,2760,8,26,108,142,1.295774647887324,0.04771131137665376,652,"I would, but I don’t want to spoil my dinner."
3550,2760,8,26,108,142,1.295774647887324,0.04771131137665376,652,"I'm counting carbs, but you should go."
2747,2760,9,24,109,142,1.295774647887324,0.048746890712609126,652,I'd say now's a good time to give up the diet.
2570,2760,4,34,104,142,1.295774647887324,0.043322150798544456,652,"You see an island of candy waiting to be gobbled up, and I see a sea monster waiting to gobble us up."
2179,2760,8,26,108,142,1.295774647887324,0.04771131137665376,652,Reminds me of sex.
1770,2760,9,24,109,142,1.295774647887324,0.048746890712609126,652,I can' t swim either.
1299,2760,7,28,107,142,1.295774647887324,0.04665275031992182,652,"It's meringue, I mean a mirage."
3009,2760,8,26,108,142,1.295774647887324,0.04771131137665376,652,You'd think they would have salt water Taffy...
464,2772,11,25,123,159,1.2955974842767295,0.046835585805270565,652,Too bad you are on a diet.
2167,2772,9,29,121,159,1.2955974842767295,0.04510375933248631,652,...at least it's a sweet view.
219,2774,8,23,101,132,1.2954545454545454,0.05014279443618571,652,"I spy with my little eye something that starts with ""C""."
1474,2774,7,25,100,132,1.2954545454545454,0.04897590645272065,652,Do you know how many times I’d have to swim back and forth to burn off just one bite?!
3620,2774,6,27,99,132,1.2954545454545454,0.04778052942215806,652,"Maybe its my double vision, but I see two S's in that desert"
4666,2774,5,29,98,132,1.2954545454545454,0.04655446886022629,652,Do you get the feeling that a shark is toying with us?
7141,2774,6,27,99,132,1.2954545454545454,0.04778052942215806,652,"If you really want to know, I’d try cannabilism before surrendering to processed sugars."
7694,2779,7,30,112,149,1.2953020134228188,0.045176715019635424,652,"Sugar is poison, man. Do you want to die?"
5483,2779,10,24,115,149,1.2953020134228188,0.04809386389828714,652,And this weight loss retreat lasts how long?
8476,2779,8,28,113,149,1.2953020134228188,0.04616958199434513,652,I also heard they have great healthcare.
184,2779,8,28,113,149,1.2953020134228188,0.04616958199434513,652,Too bad we couldn't have been stranded on the dessert-ed island.
2594,2779,7,30,112,149,1.2953020134228188,0.045176715019635424,652,"They've got candy, but we've got the big rock."
33,2784,8,33,125,166,1.2951807228915662,0.042954140865998955,652,My mirages are becoming more complex.
676,2784,5,39,122,166,1.2951807228915662,0.040323692379948664,652,"Oh, that? It's the long-fabled 'dessert island.'"
9576,2786,8,25,106,139,1.2949640287769784,0.0483846427436701,652,It's just a tease to buy a condo there.
8371,2786,6,29,104,139,1.2949640287769784,0.046179484885844745,652,"It’s appealing, but it isn’t death by chocolate."
9392,2786,8,25,106,139,1.2949640287769784,0.0483846427436701,652,I’m sure it’s just a typo...
8010,2786,4,33,102,139,1.2949640287769784,0.04386360672825866,652,"Yeah, but we don’t have any milk."
5950,2786,9,23,107,139,1.2949640287769784,0.04945035963456586,652,My kids would love it over there.
7802,2786,9,23,107,139,1.2949640287769784,0.04945035963456586,652,We might survive the sharks but not the tooth decay.
6728,2786,9,23,107,139,1.2949640287769784,0.04945035963456586,652,Who ever thought a diet would be this challenging.
7868,2786,7,27,105,139,1.2949640287769784,0.047294917685490004,652,Nah - swimsuit season is right around the corner.
2637,2794,4,38,114,156,1.294871794871795,0.04089360473251189,652,I'd never make it across this sea of chocolate
4282,2794,9,28,119,156,1.294871794871795,0.04567112695908522,652,"Let’s face it, we can’t have our view and eat it too."
6171,2794,6,34,116,156,1.294871794871795,0.04286855350832943,652,Huh...a real dessert island!
6955,2794,10,26,120,156,1.294871794871795,0.046567851825606826,652,That's what I call a desserted island!
9313,2794,7,32,117,156,1.294871794871795,0.04382266383773693,652,You know what they say: Give a man a Swedish Fish...
7410,2799,11,29,133,173,1.2947976878612717,0.04413639280096357,652,"No, it’ not the sharks. It’s the gluten."
9753,2799,7,37,129,173,1.2947976878612717,0.04097765035941169,652,Looks like Richard Branson is having another bake sale
696,2801,8,22,99,129,1.2945736434108528,0.050915909517130424,652,I’m trying to avoid artificial islands.
4938,2801,8,22,99,129,1.2945736434108528,0.050915909517130424,652,"Yes, Ms Earhart will be 138 this year but she still enjoys a good party"
6424,2801,6,26,97,129,1.2945736434108528,0.04847867345484103,652,Do you think they accept credit cards?
7408,2804,9,25,112,146,1.2945205479452055,0.0477829767707791,652,And I thought it was just a children's board game.
4341,2804,7,29,110,146,1.2945205479452055,0.04576315380847012,652,"Ah, the lure of empty calories..."
3541,2804,9,25,112,146,1.2945205479452055,0.0477829767707791,652,That one looks pretty sweet.
4,2804,8,27,111,146,1.2945205479452055,0.046783966888104454,652,It's got to be a trap
963,2804,10,23,113,146,1.2945205479452055,0.04876152356485978,652,Those sharks are diabolical!
349,2804,9,25,112,146,1.2945205479452055,0.0477829767707791,652,"It's a piece of cake,"" Mom said. If I thought she had meant it literally, I would have taken those swimming lessons"
3111,2804,11,21,114,146,1.2945205479452055,0.04972081547657818,652,"On the other hand, it could be real - I mean, it's not something ridiculous like global warming or climate change...."
2547,2811,10,28,125,163,1.294478527607362,0.04516501369728003,652,Trust me. They're in election season.  It's better here.
2591,2811,9,30,124,163,1.294478527607362,0.044318597679039465,652,I'm rethinking the vegan lifestyle.
5822,2811,10,28,125,163,1.294478527607362,0.04516501369728003,652,"But on the other hand, our grass is greener."
8296,2811,8,32,123,163,1.294478527607362,0.04345569856989565,652,I wished for desserted
9809,2811,11,26,126,163,1.294478527607362,0.045995856599420154,652,At least we're sugar free!
4696,2816,7,26,103,136,1.2941176470588236,0.04796245701688192,652,"Just a few more weeks of Whole 30, then we can swim over there."
4538,2816,9,22,105,136,1.2941176470588236,0.05018228977282247,652,But what if there is no shark?
5399,2816,10,30,130,170,1.2941176470588236,0.043870405949469046,652,What I wouldn't give for a good steak right now.
3963,2816,10,25,118,153,1.2941176470588236,0.04717906893978311,652,That's dessert island.
7217,2816,8,29,116,153,1.2941176470588236,0.04531959754911555,652,"Wow, Fred, the icebergs really are melting! That used to be the top of the Big Rock Candy Mountain!"
8771,2816,10,20,106,136,1.2941176470588236,0.05125616712862132,652,Its actually a sea monster called 'Sweety.'
9917,2816,6,33,114,153,1.2941176470588236,0.04338049444165882,652,We sure picked the wrong week go on the Mediterranean diet.
5709,2816,5,35,113,153,1.2941176470588236,0.04237768264071654,652,"No man, we agreed - you see it, you swim for it."
3951,2816,7,21,91,119,1.2941176470588236,0.05250177685216984,652,I picked a bad week to go keto.
665,2816,7,26,103,136,1.2941176470588236,0.04796245701688192,652,I wish we were on that desserted island.
3609,2816,6,28,102,136,1.2941176470588236,0.046813083867895386,652,It's like I always say -- the sand is always sweeter on the other side.
2906,2816,10,25,118,153,1.2941176470588236,0.04717906893978311,652,"""My favorite dessert - floating island."
2306,2816,8,24,104,136,1.2941176470588236,0.04908492380527736,652,New Yorker cartoonists” milestone...the 500th joke about being stranded on a deserted island.
2112,2816,8,24,104,136,1.2941176470588236,0.04908492380527736,652,"Instead of a dessert island, we end up here."
2068,2816,12,21,120,153,1.2941176470588236,0.04896798106963177,652,Didn't this order qualify for free delivery?
1343,2816,4,32,100,136,1.2941176470588236,0.04442521690971616,652,It's been like that ever since I started Paleo.
1144,2816,4,32,100,136,1.2941176470588236,0.04442521690971616,652,I always get confused with the spelling. Is it ‘deserted’ island or ‘desserted’ island .
957,2816,8,19,92,119,1.2941176470588236,0.05384112207163116,652,"Yep, the Big Rock Candy Mountain. Of course that was before climate change."
3921,2816,12,21,120,153,1.2941176470588236,0.04896798106963177,652,"Remember your new year's resolution, Rich."
2447,2835,9,29,122,160,1.29375,0.04485903409851324,652,I wonder why the cartoonist didn't put a shark fin in there somewhere.
8315,2836,4,34,105,143,1.2937062937062938,0.04306782749809967,652,Objects are closer than they appear.
7490,2836,9,24,110,143,1.2937062937062938,0.04844897363829027,652,Figures! Just when I started KETO.
7256,2836,9,24,110,143,1.2937062937062938,0.04844897363829027,652,And just when I thought we were going to lose some weight
5268,2836,6,30,107,143,1.2937062937062938,0.045297062574576955,652,They call it Temptation Island
8904,2836,5,32,106,143,1.2937062937062938,0.044196502368916084,652,I'm really more of a savory kind of guy.
3628,2836,7,28,108,143,1.2937062937062938,0.046371509940098726,652,We'll need to find a separate island that has insulin.
3049,2836,10,22,111,143,1.2937062937062938,0.049454990676809155,652,"Seriously, Bill, this might be the time to reconsider your no-sugar diet."
2575,2836,8,26,109,143,1.2937062937062938,0.04742161944054853,652,"Don't bother, it's all empty calories."
4315,2836,6,30,107,143,1.2937062937062938,0.045297062574576955,652,"Sure, sure, the other ""Island is always sweeter."""
1190,2845,9,19,98,126,1.2936507936507937,0.052935972487237484,652,"if the sharks don't get you , the carbs will.."
3580,2845,6,25,95,126,1.2936507936507937,0.049206349206349205,652,But there's more protein in coconut milk.
5151,2845,5,27,94,126,1.2936507936507937,0.0478986500356018,652,Forget it.  The water is swarming with carnivorous Swedish fish.
7167,2845,7,23,96,126,1.2936507936507937,0.05048018352979028,652,To think. We ended up here because of a common spelling mistake.
9685,2845,3,31,92,126,1.2936507936507937,0.04516981759167068,652,"I said drop us off at the desserted island, not deserted."
8307,2850,6,20,83,109,1.2935779816513762,0.05421849601211906,652,I wouldn’t worry too much about dental hygiene.
9299,2851,8,33,126,167,1.2934131736526946,0.042732726829078936,652,Is your mirage the same as my mirage?
4992,2852,11,22,117,150,1.2933333333333332,0.04873951827123914,652,I said dessert with two s’s!
2696,2852,6,32,112,150,1.2933333333333332,0.043910287499031204,652,They say it is haunted by two diabetics.
342,2854,7,25,101,133,1.2932330827067668,0.048657009197015086,652,"Tempting, but no shade."
1487,2854,7,25,101,133,1.2932330827067668,0.048657009197015086,652,Every time I start a diet.
3830,2854,9,21,103,133,1.2932330827067668,0.05094454707919094,652,And that’s the difference between deserted island and desserted island
8124,2854,5,29,99,133,1.2932330827067668,0.046256482906646926,652,I'm staying put.  That looks like some kind of Trojan Horse thing to me.
8457,2854,7,25,101,133,1.2932330827067668,0.048657009197015086,652,Can't. I'm on a diet.
5676,2859,10,31,133,174,1.293103448275862,0.04315159094718724,652,It's amazing what you can do with a whale carcass and enough microplastic.
6834,2859,7,20,89,116,1.293103448275862,0.053396260417591615,652,We picked the wrong time to start the 30-day no sugar challenge.
8195,2861,9,28,120,157,1.2929936305732483,0.045418145909484696,652,"I KNOW you wanted a burger, but this is the only joint that would deliver!"
7100,2861,9,28,120,157,1.2929936305732483,0.045418145909484696,652,I think I'll pass.  I'd hate to spoil my appetite.
6427,2861,8,30,119,157,1.2929936305732483,0.044510096163984346,652,Aren't we a pair. You with your borderline diabetes and me with high cholesterol.
4268,2861,9,28,120,157,1.2929936305732483,0.045418145909484696,652,It's for the survivors of the first Mediterranean diet.
3618,2861,7,32,118,157,1.2929936305732483,0.043583131406531896,652,"Dude, this view is sweet!"
1279,2861,9,28,120,157,1.2929936305732483,0.045418145909484696,652,I imagined you. Why can't I imagine Cupcake Island?
2,2861,6,34,117,157,1.2929936305732483,0.04263601794106621,652,I don't have a sweet tooth left.
7363,2868,10,21,109,140,1.292857142857143,0.05017587625756677,652,I wish we were stranded on Dessert Island.
6346,2868,8,25,107,140,1.292857142857143,0.048083975629902284,652,My next hallucination is going to have less carbs.
5744,2868,8,25,107,140,1.292857142857143,0.048083975629902284,652,"Hey, at least we aren’t on that island. They say too much sugar will kill you."
3400,2868,6,29,105,140,1.292857142857143,0.04589682850197191,652,"Yeah, I agree, it looks deserted."
6958,2868,8,25,107,140,1.292857142857143,0.048083975629902284,652,We need to re-evaluate our efforts to attract help.
2008,2868,9,23,108,140,1.292857142857143,0.049141058548792416,652,Desserted  Island?
1803,2868,8,25,107,140,1.292857142857143,0.048083975629902284,652,You really can't swim?
1520,2868,6,29,105,140,1.292857142857143,0.04589682850197191,652,It’s just a delirious Fig Newton of our imagination!
2577,2868,5,31,104,140,1.292857142857143,0.04476319854099585,652,If we look the other way it will be easier...
196,2877,9,30,125,164,1.2926829268292683,0.04408411708007125,652,"According to local legend, that island autocorrected to 'dessert'."
3559,2877,7,34,123,164,1.2926829268292683,0.042352992580866784,652,We can't because we don't have any toothbrushes.
5860,2877,6,36,122,164,1.2926829268292683,0.04146033383208245,652,I lost my left leg getting a piece of cake
9332,2877,8,20,95,123,1.2926829268292683,0.05256541061685997,652,"Yeah, but I'd hate if there was any sand on it..."
9434,2877,10,16,97,123,1.2926829268292683,0.0550425511397201,652,"Yeah, well, I think gluten is the least of our problems."
9759,2877,8,20,95,123,1.2926829268292683,0.05256541061685997,652,"I get it,Phil...a desserted island."
9748,2883,8,27,112,147,1.2925170068027212,0.04650779467361549,652,I hope we get marooned on a dessert island next time.
9860,2883,7,29,111,147,1.2925170068027212,0.04549491186152165,652,"Susie, I don’t think our travel agent can spell."
7636,2883,6,31,110,147,1.2925170068027212,0.04445895911030836,652,Do you have to be such a stickler for spelling?
271,2883,11,21,115,147,1.2925170068027212,0.04942204817437088,652,"Pick this island, you said. It'll be fun, you said."
90,2883,6,31,110,147,1.2925170068027212,0.04445895911030836,652,I'm starting to reconsider this whole gluten intolerance thing.
2969,2883,6,31,110,147,1.2925170068027212,0.04445895911030836,652,It's a mirage.  There's nothing there but kale and tofu.
7979,2889,10,30,131,171,1.2923976608187135,0.04364700199218211,652,But if we swam over it would be illegal immigration...
8020,2889,8,34,129,171,1.2923976608187135,0.04204119270069229,652,Why bother? The donut probably has coconut on it.
1214,2891,2,34,94,130,1.2923076923076924,0.042919894385555574,652,There goes the neighborhood. Next thing we know... TOURISTS!
1270,2891,8,22,100,130,1.2923076923076924,0.05057351916100387,652,Guess we started the Keto diet too soon.
4182,2891,4,30,96,130,1.2923076923076924,0.04561401651708575,652,It looks like a sweet deal but we might get in over our heads.
7139,2891,6,26,98,130,1.2923076923076924,0.04815765434045453,652,It was there when I woke up.  I think the sharks put it there for us.
3038,2895,10,25,119,154,1.2922077922077921,0.04691060391649483,652,It's called Dentist island.
3272,2895,10,25,119,154,1.2922077922077921,0.04691060391649483,652,"I told you there's a second ""s"" in ""dessert""!"
3659,2895,8,29,117,154,1.2922077922077921,0.04506484088691572,652,"well the grass was greener over here, but now I got the munchies."
4791,2895,8,29,117,154,1.2922077922077921,0.04506484088691572,652,The board game made it look bigger.
8079,2895,11,23,120,154,1.2922077922077921,0.047806769370392244,652,It appears to be a typo...
8549,2895,7,31,116,154,1.2922077922077921,0.0441130076773214,652,It appeared right after the sharks ate that Madison Avenue guy.
8127,2901,7,26,104,137,1.2919708029197081,0.04765945636245658,652,You can go if you want. But all the studies say they shorten your life expectancy.
9586,2901,5,30,102,137,1.2919708029197081,0.045351288480630324,652,"I've never been, but it's on my bucket list."
7881,2901,7,26,104,137,1.2919708029197081,0.04765945636245658,652,Don’t even think about it.  Cheat day is not until Sunday.
611,2901,12,16,109,137,1.2919708029197081,0.05299183725389957,652,I know I specified DESSERT island.
5250,2901,8,24,105,137,1.2919708029197081,0.048772594637979616,652,"Yeah, but the schools here are great."
7250,2901,7,26,104,137,1.2919708029197081,0.04765945636245658,652,"You know, that mirage is loaded with high-fructose corn syrup."
3730,2907,7,33,121,161,1.2919254658385093,0.042841386967846944,652,I don't care if it's a trap but I wish I had taken some swimming lessons.
5306,2907,12,23,126,161,1.2919254658385093,0.04715488516678607,652,We're on the wrong reality show.
8865,2909,9,17,94,120,1.2916666666666667,0.054741349205073335,652,I heard they're building a wall.
8828,2909,8,26,110,144,1.2916666666666667,0.04713530096155743,652,It wouldn't be so bad if I liked coconut.
8199,2909,5,25,90,120,1.2916666666666667,0.04935981384847322,652,I don't think this is what my doctor meant when she told me to stay away from sugar!
7897,2909,12,18,114,144,1.2916666666666667,0.051090478420513785,652,As if the confusion of desert island with deserted island was not bad enough already before this whole desserted island thing entered the picture.
7466,2909,10,22,112,144,1.2916666666666667,0.04915268854281311,652,"If that's heaven, we must be in hell."
7342,2909,4,27,89,120,1.2916666666666667,0.047920091827405385,652,"Yeah but there's no chocolate"""
6649,2909,10,22,112,144,1.2916666666666667,0.04915268854281311,652,Okay. But after we swim to the  Isle of Toothbrush.
5532,2909,9,24,111,144,1.2916666666666667,0.0481545604679525,652,No thanks. Too much palm oil.
2275,2909,8,26,110,144,1.2916666666666667,0.04713530096155743,652,And entirely free of cocoanut....
2124,2909,7,28,109,144,1.2916666666666667,0.0460935082154906,652,Somewhere Darwin is laughing at us.
1950,2909,9,24,111,144,1.2916666666666667,0.0481545604679525,652,It's a melange.
6705,2909,9,24,111,144,1.2916666666666667,0.0481545604679525,652,"Hansel, we got stranded on the wrong island."
3125,2921,7,30,114,151,1.2913907284768211,0.044661497483675136,652,Why do you get to be Hansel and I have to be Gretel?
6777,2921,9,26,116,151,1.2913907284768211,0.04659667154406444,652,"But then again, if they ARE gluten-free, we avoid the whole question of cannibalism."
4556,2923,8,21,98,127,1.2913385826771653,0.05136584197055362,652,Yesterday they were showing gin gimlets.
2409,2923,8,21,98,127,1.2913385826771653,0.05136584197055362,652,Talk about your childhood wishes...
1330,2925,9,28,121,158,1.2911392405063291,0.045167856347019135,652,Look on the bright side. Your BMI and cholesterol are way down.
1411,2925,9,28,121,158,1.2911392405063291,0.045167856347019135,652,It's great how much weight we've lost since we swam here.
6267,2925,10,26,122,158,1.2911392405063291,0.046051719860048704,652,We were just one spellcheck away...
7149,2925,12,22,124,158,1.2911392405063291,0.04777041147232562,652,What we really need is something savory.
9539,2925,9,28,121,158,1.2911392405063291,0.045167856347019135,652,I'm never making another New Years resolution
5856,2930,8,23,103,134,1.291044776119403,0.049489172468696274,652,Did you remember your epipen?
358,2930,7,25,102,134,1.291044776119403,0.04834208664303101,652,Empty calories. It wouldn't be worth the effort.
2419,2930,8,23,103,134,1.291044776119403,0.049489172468696274,652,"Don't fall for it, that is a Portuguese man of candy-land jelly fish."
3307,2930,6,27,101,134,1.291044776119403,0.04716711238106769,652,"I thought people only saw mirages in the desert, or should I say dessert?"
6271,2930,6,27,101,134,1.291044776119403,0.04716711238106769,652,"So technically that's still Paleo, right?"
6392,2930,8,23,103,134,1.291044776119403,0.049489172468696274,652,I can’t wait to be desserted.
6797,2930,7,25,102,134,1.291044776119403,0.04834208664303101,652,"“ It wasn’t there yesterday. It must be an ile flottante."""
4360,2937,4,40,121,165,1.290909090909091,0.0394138331711882,652,Let's swim over. We'll burn a few calories...
9887,2938,2,37,102,141,1.2907801418439717,0.040935126836723755,652,"Yeah, but if we were over there would you really want to be rescued?"
7865,2938,11,19,111,141,1.2907801418439717,0.05086785539495573,652,"I don't give a damn if it's the Good Ship Lollipop, I don't trust it."
7212,2938,11,19,111,141,1.2907801418439717,0.05086785539495573,652,Did you wish to be on a Deserted island or a Dessert-ed island?
9385,2938,9,23,109,141,1.2907801418439717,0.04883548369059827,652,Keep your eyes peeled for the Good Ship Lollipop.
8416,2938,8,25,108,141,1.2907801418439717,0.04778689511467523,652,The difference between here and there is one letter of the alphabet.
7195,2938,8,25,108,141,1.2907801418439717,0.04778689511467523,652,"I don't know Gretel, but an island made out of candy seems like a fairy tale."
6090,2938,6,29,106,141,1.2907801418439717,0.04561746485189126,652,The thing is we don’t have toothbrushes
6425,2938,8,25,108,141,1.2907801418439717,0.04778689511467523,652,Let’s wait—tomorrow’s our cheat day.
3036,2938,6,29,106,141,1.2907801418439717,0.04561746485189126,652,It’s all that’s left of The Good Ship Lollypop.
2093,2938,7,27,107,141,1.2907801418439717,0.04671477520129208,652,That's what's left of the Big Rock Candy Mountain. It's just the Little Sweets Iceberg after global warming.
826,2938,5,31,105,141,1.2907801418439717,0.04449310032937485,652,You think they're thinking the same thing we are?
7091,2938,7,27,107,141,1.2907801418439717,0.04671477520129208,652,I can’t believe you forgot your insulin pen.
6773,2950,11,21,116,148,1.2905405405405406,0.049126754247925356,652,Our island is better.  Do you realize how fat we’d be if we lived on that one.
6211,2950,7,29,112,148,1.2905405405405406,0.04522967310855908,652,"Well on the bright side, we're both diabetic."
2344,2950,7,29,112,148,1.2905405405405406,0.04522967310855908,652,"I thought my dream would come true, but I guess I mispelled dessert when I wished for an island getaway."
606,2950,11,21,116,148,1.2905405405405406,0.049126754247925356,652,One S makes all the difference.
237,2950,9,25,114,148,1.2905405405405406,0.04721843555457532,652,"Behold, the Islet of Langerhans."
1212,2950,6,31,111,148,1.2905405405405406,0.04420174958245293,652,It's not easy being diabetic.
2515,2956,7,31,117,155,1.2903225806451613,0.04386801044765344,652,So that’s where the good ship lollipop ended up
5181,2956,6,24,94,124,1.2903225806451613,0.04961719913588533,652,The last time share offered pizza.
5271,2956,7,31,117,155,1.2903225806451613,0.04386801044765344,652,Sharks? What about all that high-fructose corn syrup?
6395,2956,10,25,120,155,1.2903225806451613,0.046645084224594915,652,My turn. Let’s think about some power tools.
6582,2956,6,24,94,124,1.2903225806451613,0.04961719913588533,652,Is it cheat day yet?
8000,2961,9,29,124,162,1.2901234567901234,0.04437719097706396,652,"That's a lot of carbs, but if we swim and only eat half,  we're good."
4754,2961,4,39,119,162,1.2901234567901234,0.03982372281074658,652,"We COULD move, but I have dietary restrictions."
655,2961,9,29,124,162,1.2901234567901234,0.04437719097706396,652,"The last time you saw pastries and candy canes, we ended up on this side."
1447,2961,12,23,127,162,1.2901234567901234,0.046897534981269376,652,And I thought this was a deserted island.
4183,2961,9,29,124,162,1.2901234567901234,0.04437719097706396,652,"When I played it as a kid, the land just seemed bigger."
2276,2966,5,28,98,131,1.2900763358778626,0.04659712215479302,652,"I just realized, we're on a desert island, so those must be our just deserts."
3003,2966,9,20,102,131,1.2900763358778626,0.05139115723053826,652,"Dude, I told you to spell check Dessert Island before you got directions."""
3420,2966,4,30,97,131,1.2900763358778626,0.045319443741206736,652,"Trust me, it's just empty calories."
4049,2966,5,28,98,131,1.2900763358778626,0.04659712215479302,652,The dessertification of the south seas!
4836,2966,8,22,101,131,1.2900763358778626,0.050235557420990215,652,"Yes, but it's all carbs."
5267,2971,11,18,109,138,1.289855072463768,0.05163455240521216,652,A dessert island? Ironic!
9004,2971,8,24,106,138,1.289855072463768,0.04846408395601442,652,I know it's deserted but that's a pretty sweet view.
8222,2971,12,16,110,138,1.289855072463768,0.05264896508843832,652,That is all that is left after Hurri-cane Candy
7391,2971,9,22,107,138,1.289855072463768,0.049543455233689644,652,Well. obviously it's from the good ship Lollipop.
9146,2971,6,28,104,138,1.289855072463768,0.04622979978435579,652,Carbs don't count when you're a castaway.
5546,2971,7,26,105,138,1.289855072463768,0.04736011941389737,652,Did you put the wrong address for the delivery?
5179,2971,8,24,106,138,1.289855072463768,0.04846408395601442,652,"Hey, last week it was a full course meal!"
2700,2971,13,14,111,138,1.289855072463768,0.0536441986395602,652,"As Wittgenstein said, “The limits of my spelling are the limits of my world.”"
3136,2971,8,24,106,138,1.289855072463768,0.04846408395601442,652,"Thanks to global warming, that is all that’s left of Gumdrop Mountain"
3101,2971,6,28,104,138,1.289855072463768,0.04622979978435579,652,DO you think Lent is over by now?
2090,2971,7,26,105,138,1.289855072463768,0.04736011941389737,652,"Yes, but do they have coconut?"
1666,2971,6,28,104,138,1.289855072463768,0.04622979978435579,652,"Oh, it's like a current/currant thing.  That's funny, though not really right now."
785,2971,5,30,103,138,1.289855072463768,0.04507114226758212,652,It looks friendly.
4037,2971,7,26,105,138,1.289855072463768,0.04736011941389737,652,I can't handle eating another island.
7569,2985,7,28,110,145,1.289655172413793,0.04581869293791896,652,I'm Paleo but you go ahead.
6637,2985,7,28,110,145,1.289655172413793,0.04581869293791896,652,"Yes, we could, but it would take weeks to work off the calories."
3884,2985,4,34,107,145,1.289655172413793,0.04256754985549702,652,I understand that Willy Wonka bought his own island.
3099,2985,7,28,110,145,1.289655172413793,0.04581869293791896,652,I've never had a sweet tooth.I'm going to wait for the protein mirage before I waste my energy swimming out to it.
2642,2985,9,24,112,145,1.289655172413793,0.04786359267507359,652,"For the last time, that isn't Easter Island and this isn't Greenland!"
8181,2985,9,24,112,145,1.289655172413793,0.04786359267507359,652,Kinda want to play Candyland now
1258,2985,8,26,111,145,1.289655172413793,0.046852300510778884,652,I would go but it’s not locally sourced.
1020,2985,5,32,108,145,1.289655172413793,0.04367816091954022,652,Palm oil is so much healthier you know.
506,2985,9,24,112,145,1.289655172413793,0.04786359267507359,652,It's too pretty to eat
132,2985,7,28,110,145,1.289655172413793,0.04581869293791896,652,I propose a cost-benefit analysis.
1776,2985,7,28,110,145,1.289655172413793,0.04581869293791896,652,"Mr. Wonka trusted you, Charlie."
627,2996,7,30,115,152,1.2894736842105263,0.04440809644558711,652,Shipwrecked AND developing type 2 diabetes; no thanks.
1035,2996,9,26,117,152,1.2894736842105263,0.046328779191793075,652,I see danger written all over it.
2313,2996,9,26,117,152,1.2894736842105263,0.046328779191793075,652,Don't. It's just empty calories.
9506,2996,12,20,120,152,1.2894736842105263,0.04906904226316169,652,It was called Big Rock Candy Mountain till climate change took over.
9816,2996,11,22,119,152,1.2894736842105263,0.048172943992279234,652,I told you “dessert island” was spelled with two S’s!
10005,3001,7,32,120,159,1.2893081761006289,0.04311151787474359,652,It'll take all of our floss to build a raft.
3941,3002,9,17,95,121,1.2892561983471074,0.05434054507175087,652,"Well, I'm not sure what it is, but it's definitely not the land of milk and honey"""
5184,3002,9,17,95,121,1.2892561983471074,0.05434054507175087,652,That second ‘s’ really makes a difference.
3881,3004,7,34,125,166,1.2891566265060241,0.041914951498225626,652,I'm more of a pie guy anyway
56,3005,8,21,99,128,1.2890625,0.051013767718148216,652,How did you spell Dessert?
524,3005,5,27,96,128,1.2890625,0.047257909482034906,652,"Not to appear delusional, but the pie looks like a boat."
1019,3005,5,27,96,128,1.2890625,0.047257909482034906,652,We’ll we’ve got friendship.
6050,3005,8,21,99,128,1.2890625,0.051013767718148216,652,I said dessert NOT desert!
7113,3005,7,23,98,128,1.2890625,0.04979330276993271,652,"No, not interested. I just started working out again."
8298,3005,9,19,100,128,1.2890625,0.05220570843178142,652,They say hallucinations are to be expected during week one of the keto diet
8945,3011,4,31,100,135,1.288888888888889,0.04444444444444443,652,At first it seemed like a dream come true...
5088,3011,6,27,102,135,1.288888888888889,0.0468660354734897,652,"I swear they said covered with cannibals, not candy edibles."
2140,3011,7,25,103,135,1.288888888888889,0.048031069116936574,652,This would be a no-brainer if it weren't for the sharks.
117,3011,2,35,98,135,1.288888888888889,0.0418830753759585,652,Mirages can be so sarcastic.
4972,3011,5,29,101,135,1.288888888888889,0.04567129253140151,652,"OK, but you'll have to brush your teeth."
129,3016,4,33,105,142,1.2887323943661972,0.04308197916678708,652,That was Dave. Big fan of that British baking show.
1412,3016,7,27,108,142,1.2887323943661972,0.04642981037575552,652,"Of course it's a trap. If it were a humanitarian gesture, it would be covered in kale. OK, maybe a few rolls of paper towels, but mostly kale."
1468,3016,11,19,112,142,1.2887323943661972,0.05054985435188512,652,No way.... sugar kills.
3184,3016,10,21,111,142,1.2887323943661972,0.04955196922554898,652,Well there goes our South Beach diet.
8947,3016,10,21,111,142,1.2887323943661972,0.04955196922554898,652,Is it ironic our grass is greener.
9605,3016,8,25,109,142,1.2887323943661972,0.047493340716311595,652,Talk about gentrification
5429,3022,10,23,116,149,1.2885906040268456,0.0478972898300701,652,Still doubt climate change? That's the Big Rock Candy Mountain.
9544,3022,6,31,112,149,1.2885906040268456,0.043947371784862375,652,"We both know that it’s a mirage,but I’m smelling coffee."
8891,3022,9,25,115,149,1.2885906040268456,0.04694098051275167,652,Why couldn’t we land on THAT desserted island?
6327,3022,8,27,114,149,1.2885906040268456,0.045964779232922755,652,"I can't decide, let's split the whole mirage."
5309,3022,9,25,115,149,1.2885906040268456,0.04694098051275167,652,This South Beached diet is really working.
5164,3022,9,25,115,149,1.2885906040268456,0.04694098051275167,652,I believe they call it the Great Pacific Junk Food Patch.
3677,3022,8,27,114,149,1.2885906040268456,0.045964779232922755,652,"Forget  it, even if it’s real, it’s not worth the empty calories."
2884,3022,10,23,116,149,1.2885906040268456,0.0478972898300701,652,That giant clam is just mess’n with us.
2668,3022,7,29,113,149,1.2885906040268456,0.04496739049982912,652,"Oh, come on!  Has mythology taught you nothing?"
1507,3022,7,29,113,149,1.2885906040268456,0.04496739049982912,652,"Ever since I started that keto diet, I see it too."
1315,3022,8,27,114,149,1.2885906040268456,0.045964779232922755,652,The Good Ship Lollypop must have gone down last night too.
4608,3022,9,25,115,149,1.2885906040268456,0.04694098051275167,652,"Seriously.  If you repeat that pun one more time, I’ll kill you."
730,3034,6,33,117,156,1.2884615384615385,0.042667095141641895,652,"I'd swim it, but I think it's just bad copyediting."
4985,3034,10,25,121,156,1.2884615384615385,0.04638246383689735,652,We need to build a wall.
5273,3034,8,29,119,156,1.2884615384615385,0.04456351624034515,652,You go. I'll keep an eye peeled for sharks.
8265,3034,7,31,118,156,1.2884615384615385,0.04362561167209823,652,Too bad the insulin went down in the crash.
4747,3038,7,33,123,163,1.2883435582822085,0.0423893709912522,652,And then what?
4330,3039,11,27,132,170,1.2882352941176471,0.04449369838025287,652,I reckon we just missed it by one letter s.
10001,3039,10,29,131,170,1.2882352941176471,0.04370441111922959,652,"OK, it's bad for our teeth and there are sharks in the water, but I say we go for it."
6808,3041,5,26,94,125,1.288,0.047946206415913864,652,I gave up that island for Lent.
2175,3041,9,18,98,125,1.288,0.05305626958178915,652,"Before climate change, we called it 'The Big Rock Candy Mountain'."
8228,3043,9,20,103,132,1.2878787878787878,0.051047667271198825,652,"I blame Jeff Bezos.  I wrote Amazon Prime asking them to deliver me from a desert island.  Instead, they delivered a dessert island."
6675,3043,8,22,102,132,1.2878787878787878,0.04990194297647228,652,"Well Rob, this is as close to a desserted island as we're going to get."
8571,3043,8,22,102,132,1.2878787878787878,0.04990194297647228,652,I think we picked the wrong excursion.
6635,3043,10,18,104,132,1.2878787878787878,0.05216823511328475,652,I'll bet you that my mirage is better than your's
8668,3043,7,24,101,132,1.2878787878787878,0.04872928782388635,652,I'm thinking of getting off the South Beach diet.
3655,3043,5,28,99,132,1.2878787878787878,0.046294952746657965,652,Do you suppose the Good Ship Lollipop finally capsized?
3156,3043,7,24,101,132,1.2878787878787878,0.04872928782388635,652,"I mean, it's tempting, but all those empty calories!"
177,3043,6,26,100,132,1.2878787878787878,0.04752770845327204,652,It’s not my fault. I told the travel agent ‘Dessert Island’.
6196,3043,4,30,98,132,1.2878787878787878,0.04502846020919837,652,What are the chances?
147,3052,8,24,107,139,1.2877697841726619,0.04815932563978985,652,Man... I wish I had saved space for dessert...
2588,3052,12,16,111,139,1.2877697841726619,0.05231040340410853,652,I'm pretty sure I saw an ICE agent hiding behind the donut.
2720,3052,8,24,107,139,1.2877697841726619,0.04815932563978985,652,Worst part is we're not even lost. This is what Trump's global warming did to Cleveland. That's a Dairy Queen.
3836,3052,4,32,103,139,1.2877697841726619,0.043614939961646976,652,It may only be a mirage but it makes me happy
4403,3052,7,26,106,139,1.2877697841726619,0.04706438389614813,652,The good ship Lollipop ran aground there and Miss Temple was eventually rescued.
4706,3052,9,22,108,139,1.2877697841726619,0.049229920380137036,652,You know I wish we went to swim lessons
4967,3052,4,32,103,139,1.2877697841726619,0.043614939961646976,652,Candyland ? Or funny looking sub?
8973,3059,9,24,113,146,1.2876712328767124,0.04757601292775532,652,Look on the bright side: our island is gluten free.
8483,3059,8,26,112,146,1.2876712328767124,0.04657256375606114,652,"It’s just as well, I’m diabetic"
8133,3059,7,28,111,146,1.2876712328767124,0.04554701289352375,652,"Interesting, since I've stopped drinking, my fantasies have changed!"
7959,3059,8,26,112,146,1.2876712328767124,0.04657256375606114,652,So far it's better than the Fyre Festival
5516,3059,4,34,108,146,1.2876712328767124,0.042321512846945075,652,"If you say, ""The Big Rock Candy Island,"" I will throw you in the water."
4956,3059,7,28,111,146,1.2876712328767124,0.04554701289352375,652,"It's not that I don't feel lucky, I just wish we were stranded on a dessert island."
2433,3059,6,30,110,146,1.2876712328767124,0.044497832219482995,652,I would not bother. It is all high glycemic.
1916,3059,7,28,111,146,1.2876712328767124,0.04554701289352375,652,Do you think it’s worth the calories?
1611,3059,6,30,110,146,1.2876712328767124,0.044497832219482995,652,"Yes, but you can swim off all of those extra calories."
1316,3059,10,22,114,146,1.2876712328767124,0.04855873059905398,652,I don't care...it's full of high fructose corn syrup and I'm not eating it!
567,3059,11,20,115,146,1.2876712328767124,0.04952195097813759,652,What bothers me is that it’s slowly moving.
3229,3059,8,26,112,146,1.2876712328767124,0.04657256375606114,652,"Yes, you are better at spelling than I am, but here we both are."
3846,3071,13,18,122,153,1.2875816993464053,0.04965758449452629,652,"Is that with one ""s"" or two?"
93,3071,8,28,117,153,1.2875816993464053,0.04512071739016899,652,Empty calories.
3449,3071,8,28,117,153,1.2875816993464053,0.04512071739016899,652,Why do I have to wait for your cheat day?
4250,3071,6,32,115,153,1.2875816993464053,0.04317268249474997,652,I guess we should have sprung for the all-inclusive resort.
4369,3071,6,32,115,153,1.2875816993464053,0.04317268249474997,652,"If that was six women, I'd risk it."
5163,3071,8,28,117,153,1.2875816993464053,0.04512071739016899,652,I wonder where the kids went?
5300,3071,5,34,114,153,1.2875816993464053,0.042164928575618224,652,"One wish, and you leave out a lousy 's' ?"
8086,3071,10,24,119,153,1.2875816993464053,0.04698805977920887,652,Who eats cupcakes anymore?
2995,3079,9,28,123,160,1.2875,0.04467519044737731,652,God wasn’t sure how to spell it either.”
6699,3079,9,28,123,160,1.2875,0.04467519044737731,652,So candy land does exist.
5868,3081,4,27,91,122,1.2868852459016393,0.04725138260055944,652,"Actually, I prefer our more traditional look."
3489,3082,7,25,104,136,1.286764705882353,0.04772388840551284,652,If you were stuck on a dessert island...
9590,3082,9,21,106,136,1.286764705882353,0.04995432361957391,652,Uber Eats?
18,3082,11,17,108,136,1.286764705882353,0.05208934029181399,652,Looks like Someone misspelled desert island.
3015,3082,7,25,104,136,1.286764705882353,0.04772388840551284,652,Not that’s a real dessert island
7448,3086,6,29,108,143,1.2867132867132867,0.04506840355452776,652,I'm waiting for the healthy choice option.
6357,3086,9,23,111,143,1.2867132867132867,0.04823525855297528,652,Don't you think this should be a riddle?
5370,3086,8,25,110,143,1.2867132867132867,0.047203253186966256,652,I hate coconut.
3133,3086,6,29,108,143,1.2867132867132867,0.04506840355452776,652,Let’s go there on Cheat Day.
4090,3086,9,23,111,143,1.2867132867132867,0.04823525855297528,652,I’ll be Hansel and you’ll be Gretel.
1755,3086,10,21,112,143,1.2867132867132867,0.04924564167428332,652,"When I close my eyes, I can see Doris and the kids and our dogs. It's like they're right here with me. I guess it makes sense...they say you imagine those who have been there for you the most. Anyway, what about you - Who do you see, Jack?"
1495,3086,9,23,111,143,1.2867132867132867,0.04823525855297528,652,I was hoping for a grown up fantasy.
875,3086,4,33,106,143,1.2867132867132867,0.04282726802487756,652,I'm expecting the Good Ship Lollipop any day now.
672,3086,4,33,106,143,1.2867132867132867,0.04282726802487756,652,"You go ahead, I swore off refined sugars."
2341,3086,7,27,109,143,1.2867132867132867,0.04614817499309485,652,Candyland was just a game. This is reality.
8197,3096,9,25,116,150,1.2866666666666666,0.046666666666666676,652,Are we having a desert island mirage or a dessert island mirage?
7629,3096,7,29,114,150,1.2866666666666666,0.04470801785532241,652,"What did you expect to see on the Lollypop cruise, kale?"
7061,3096,10,23,117,150,1.2866666666666666,0.0476157876800411,652,That's where the Good Ship Lollipop sank.
6939,3096,6,31,113,150,1.2866666666666666,0.043695782427356215,652,No man is a coconut.
5258,3096,6,31,113,150,1.2866666666666666,0.043695782427356215,652,It would just go straight to my thighs.
4816,3096,5,33,112,150,1.2866666666666666,0.042659535198193106,652,...and I was just getting down to my target weight.
5244,3096,10,23,117,150,1.2866666666666666,0.0476157876800411,652,I suppose we could splurge just this once.
4328,3096,5,33,112,150,1.2866666666666666,0.042659535198193106,652,"Empty calories, man... empty calories."
3808,3096,12,19,119,150,1.2866666666666666,0.04945941926081123,652,"You have my insulin, right?"
3757,3096,4,35,111,150,1.2866666666666666,0.04159748171119138,652,"Enticing, but we have no dental plan."
2611,3096,9,25,116,150,1.2866666666666666,0.046666666666666676,652,You invest in coconuts and sugar cane and now look --gentrification.
1991,3096,6,31,113,150,1.2866666666666666,0.043695782427356215,652,"If one of us was a dentist, then I definitely would."
4377,3096,9,25,116,150,1.2866666666666666,0.046666666666666676,652,"No way,dude. Those carbs will kill you."
2378,3109,7,31,119,157,1.286624203821656,0.04338577281631521,652,My dentist was the developer.
7068,3109,9,27,121,157,1.286624203821656,0.04522879522522273,652,The Island of Misfit Foods.
9655,3109,7,31,119,157,1.286624203821656,0.04338577281631521,652,"That's my dream, this is our reality."
6008,3112,7,35,129,171,1.286549707602339,0.04103874193294408,652,"I was sure I had included the second ""s"" in the travel booking."
3947,3113,9,35,141,185,1.2864864864864864,0.040493509735217474,652,We have to wait 30 minutes before we can swim to the next island.
9742,3114,4,24,84,112,1.2857142857142858,0.04982041660449398,652,"Think about it Larry, if we make it, we'd be Dessert Island castaways.  Don't you agree that's more palatable?"
9094,3114,9,24,114,147,1.2857142857142858,0.04729176506299245,652,"In Homer's time, sailors succumb to a siren, not to a sugar-high."
9081,3114,7,26,107,140,1.2857142857142858,0.046772188798323865,652,"Hansel, that witch just won't stop following us"
8600,3114,3,34,103,140,1.2857142857142858,0.042148997061743014,652,Salty air always makes me crave sweets.
7727,3114,7,22,97,126,1.2857142857142858,0.05021495743414883,652,Better to be stranded on a dessert island.
6874,3114,6,32,116,154,1.2857142857142858,0.04293205686927954,652,Do you still want to give up sugar?
6867,3114,4,30,99,133,1.2857142857142858,0.04474100625662531,652,I wish we had more options
6605,3114,5,32,110,147,1.2857142857142858,0.04317127751539282,652,I'm beginning think that Charlie is not coming back.
5998,3114,8,32,128,168,1.2857142857142858,0.04233596225370394,652,Looks like I picked the wrong week to start the South Beach Diet.
5775,3114,7,30,117,154,1.2857142857142858,0.0439094972056236,652,I still don't think anyone will come.
9669,3114,7,26,107,140,1.2857142857142858,0.046772188798323865,652,"The next time you meet a genie, focus on annunciating the S."
5019,3114,8,26,113,147,1.2857142857142858,0.046296037440127856,652,"Yes, they look good, but not to die for..."
325,3114,10,18,105,133,1.2857142857142858,0.051819732150715114,652,The water's always bluer...
463,3114,7,28,112,147,1.2857142857142858,0.0452784178449531,652,"You had to spell it correctly, didn't you."
628,3114,9,22,109,140,1.2857142857142858,0.0489202155639534,652,We shouldn't of eaten the candy boat first.
892,3114,4,30,99,133,1.2857142857142858,0.04474100625662531,652,Would you believe I just spent 6 months losing 30 pounds?
5241,3114,7,24,102,133,1.2857142857142858,0.04840992811927757,652,I told you not to trust auto-correct.
2970,3114,4,34,109,147,1.2857142857142858,0.04207815635452091,652,"If we don't get rescued, no one would ever believe us."
3255,3114,9,16,94,119,1.2857142857142858,0.054875987837503935,652,If only we had been stranded on dessert island.
4107,3114,6,26,101,133,1.2857142857142858,0.047218640111304305,652,Guess it's not always grass.
4673,3114,7,30,117,154,1.2857142857142858,0.0439094972056236,652,Probably the result of the Candy Caine Mutany
2459,3114,8,24,108,140,1.2857142857142858,0.04785825496092456,652,"Look, the candy’s always sweeter on the other Island."
4497,3136,7,33,125,165,1.284848484848485,0.04194641692134844,652,"You may see a savior from starvation, but I see a disguised alien spaceship waiting for two more victims."
8823,3136,10,27,128,165,1.284848484848485,0.044511025404519275,652,"Sharks have become much more inventive. That's what they call ""man lure."""
9026,3136,7,33,125,165,1.284848484848485,0.04194641692134844,652,"Sure, being stranded sucks. But the view is pretty sweet."
9710,3136,11,25,129,165,1.284848484848485,0.04533366533349307,652,"Sure,it's all fun and games but then comes the anal probe."
5249,3140,9,27,122,158,1.2848101265822784,0.044978223252496785,652,"No, I don't think that's Sweden"
4036,3140,10,25,123,158,1.2848101265822784,0.04586574126769227,652,Nah! You go. I'm diabetic.
1927,3142,6,31,114,151,1.2847682119205297,0.04344693898505093,652,Well at least I can stick to my diet this vacation
3413,3142,8,27,116,151,1.2847682119205297,0.04543387446247395,652,We must have collided with the Good Ship Lollipop.
6861,3142,5,33,113,151,1.2847682119205297,0.04241858421046354,652,Wonka's tour was more fun before climate change.
8207,3142,7,29,115,151,1.2847682119205297,0.04445150984973728,652,Looks like the folks on the Good Ship Lollipop have colonized.
7926,3146,8,25,111,144,1.2847222222222223,0.046916574486865814,652,"I've said it once,and I'll say it again. I wish I could swim."
7804,3146,11,19,114,144,1.2847222222222223,0.04992534679856435,652,"No no no, I ordered a sub!"
8656,3146,10,21,113,144,1.2847222222222223,0.048942978616261415,652,It looks desserted but maybe someone is over there.
7192,3146,9,23,112,144,1.2847222222222223,0.04794048454810115,652,You go ahead.  I'm on a keto diet.
7017,3146,8,25,111,144,1.2847222222222223,0.046916574486865814,652,"Yeah, but ours has more personality."
4157,3146,5,31,108,144,1.2847222222222223,0.043701140376497465,652,I say let's go treat ourselves today for once.
6633,3146,10,21,113,144,1.2847222222222223,0.048942978616261415,652,It's the island of earthly desserts
6131,3146,5,31,108,144,1.2847222222222223,0.043701140376497465,652,So that’s where all the bees went.
1694,3146,5,31,108,144,1.2847222222222223,0.043701140376497465,652,Nows the time I wish I had taken swimming lessons.
1010,3146,8,25,111,144,1.2847222222222223,0.046916574486865814,652,Your no sugar diet is killing me.
6701,3146,7,27,110,144,1.2847222222222223,0.04586981430588673,652,"On the bright side, ours is gluten free!"
1830,3157,8,23,106,137,1.2846715328467153,0.04853909676452005,652,I think we got desserted on the wrong island
4024,3157,8,23,106,137,1.2846715328467153,0.04853909676452005,652,I could kill for some milk right now.
6459,3157,5,29,103,137,1.2846715328467153,0.04510008086298866,652,"Hallucination or not, it’s a damn side better sight than an island made of broccoli..."
4940,3160,5,27,98,130,1.2846153846153847,0.04663336666654655,652,So you're starving; I still prefer the mirage with the satyrs and nude dancing girls.
7775,3160,3,31,96,130,1.2846153846153847,0.04400170130691367,652,Even my mirages get confused between desert and dessert.
9165,3160,8,21,101,130,1.2846153846153847,0.050323480004737006,652,Don’t try to sweet talk me into swimming across
1713,3163,3,27,86,116,1.2844827586206897,0.047114703382027195,652,"No, you moron, “enjoy a dessert island escape” is not spelled with one s!"
3684,3164,9,30,130,169,1.2840236686390532,0.04294674859024001,652,The brochure said it was only a short walk away.'
9480,3165,7,32,123,162,1.2839506172839505,0.04242219164031854,652,Just tell me. How does a desert island become a dessert island?
5325,3165,7,32,123,162,1.2839506172839505,0.04242219164031854,652,They think we're suckers
6687,3165,11,24,127,162,1.2839506172839505,0.045895177175537906,652,It's no cakewalk...
4122,3165,10,26,126,162,1.2839506172839505,0.04505203715563248,652,Can I try your glasses for a sec ?
5135,3165,9,28,125,162,1.2839506172839505,0.04419281407390758,652,"I don't care if it's not your 'cheat day', I'm swimming over."
1201,3165,6,34,122,162,1.2839506172839505,0.04150856667564403,652,"Moment on the lips, forever on the hips."
5242,3171,10,24,121,155,1.2838709677419355,0.04645347480325674,652,"I prefer the all organic, non-GMO, gluten free mirage."
5505,3171,8,28,119,155,1.2838709677419355,0.04461334957357563,652,Good” ship lollipop my ass
6766,3171,9,26,120,155,1.2838709677419355,0.045542706778752565,652,Pretty sweet.
7002,3171,9,26,120,155,1.2838709677419355,0.045542706778752565,652,"Look! It's the good sub, Lollipop"
8913,3171,9,26,120,155,1.2838709677419355,0.045542706778752565,652,"I for one am glad it's shark infested water. A moment on the lips, a lifetime on the hips."
3822,3176,9,24,115,148,1.2837837837837838,0.047010794061335605,652,Could be worse.
7885,3176,10,22,116,148,1.2837837837837838,0.0479785725260198,652,"When they told me swimming lessons could save my life, this was NOT what I had in mind."
7438,3176,9,24,115,148,1.2837837837837838,0.047010794061335605,652,I guess I booked desert island instead of dessert island
7310,3176,8,26,114,148,1.2837837837837838,0.04602266935891564,652,The sharks are very creative with their bait.
2966,3176,8,26,114,148,1.2837837837837838,0.04602266935891564,652,Now I understand how mexicans see the US.
2092,3176,9,24,115,148,1.2837837837837838,0.047010794061335605,652,"It really bugs me how they've commercialized Christmas Island."""
424,3176,11,20,117,148,1.2837837837837838,0.04892721211137803,652,The thing is I've cut sugar.
4138,3176,8,26,114,148,1.2837837837837838,0.04602266935891564,652,"Ya know, I'm tired of coconuts."
7741,3184,4,32,105,141,1.2836879432624113,0.04309016151897889,652,So much for being rescued by the Good Ship Lollypop
8694,3184,6,28,107,141,1.2836879432624113,0.045380571447692516,652,the girl scouts are going all out!!
8621,3184,9,22,110,141,1.2836879432624113,0.048614273960435536,652,"People will come, Ray. People will most definitely come."
8258,3184,9,22,110,141,1.2836879432624113,0.048614273960435536,652,"Actually, I could go for something savory."
8910,3184,9,22,110,141,1.2836879432624113,0.048614273960435536,652,"Maybe it's just the dehydration, but I feel like this mirage is quizzing me on my grammar."
6019,3184,6,28,107,141,1.2836879432624113,0.045380571447692516,652,"""I don't know, I'm more of a pickles and chips person."""
5366,3184,8,24,109,141,1.2836879432624113,0.04756080855185876,652,New Year's resolution be damned ... I'm goin' for it.
5340,3184,8,24,109,141,1.2836879432624113,0.04756080855185876,652,They misspelled 'desert.
5311,3184,8,24,109,141,1.2836879432624113,0.04756080855185876,652,Clearly a deserted island.
2258,3184,5,30,106,141,1.2836879432624113,0.04425018804847509,652,"Next time, I'll roll the dice."
6614,3184,8,24,109,141,1.2836879432624113,0.04756080855185876,652,Too bad I lost my sweet tooth.
9678,3195,10,18,106,134,1.2835820895522387,0.0514757421065385,652,When you're really a stickler for grammar.
9476,3195,5,28,101,134,1.2835820895522387,0.045701726140799336,652,We clearly haven't been marooned long enough.
8322,3195,8,22,104,134,1.2835820895522387,0.049247439772548224,652,I’m holding out for maple-glazed bacon.
8051,3195,4,30,100,134,1.2835820895522387,0.04445702331032267,652,I'd like to see a mirage that is more vegan
7837,3195,8,22,104,134,1.2835820895522387,0.049247439772548224,652,"What do you think, real news or fake news?"""
6113,3195,5,28,101,134,1.2835820895522387,0.045701726140799336,652,I’d hate to ruin my diner.
3940,3195,8,22,104,134,1.2835820895522387,0.049247439772548224,652,"Well, at least we're healthy..."
2527,3195,11,16,107,134,1.2835820895522387,0.05255447531897648,652,Chutes and Ladders might have been more helpful.
2317,3195,6,26,102,134,1.2835820895522387,0.046913416235472225,652,Cheat day?
2199,3195,6,26,102,134,1.2835820895522387,0.046913416235472225,652,Too bad we're gluten free.
2025,3195,9,20,105,134,1.2835820895522387,0.05037391363379276,652,That island is sweet.
4025,3195,7,24,103,134,1.2835820895522387,0.04809458881742017,652,I think I'm having a dessert mirage.
8831,3207,8,20,99,127,1.2834645669291338,0.051106538129964296,652,From now on I Make the on-line reservations How could you Not know DeSSert Island has two S's
8545,3207,7,22,98,127,1.2834645669291338,0.04986876640419947,652,"See, that Keto diet is working already! I see that island, and I feel healtheir, happier, and I don't even want that cupcake."
1749,3207,8,20,99,127,1.2834645669291338,0.051106538129964296,652,I never have liked puns.
3401,3207,9,18,100,127,1.2834645669291338,0.052315032414998804,652,"Let's send the person who invented auto-correct to dessert island, and when he gets here ask him how HE likes it."
6293,3207,9,18,100,127,1.2834645669291338,0.052315032414998804,652,Don't spoil your appetite now. Just wait for low tide when you can see the whole pyramid.
5701,3212,6,22,92,120,1.2833333333333334,0.05046469400286688,652,See what happens when you let Amazon come in and build a new headquarters?
9419,3213,6,20,87,113,1.2831858407079646,0.05254133666830936,652,"Ohhhhh wait. So what you actually said was, ‘life would be sweet on a DESSERTED island?’"
9767,3213,5,22,86,113,1.2831858407079646,0.051015333440031146,652,"I don’t care how hungry you get, Kevin, we’re sticking to the diet"
1286,3215,7,33,126,166,1.283132530120482,0.041728258712600705,652,The sweetest part is the anticipation.
1485,3216,11,23,125,159,1.2830188679245282,0.046476070349953214,652,At last... the dessert cart!
2572,3216,8,29,122,159,1.2830188679245282,0.04383138860991945,652,"I know, but I'm much happier gluten-free."""
2638,3216,11,23,125,159,1.2830188679245282,0.046476070349953214,652,...and we got stranded on Vegan Island!!
6102,3216,6,33,120,159,1.2830188679245282,0.04197579821365831,652,We may be the only castaways who gained weight during their ordeal.
7046,3216,8,29,122,159,1.2830188679245282,0.04383138860991945,652,I'll bet that donut floats as well.
7326,3216,9,27,123,159,1.2830188679245282,0.04473032666294518,652,Welcome to Atkins Island.
8827,3216,9,27,123,159,1.2830188679245282,0.04473032666294518,652,"I knew that shark’s camouflage 
abilities had evolved, but this
is a little scary"
8703,3223,5,33,114,152,1.2828947368421053,0.04218021713833118,652,"Let’s face it, you can’t have your cookies, candy and cake and the shade of the palm tree too."
6317,3223,7,29,116,152,1.2828947368421053,0.04419782199744824,652,Or maybe we're pastries dreaming we're humans!
3380,3223,7,29,116,152,1.2828947368421053,0.04419782199744824,652,So... What are you giving up for Lent this year?
5736,3223,11,21,120,152,1.2828947368421053,0.04797917227590347,652,Doesn't bother me. I'm a diabetic who can't swim.
7515,3227,6,29,110,145,1.282758620689655,0.04453188650071384,652,I'm kind of holding out for the Cheesecake Factory.
1092,3227,6,29,110,145,1.282758620689655,0.04453188650071384,652,You go ahead. I'm diabetic.
1482,3227,9,23,113,145,1.282758620689655,0.047649189260170415,652,It's the good ship Lollipop. Goes by every Saturday.
1931,3227,7,27,111,145,1.282758620689655,0.045594674644364834,652,"But honey, what about your New Year's resolution?"
3937,3227,4,33,108,145,1.282758620689655,0.042326327906947056,652,"Unless there’s an insulin island close by, I’ll pass."
5203,3227,9,23,113,145,1.282758620689655,0.047649189260170415,652,"It's February, all that stuff is stale."
5221,3227,6,29,110,145,1.282758620689655,0.04453188650071384,652,This is what we get for buying cheap airfare tickets.They sent us to the wrong desserted island.
7738,3227,7,27,111,145,1.282758620689655,0.045594674644364834,652,I always knew that spelling bee in 4th grade would come back to haunt me.
7911,3227,8,25,112,145,1.282758620689655,0.04663324775885241,652,That was the one thing you’d bring?
7957,3227,8,25,112,145,1.282758620689655,0.04663324775885241,652,You go ahead. I'm still on the Atkins Diet.
8414,3227,9,23,113,145,1.282758620689655,0.047649189260170415,652,Don’t you know the difference between dessert and desert?
9032,3238,8,23,107,138,1.2826086956521738,0.04823021509412167,652,Don't worry.  A Disney cruise is bound to come by soon.
7498,3238,6,27,105,138,1.2826086956521738,0.045984569177401784,652,It’s also spelled differently.
9492,3238,10,19,109,138,1.2826086956521738,0.050375854271855605,652,"It's a new Amazon location, and it's not an isolated incident"
7067,3238,7,25,106,138,1.2826086956521738,0.04712077169601795,652,I thought Christmas Island was further north.
9201,3238,6,27,105,138,1.2826086956521738,0.045984569177401784,652,"I'm just telling you, last time I went there I really regretted it."
5742,3238,10,19,109,138,1.2826086956521738,0.050375854271855605,652,Who knew the Good Ship Lollipop was not seaworthy?
2687,3238,10,19,109,138,1.2826086956521738,0.050375854271855605,652,I'm thinking of giving up on the New Yorker Caption Contest
6412,3238,8,23,107,138,1.2826086956521738,0.04823021509412167,652,That genie really was a stickler for inflection.
4564,3238,8,23,107,138,1.2826086956521738,0.04823021509412167,652,Are you a dentist?
4462,3238,6,27,105,138,1.2826086956521738,0.045984569177401784,652,Well I guess I can check type 2 diabetes off my bucket list.
2772,3248,8,19,97,124,1.282258064516129,0.05192401480808935,652,"'Desert', with one S"
3431,3248,6,23,95,124,1.282258064516129,0.049333990581217756,652,One of us is having the mother of all hallucinations...
4964,3248,5,25,94,124,1.282258064516129,0.04798658440758398,652,Thank god we found the Islets of Insulin.
6193,3248,4,27,93,124,1.282258064516129,0.04660023540224536,652,So this is what it felt like to be at the Fyre festival.
9973,3248,9,17,98,124,1.282258064516129,0.05317173739264293,652,If it were a real mirage it would have meat and potatoes.
7577,3253,7,32,124,163,1.2822085889570551,0.04219710304169643,652,You go. I prefer savory.
7414,3253,8,30,125,163,1.2822085889570551,0.04308521634099655,652,All that's left of the Good Ship Lollypop.
376,3255,9,26,121,156,1.2820512820512822,0.045286398422963496,652,"Wait, so then what's a homonym?"
859,3255,7,30,119,156,1.2820512820512822,0.043421560430802184,652,This is the human condition: we always want what we can’t have.
4156,3255,9,26,121,156,1.2820512820512822,0.045286398422963496,652,Is that the winter White House?
5260,3255,9,26,121,156,1.2820512820512822,0.045286398422963496,652,"It could be worse, we could be stranded on a dessert island."
8560,3255,3,27,87,117,1.2820512820512822,0.046773519588670424,652,It's all empty calories anyway.
9249,3260,11,20,118,149,1.2818791946308725,0.0486350391551731,652,For sure it's not the Atkins Island!
6069,3260,8,26,115,149,1.2818791946308725,0.045752408340147585,652,The question remains: are they candy canes or antennae?
5688,3260,9,24,116,149,1.2818791946308725,0.04673304602196192,652,It seems your pie in the sky ideas have come down to earth.
4825,3260,7,28,114,149,1.2818791946308725,0.04475028656172384,652,Darn! I was hoping we'd catch the main course . . .
3664,3260,8,26,115,149,1.2818791946308725,0.045752408340147585,652,Last year it was a miniature golf course. Some locations just don’t do well no matter what you put on them.
3613,3260,9,24,116,149,1.2818791946308725,0.04673304602196192,652,"Did you use one ""s"" or two when you put the note in the bottle?"
2614,3260,7,28,114,149,1.2818791946308725,0.04475028656172384,652,Go for it. I'm more of a red meat guy.
578,3260,8,26,115,149,1.2818791946308725,0.045752408340147585,652,It all looks good except for the coconut creme pie.
4448,3260,9,24,116,149,1.2818791946308725,0.04673304602196192,652,Too bad the cartoonist didn’t know the difference between “desert” and “dessert”!
9696,3269,9,22,111,142,1.2816901408450705,0.0483120301873452,652,"Well, I did pay extra for a sweet view."
8623,3269,7,26,109,142,1.2816901408450705,0.04619818198900105,652,I wish it was a meringue instead of a mirage.
7986,3269,7,26,109,142,1.2816901408450705,0.04619818198900105,652,Everything's sweeter on the other side.
7155,3269,4,32,106,142,1.2816901408450705,0.04283225019173897,652,You should swing by my place. It's pretty sweet.
6880,3269,7,26,109,142,1.2816901408450705,0.04619818198900105,652,I thought you said dessert island not deserted island.
6162,3269,7,26,109,142,1.2816901408450705,0.04619818198900105,652,It's not the carbs that are bothering me.
4827,3269,3,34,105,142,1.2816901408450705,0.04164986837459005,652,All I can see is heartburn
4697,3269,5,30,107,142,1.2816901408450705,0.043982857767029745,652,I hear it's members only...
4148,3269,5,30,107,142,1.2816901408450705,0.043982857767029745,652,Seems our neighbor has a sweet tooth.
3857,3269,9,22,111,142,1.2816901408450705,0.0483120301873452,652,My fantasy island would have booze and babes.
2798,3269,3,34,105,142,1.2816901408450705,0.04164986837459005,652,Nothing's hopeless. Think Tom Hanks.
2377,3269,5,30,107,142,1.2816901408450705,0.043982857767029745,652,Make one typo on one restaurant menu...
5842,3269,6,28,108,142,1.2816901408450705,0.045104122851706306,652,"If stranded on a dessert island, what's the one thing you'd most like to have?"""
10006,3282,5,28,102,135,1.2814814814814814,0.04541054279081359,652,"On the bright side, we won't have to worry about gaining weight"
8038,3282,9,20,106,135,1.2814814814814814,0.05004348783418763,652,"No, actually...I think it’s, “desserted isle.”"
8438,3282,9,20,106,135,1.2814814814814814,0.05004348783418763,652,"When the Good Ship Lollipop swings by, we make our move."
4593,3282,9,20,106,135,1.2814814814814814,0.05004348783418763,652,I wonder if they have NY style pizza
1550,3282,5,28,102,135,1.2814814814814814,0.04541054279081359,652,I told you Candyland was real.
7992,3282,6,26,103,135,1.2814814814814814,0.04661196966520355,652,Was that there yesterday?
3873,3288,10,27,130,167,1.281437125748503,0.04404206293391515,652,I heard it’s pretty sweet on that island.
4899,3288,12,23,132,167,1.281437125748503,0.04565077262501024,652,We called it Big Rock Candy Mountain until global warming.
2475,3290,7,31,122,160,1.28125,0.042681240447807064,652,Isn't the final stage of dehydration seeing candy?
3039,3290,11,23,126,160,1.28125,0.046218542761196545,652,I always forget which one has two s’s.
7995,3290,6,24,98,128,1.28125,0.04826913047376049,652,This game is way more fun then saying what shapes you see in the clouds
8403,3290,7,22,99,128,1.28125,0.04952716883444788,652,Turns out my travel agent is a real stickler about spelling.
9009,3294,9,25,119,153,1.2810457516339868,0.045862071241845694,652,I wish our island was desserted.....
5459,3294,7,29,117,153,1.2810457516339868,0.043946910637508094,652,"No, dessert has 2 “s’s.”"
5197,3294,8,27,118,153,1.2810457516339868,0.04491469989420642,652,I guess the women want us to come back??
5186,3294,6,31,116,153,1.2810457516339868,0.04295732350339832,652,Looks like they've evolved to lure land-based prey.
6143,3294,8,27,118,153,1.2810457516339868,0.04491469989420642,652,"After all this time, I still can’t remember which one is spelled with two S’s."
4567,3294,10,23,120,153,1.2810457516339868,0.04679026491266783,652,Good thing it's a mirage.  I'm diabetic.
4120,3294,8,27,118,153,1.2810457516339868,0.04491469989420642,652,at least we have better shade.
3611,3294,7,29,117,153,1.2810457516339868,0.043946910637508094,652,Those carbs will kill you.
998,3294,8,27,118,153,1.2810457516339868,0.04491469989420642,652,Did you pack my insulin?
5118,3294,12,19,122,153,1.2810457516339868,0.048593492512975865,652,I could have sworn the tickets said Dessert Island.
294,3304,4,26,91,121,1.28099173553719,0.04727147506480756,652,"Yes, but the view is better from over here."
6594,3304,10,14,97,121,1.28099173553719,0.055326653936366495,652,At least we are not stranded on a dessert.
9263,3306,6,29,111,146,1.2808219178082192,0.04426820678301526,652,I don't know about you but I just don't think I've earned it.
5787,3306,4,33,109,146,1.2808219178082192,0.0420800131797113,652,That’s how I remember there’s one S in deserted.
3831,3306,9,23,114,146,1.2808219178082192,0.04736131401948726,652,"I don't know whether to be flattered or not when you say you prefer cannibalism."""
3456,3306,7,27,112,146,1.2808219178082192,0.045322703395465715,652,I don't care what you're giving up for Lent.
2365,3306,10,21,115,146,1.2808219178082192,0.04834839580525957,652,"Looks good, Gretel ."
63,3306,6,29,111,146,1.2808219178082192,0.04426820678301526,652,"It's true, the grass is sweeter on the other side!"
3107,3306,10,21,115,146,1.2808219178082192,0.04834839580525957,652,"Do you think it's a mirage, Wilson?"
7092,3313,7,34,130,171,1.280701754385965,0.04085696891379272,652,I’ll go first to make sure it’s safe.
4968,3314,4,31,104,139,1.2805755395683454,0.04335619767464587,652,Think positive!  We don't eat carbs anyways!
9546,3314,9,21,109,139,1.2805755395683454,0.04900083621306406,652,"So he eats desserts,shoots,AND leaves?"
9139,3314,6,27,106,139,1.2805755395683454,0.04569779760462853,652,I can''t help wondering what's below the surface.
7940,3314,5,29,105,139,1.2805755395683454,0.04454238758035183,652,Are we still doing Atkins?
6544,3314,6,27,106,139,1.2805755395683454,0.04569779760462853,652,Just give it a month and your body will naturally stop craving that stuff.
4790,3314,8,23,108,139,1.2805755395683454,0.04792512425674259,652,My disdain for corn syrup suddenly seems misplaced.
9286,3314,9,21,109,139,1.2805755395683454,0.04900083621306406,652,It was nice of your ex to remember your birthday but you should have called someone else before your phone died.
4237,3314,7,25,107,139,1.2805755395683454,0.046824706304139325,652,At least we can catch the Swedish Fish.
1376,3314,9,21,109,139,1.2805755395683454,0.04900083621306406,652,For how long has The Great British Baking Show had a mirage challenge?
3488,3314,8,23,108,139,1.2805755395683454,0.04792512425674259,652,"No, no – go on without me. I'm trying to stick to my resolutions this year."
4530,3314,7,25,107,139,1.2805755395683454,0.046824706304139325,652,"Yeah, and all because of a typo."
3954,3314,9,21,109,139,1.2805755395683454,0.04900083621306406,652,"Yes, Frank, her divorce attorney WAS pretty good."
4158,3314,6,27,106,139,1.2805755395683454,0.04569779760462853,652,We'll be saved. The Good Ship Lollipop docks here once a week.
3851,3314,4,31,104,139,1.2805755395683454,0.04335619767464587,652,Beware of turtles bearing gifts.
3202,3328,6,34,124,164,1.2804878048780488,0.04107341384083192,652,I told you it was all inclusive
6408,3328,8,30,126,164,1.2804878048780488,0.042856256517744475,652,Too bad we gave up sugar.
9904,3330,6,25,101,132,1.2803030303030303,0.04726426699385176,652,"I kinda wish it was ""Beer Land"".."
7538,3330,5,27,100,132,1.2803030303030303,0.046024455602018496,652,All I want for Christmas is an isthmus.
6570,3330,7,23,102,132,1.2803030303030303,0.04847237724178624,652,You’re really a dentist?
2848,3330,4,29,99,132,1.2803030303030303,0.04475030829456082,652,Don't bother swimming over.  These things always turn out to be mirages.
4358,3330,6,25,101,132,1.2803030303030303,0.04726426699385176,652,I’ve been there.  It’s not so great.
3294,3330,8,21,103,132,1.2803030303030303,0.049651100455820406,652,When my doctor told me to start watching carbs...
8946,3336,9,26,122,157,1.2802547770700636,0.04503287392732904,652,"Just our luck. If we had another ""s"" we'd be on the dessert island."
7049,3337,8,26,116,150,1.28,0.04548520422216428,652,"Maybe so, but this one is gluten-free."
8684,3337,10,22,118,150,1.28,0.047411757195425085,652,Added sugars really can hide in some surprising places.
7906,3337,7,28,115,150,1.28,0.044490654575079204,652,"No, ours only has one 's'."
7778,3337,8,26,116,150,1.28,0.04548520422216428,652,Sweeeeeeeeeeeeeeet!
7534,3337,7,21,97,125,1.28,0.05028948456749697,652,"Before Global Warming, we called that Big Rock Candy Mountain"
7514,3337,4,34,112,150,1.28,0.04136377604474826,652,"Okay but this time, get the donut."
4441,3337,7,21,97,125,1.28,0.05028948456749697,652,Whatever happened to cream colored ponies and crisp apple strudels?
3434,3337,6,23,96,125,1.28,0.04898979485566356,652,I find that people often underestimate the difficulty of living with diabetes.
3063,3337,4,34,112,150,1.28,0.04136377604474826,652,You know the angler fish that tease you with a worm-like tentacle? I don't think it's an island. Just sayin'.
2468,3337,7,28,115,150,1.28,0.044490654575079204,652,Some day all that could be ours.
1528,3337,4,27,94,125,1.28,0.046281048863125035,652,"This is exactly what I was telling my therapist, I'm always unsatisfied with what I got."
546,3337,8,19,98,125,1.28,0.05155642070711495,652,I still stand behind my vote for the Brexit.
413,3337,9,24,117,150,1.28,0.0464584681381658,652,It's obviously a dessert-ed island
4112,3337,9,24,117,150,1.28,0.0464584681381658,652,And just this morning I went on a diet.
9903,3351,5,30,108,143,1.2797202797202798,0.04371860360477925,652,So the good news is it’s gluten free. The bad news is they don’t take Apple Pay...
9525,3351,5,30,108,143,1.2797202797202798,0.04371860360477925,652,Pay no attention; it's just another dessert mirage!
7136,3351,6,28,109,143,1.2797202797202798,0.044830897352064594,652,You mean I could have brought three things to a desserted island?
8884,3351,8,24,111,143,1.2797202797202798,0.04697654169764333,652,Screw the carbs.  I say we go for it.
2657,3351,7,26,110,143,1.2797202797202798,0.045916254351056195,652,Let's wait for The Good Ship Lollipop.
2165,3351,4,32,107,143,1.2797202797202798,0.04257726206453724,652,Think we picked the wrong week to go carb free!
529,3351,6,28,109,143,1.2797202797202798,0.044830897352064594,652,"Yes, I see it. But do you see the Minotaur?"
3059,3351,6,28,109,143,1.2797202797202798,0.044830897352064594,652,Castaway 2: the cake-walk
4541,3359,6,33,122,161,1.279503105590062,0.041526744473159696,652,The extra 's' makes all the difference.
6240,3359,6,33,122,161,1.279503105590062,0.041526744473159696,652,Of all the months to start this detox diet.
7176,3359,11,23,127,161,1.279503105590062,0.04596378209311191,652,"Unfortunately, no dessert until we clean our plates. Unfortunately, no plates."
8795,3359,6,33,122,161,1.279503105590062,0.041526744473159696,652,I don’t care that Fred was eaten by a giant squid – I’m feeling lucky.
6542,3363,8,22,106,136,1.2794117647058822,0.048609394707985344,652,One more S and we could've been on a dessert island.
9872,3363,9,20,107,136,1.2794117647058822,0.049717257725566,652,God’s idea of a micro-aggression.
8273,3363,6,26,104,136,1.2794117647058822,0.04631423463827765,652,"Dude,it's an illusion. It's just a million pounds of garbage.
The doughnut is a tire,the frosting is grocery bags,the candy canes are broken arches from the burger place..."
7817,3363,7,24,105,136,1.2794117647058822,0.04747568632471863,652,"First, it's a Caribbean island, not a Carb island and it wasn't funny the first hundred times you said it."
6951,3363,8,22,106,136,1.2794117647058822,0.048609394707985344,652,"Just think  —  If we’d washed up over there, we’d be diabetic by now."
6325,3363,3,32,101,136,1.2794117647058822,0.04264048480620878,652,"Hansel, what couid possibly go wrong if we were to swim over and take a nibble or two?"
87,3363,4,30,102,136,1.2794117647058822,0.043899241523996296,652,"Damn, I'm diabetic."
4313,3363,7,24,105,136,1.2794117647058822,0.04747568632471863,652,No dessert until you eat some dinner.
4020,3363,10,18,108,136,1.2794117647058822,0.050800966306006334,652,"Hey, I like puns as much as the next man, but I refuse to say it."
1910,3363,5,28,103,136,1.2794117647058822,0.0451228973832111,652,It’s not just the grass that’s greener on the other island
1014,3363,7,24,105,136,1.2794117647058822,0.04747568632471863,652,"Look! It’s Candyland! But 
Where’s the Good Ship Lollipop!?"
5521,3363,8,22,106,136,1.2794117647058822,0.048609394707985344,652,Too bad there's no ice cream.
3249,3375,9,25,120,154,1.2792207792207793,0.04559982603418519,652,"Before we start swimming, did you bring your insulin?"
3829,3375,8,27,119,154,1.2792207792207793,0.04465939650873419,652,"So, maybe next time I will take the free swim lessons at the ""Y""."
4417,3375,8,27,119,154,1.2792207792207793,0.04465939650873419,652,"Great, another Fyre festival."
6957,3375,11,21,122,154,1.2792207792207793,0.04742477211326568,652,Darn autocorrect! I'm sure the artist meant to put us on a dessert island.
9800,3375,7,29,118,154,1.2792207792207793,0.04369873291870972,652,I wonder what THEIR ship was like?
9619,3380,9,18,102,129,1.2790697674418605,0.05159371903865945,652,I told you we should’ve paid for the extra S.
8442,3380,3,30,96,129,1.2790697674418605,0.04399054055355104,652,Looks like there's one  good thing about surviving the sinking of the Good Ship Lollipop.
7758,3380,9,18,102,129,1.2790697674418605,0.05159371903865945,652,Big rock candy mountain  isnt the same with global  warming.
5603,3380,6,24,99,129,1.2790697674418605,0.04794308866997281,652,Have you given any thought to the North Beach Diet instead?
4068,3380,7,22,100,129,1.2790697674418605,0.04919007808719789,652,I could have sworn it was a typo.
2399,3380,6,24,99,129,1.2790697674418605,0.04794308866997281,652,So real I can almost taste it
6757,3380,6,24,99,129,1.2790697674418605,0.04794308866997281,652,"I prefer desert to dessert, don't you?"
5702,3387,7,27,113,147,1.2789115646258504,0.04505384898202644,652,And that’s Neil Young’s place over there.
9782,3387,5,31,111,147,1.2789115646258504,0.042935688976236765,652,We can either die of sun or sugar exposure
9022,3387,6,29,112,147,1.2789115646258504,0.04400751467624242,652,Must have been shipwrecked ssometime in the 1950's
8660,3387,12,17,118,147,1.2789115646258504,0.04995787334017542,652,I was wrong. Keto island is not fun at all.
7522,3387,6,29,112,147,1.2789115646258504,0.04400751467624242,652,It's at moments like this that my commitment to a calorie free diet begins to waver.
6786,3387,10,21,116,147,1.2789115646258504,0.04805635429828093,652,Go for it. I'm off sugar.
6316,3387,9,23,115,147,1.2789115646258504,0.04707680138163968,652,"Remember, we pledged solidarity on this keto diet no matter what."
6070,3387,4,33,110,147,1.2789115646258504,0.04183641270171937,652,"My bad, dude. Like, I totally swear I clicked on ""dessert"" island for one week, two guests."
4338,3387,8,25,114,147,1.2789115646258504,0.04607642855312028,652,That was my favorite campaign promise.
1719,3387,7,27,113,147,1.2789115646258504,0.04505384898202644,652,Maybe we should have opted for all inclusive.
3371,3387,7,27,113,147,1.2789115646258504,0.04505384898202644,652,"I don't care if it's just a typo, let's go after dinner!"
3223,3387,9,23,115,147,1.2789115646258504,0.04707680138163968,652,Don't worry. I'm pretty sure they can't swim.
2299,3387,11,19,117,147,1.2789115646258504,0.0490163355276326,652,"No Carl! You haven't had sugar in 2 months, don't cave now."
1876,3387,6,29,112,147,1.2789115646258504,0.04400751467624242,652,"No, there’s no ‘dessert island’; it’s a mirage.  Look, all the calories are empty!"
1851,3387,11,19,117,147,1.2789115646258504,0.0490163355276326,652,I wished to be off the desserted island...
1671,3387,7,27,113,147,1.2789115646258504,0.04505384898202644,652,"Or...We can sit here until we starve to death, 
debating whether too much sugar is bad for your diet!"
88,3387,7,27,113,147,1.2789115646258504,0.04505384898202644,652,"I mean, I would, but think of the calories!"
3761,3387,8,25,114,147,1.2789115646258504,0.04607642855312028,652,Has that always been there?
9572,3405,7,32,126,165,1.2787878787878788,0.04175375565679171,652,But do they have coconut milk?
4901,3406,6,27,107,140,1.2785714285714285,0.04541445222616682,652,It's the Russians trying to tempt us to come over to their side.
5520,3406,5,29,106,140,1.2785714285714285,0.04426847126436581,652,But what if there's a witch with a snorkel?
5012,3406,5,29,106,140,1.2785714285714285,0.04426847126436581,652,Carmen Miranda goes snorkeling every day about this time.
4598,3406,7,25,108,140,1.2785714285714285,0.046532218880272584,652,You've gotta have a dream.
1324,3406,7,25,108,140,1.2785714285714285,0.046532218880272584,652,"There's a blonde curly headed kid over there that keeps singing ""On the Good Ship Lollypop"" and I couldn't take it anymore."
2196,3406,6,27,107,140,1.2785714285714285,0.04541445222616682,652,"Now might be a good time to give up my ""no sugar"" diet."
1627,3406,7,25,108,140,1.2785714285714285,0.046532218880272584,652,"'""Damn the sharks!"""
2524,3406,6,27,107,140,1.2785714285714285,0.04541445222616682,652,"If I swim back and forth between each bite, I can burn off the carbs and still look great in my bathing suit!"
4742,3414,8,28,122,158,1.2784810126582278,0.04387265598158213,652,"Can't swim, can you?"
6943,3414,3,38,117,158,1.2784810126582278,0.03900873834746539,652,I prefer my girls in grass skirts mirage...
6984,3414,9,26,123,158,1.2784810126582278,0.04478209014730891,652,"I don't care if you are a dentist, I'm going over."
319,3417,7,23,103,133,1.2781954887218046,0.04815268618576098,652,It's only a mirage; we still have 29 more days of this diet
985,3417,6,25,102,133,1.2781954887218046,0.04695487216840901,652,It's the worst when the wind is out of the East!
5814,3417,4,29,100,133,1.2781954887218046,0.04446254251891293,652,"No Sh*t, that's Candyland?"
7523,3417,11,15,107,133,1.2781954887218046,0.05267224936449324,652,Don’t do it. We’ve got all the food I need right here.
7831,3417,5,27,101,133,1.2781954887218046,0.04572569139771301,652,Sorry about that I really thought it was a muffin top
7913,3417,4,29,100,133,1.2781954887218046,0.04446254251891293,652,Any plans for tonight?
10024,3417,7,23,103,133,1.2781954887218046,0.04815268618576098,652,"Well, you should've gone over on cheat day"
9211,3424,9,24,118,151,1.2781456953642385,0.04618700867327866,652,All that talk about how smart dolphins are.  You can't help but admire these local sharks!
5119,3424,9,24,118,151,1.2781456953642385,0.04618700867327866,652,I guess there are two S's in dessert island...
2971,3424,10,22,119,151,1.2781456953642385,0.04713321536810394,652,I imagined a different kind of treasure.
64,3424,8,26,117,151,1.2781456953642385,0.045221007833030055,652,"What a difference an 's' makes, huh?"
2086,3424,10,22,119,151,1.2781456953642385,0.04713321536810394,652,I wonder if they're wondering about us
6222,3429,10,27,132,169,1.2781065088757397,0.043582603143953354,652,"And of course, my cheat day isn't until tomorrow."
9187,3430,10,20,114,144,1.2777777777777777,0.04872544551705718,652,"It'll be fine, you said. Good Ship Lollipop is just a name, you said."
8704,3430,6,28,110,144,1.2777777777777777,0.04456084214122663,652,Plastic.
8386,3430,11,23,128,162,1.2777777777777777,0.045711745577767894,652,"No, you go ahead. I'm cutting down on sugar."
7889,3430,14,17,131,162,1.2777777777777777,0.048162302603500594,652,It’s strictly for twelve and under - Michael Jackson built it
7638,3430,9,22,113,144,1.2777777777777777,0.047718381612441664,652,It’s best to save your extra points for the weekends.
7563,3430,6,23,97,126,1.2777777777777777,0.04865021103252996,652,I wished for a desserted island!
7365,3430,9,22,113,144,1.2777777777777777,0.047718381612441664,652,Its called Mar a Lago.
7057,3430,7,26,111,144,1.2777777777777777,0.04563763523080941,652,"Sorry Bob, I can't. I'm doing keto right now."
6647,3430,10,20,114,144,1.2777777777777777,0.04872544551705718,652,"See, I TOLD you spelling matters!"
6288,3430,9,17,100,126,1.2777777777777777,0.05241941829572397,652,"And an extra ""s"" has made all the difference."
5753,3430,12,21,129,162,1.2777777777777777,0.046542936304750995,652,"They’re not spelled the same, either—it’s a ""dessert"" island."
5537,3430,10,20,114,144,1.2777777777777777,0.04872544551705718,652,"Look, it's typo island.  Yum!"
5278,3430,7,26,111,144,1.2777777777777777,0.04563763523080941,652,The difference one tiny 's' makes!
4406,3430,8,24,112,144,1.2777777777777777,0.04668960105404107,652,I guess that's a dessert island.
4267,3430,6,23,97,126,1.2777777777777777,0.04865021103252996,652,"I'd swim for it, but there's a bunch of lemon sharks around there."
3866,3430,3,34,107,144,1.2777777777777777,0.04116179491907547,652,"Without floss and a toothbrush it is sheer madness, I tell you."
3351,3430,4,32,108,144,1.2777777777777777,0.0423251516014429,652,I sure picked the wrong day to start my diet
2963,3430,5,30,109,144,1.2777777777777777,0.043457376303801656,652,Don’t give up. Looks like the Good Ship Lollipop made a stop recently.
2915,3430,5,25,96,126,1.2777777777777777,0.04732714766944626,652,"All desert islands are the same he said, we’ll save 50 bucks he said..."
2151,3430,5,30,109,144,1.2777777777777777,0.043457376303801656,652,That's my fantasy.  What's yours?
1388,3430,6,23,97,126,1.2777777777777777,0.04865021103252996,652,they'll just make you thirsty
1203,3430,8,24,112,144,1.2777777777777777,0.04668960105404107,652,It’s the Island of Empty Calories.
1116,3430,5,30,109,144,1.2777777777777777,0.043457376303801656,652,"I realize we are dreaming, but still the sharks in that water
don't know that."
1084,3430,7,26,111,144,1.2777777777777777,0.04563763523080941,652,We should have upgraded to premium!
828,3430,7,26,111,144,1.2777777777777777,0.04563763523080941,652,That's the iceberg that sank the 'Good Ship Lollipop.'
822,3430,6,18,84,108,1.2777777777777777,0.053975452629488975,652,"No, I’m staying here. I gave up sweets for Lent."
5064,3430,10,25,127,162,1.2777777777777777,0.044865158504847125,652,I forgot my insulin.
8351,3457,7,29,119,155,1.2774193548387096,0.043453246784730684,652,We thought we were on a deserted island
6103,3457,11,21,123,155,1.2774193548387096,0.0471522361970268,652,"They had a war, and the paleo tribe lost."
1357,3457,9,25,121,155,1.2774193548387096,0.045340478793870896,652,I wonder if that dessert desert island is deserted?
7964,3457,4,35,116,155,1.2774193548387096,0.040457670650330145,652,I’m fine. I ate before we left.”
923,3457,9,25,121,155,1.2774193548387096,0.045340478793870896,652,"Sure, I've heard of an anglerfish.  Why?"
263,3457,6,31,118,155,1.2774193548387096,0.042478200003923584,652,Haven't you ever seen a dessert island?
186,3457,8,27,120,155,1.2774193548387096,0.04440688951836282,652,You really outta proofread when you write your wishes.
1004,3457,8,27,120,155,1.2774193548387096,0.04440688951836282,652,Look at the good part—at least we eat healthier on this side!
3206,3465,12,14,111,137,1.2773722627737227,0.05255384999954335,652,And I bet they have free WiFi as well !
3899,3465,9,20,108,137,1.2773722627737227,0.049395146815321624,652,You really think it's Mar-a-lago?
3987,3465,10,18,109,137,1.2773722627737227,0.0504700181876622,652,You have to remember the Castaway Mirage only lasts for 15 minutes; then you crash.
6374,3465,6,26,105,137,1.2773722627737227,0.04602014676247625,652,"Well, there goes the neighborhood. Is that my tacky mirage or yours?"
7214,3465,8,22,107,137,1.2773722627737227,0.048296359303278774,652,"I could have sworn it was two ""s""s."
8553,3470,5,23,91,119,1.2773109243697478,0.04909720460822299,652,I think I'm mirage intolerant
8076,3471,10,26,130,166,1.2771084337349397,0.044093652219486655,652,"I’m going to try this one more time. It’s not a deserted island, it’s a DESSERTED island. Nobody gets me!"
5107,3471,12,22,132,166,1.2771084337349397,0.04571967701448259,652,Dude...Sweet
661,3473,10,21,117,148,1.277027027027027,0.04776773371296766,652,Sure I am starving but I am not a big dessert fan.
3140,3473,7,27,114,148,1.277027027027027,0.044788060842162865,652,"Meanwhile, in hell for people who can't swim"
6574,3473,10,21,117,148,1.277027027027027,0.04776773371296766,652,Too bad it's not chicken wings and beer.
6977,3473,8,25,115,148,1.277027027027027,0.045802828049788774,652,All I see is a food desert
7081,3473,9,23,116,148,1.277027027027027,0.046795595099493624,652,"If it's big enough to eat them, it's big enough to eat us."
8473,3478,9,18,103,130,1.2769230769230768,0.051240293075978584,652,"No, it' not a mirage.  It's actually part of the great gyre of discarded candies and sweets that ceaselessly rotate about the ocean."
3264,3479,12,25,140,177,1.2768361581920904,0.043679561481140786,652,I ‘m afraid our dessert island was misspelled.
3478,3479,8,33,136,177,1.2768361581920904,0.04063371444544116,652,"It’ll still be there later, when I really need it. I mean when WE need it."
8599,3481,5,34,120,159,1.2767295597484276,0.0408023479306168,652,I'll pass. I don't see any carrot cake.
3948,3481,8,28,123,159,1.2767295597484276,0.04363102204110205,652,I can’t believe we finished dinnered island. Do you have any room left for desserted island?
3083,3481,7,30,122,159,1.2767295597484276,0.0427089520879537,652,But we would lose the benefit of all the weight we have lost while here
698,3481,11,22,126,159,1.2767295597484276,0.046287153423505714,652,"It seems to be a ""Dessert-ed"" Island."
9974,3485,10,19,112,141,1.2765957446808511,0.049420535807965946,652,Once again I find myself in the nightmare I've been having ever since I started the South Beach Diet.
9403,3485,10,19,112,141,1.2765957446808511,0.049420535807965946,652,Five bucks says it's the Good Ship Lollipop.
7266,3485,5,29,107,141,1.2765957446808511,0.04399776979095477,652,"You're never gonna believe this, but when my sister Gretel and I were kids..."
6592,3485,5,29,107,141,1.2765957446808511,0.04399776979095477,652,"It's up to you but remember: a moment of pleasure, a lifetime of regret."
6365,3485,7,25,109,141,1.2765957446808511,0.046243248066774996,652,"Actually, I'm more of a salty person."
9345,3485,7,25,109,141,1.2765957446808511,0.046243248066774996,652,That's what happens in a world without literacy.
4529,3485,6,27,108,141,1.2765957446808511,0.045134475394886006,652,Aren't you glad we left? There's no dentist for miles.
2531,3485,9,21,111,141,1.2765957446808511,0.048384628105966936,652,It’s a mirage but it cheers me up.
738,3485,8,23,110,141,1.2765957446808511,0.047326051117318114,652,Unfortunately I didn't leave room for dessert.
702,3485,10,19,112,141,1.2765957446808511,0.049420535807965946,652,That stuff will kill you.
5642,3485,8,23,110,141,1.2765957446808511,0.047326051117318114,652,I prefer chutes and ladders
2241,3496,8,31,131,170,1.276470588235294,0.041719849626640736,652,Want another hit of LSD?
4143,3496,7,33,130,170,1.276470588235294,0.04087703766902926,652,"Yes Lonnie, mirages can happen on water . ."
6227,3496,8,31,131,170,1.276470588235294,0.041719849626640736,652,I'm betting the Good Ship Lollipop is just over the horizon.
5809,3499,9,24,119,152,1.2763157894736843,0.04591861693702519,652,OK. I give up. Where's the rest of the donut?
9927,3499,4,34,114,152,1.2763157894736843,0.04090021396894979,652,Looks sweet!
8396,3499,9,24,119,152,1.2763157894736843,0.04591861693702519,652,"Actually, this is South Beach."
5060,3499,8,26,118,152,1.2763157894736843,0.04495977096993022,652,"I know the grass always looks greener, but that Island looks really sweet."
4668,3499,9,24,119,152,1.2763157894736843,0.04591861693702519,652,I've been there. It's just a mirage.
3824,3499,4,34,114,152,1.2763157894736843,0.04090021396894979,652,"We don’t have a dental plan, either."
2607,3499,12,18,122,152,1.2763157894736843,0.04868197313822936,652,Where's the 'Good Ship Lollipop' when you need it?
43,3499,5,32,115,152,1.2763157894736843,0.041951947254526244,652,"I don't care if it's a trap, I want that big cupcake."
4821,3499,5,32,115,152,1.2763157894736843,0.041951947254526244,652,"When they said Food Network was going under, I wasn't exactly expecting THIS."
5358,3508,7,23,104,134,1.2761194029850746,0.04783705819755782,652,All we need is the good ship Lollipop.
1056,3508,5,27,102,134,1.2761194029850746,0.045430633230546524,652,Think what it would do to your blood sugar.
2613,3508,7,23,104,134,1.2761194029850746,0.04783705819755782,652,You did say you wanted to go on a sweet island vacation
3159,3508,5,27,102,134,1.2761194029850746,0.045430633230546524,652,"..yeah, I hear you man...but what about the witch?"
3556,3508,5,27,102,134,1.2761194029850746,0.045430633230546524,652,How much do you want to bet that it's just a mirage?
5441,3508,7,23,104,134,1.2761194029850746,0.04783705819755782,652,It's better than a cleanse.
5974,3508,6,25,103,134,1.2761194029850746,0.04664936533718852,652,The treats are organic but the water is contaminated. I'd say it's a wash.
7706,3508,7,23,104,134,1.2761194029850746,0.04783705819755782,652,Forget it. It's probably a Venus fly island.
1642,3516,7,31,125,163,1.2760736196319018,0.04199842345125934,652,Kind of a bad month to go Paleo.
4465,3516,7,31,125,163,1.2760736196319018,0.04199842345125934,652,"‘’Can’t we jus skip the fish, just for one night?”"
5598,3516,8,29,126,163,1.2760736196319018,0.04289065089772153,652,"Helluva mirage, eh?"
9894,3516,9,27,127,163,1.2760736196319018,0.04376469234976011,652,Let’s try Coconut Island you said. Candy Island is too crowded you said.
8886,3520,9,22,114,145,1.2758620689655173,0.04742685295581093,652,At least we're not stuck on that dessert island.
6985,3520,7,26,112,145,1.2758620689655173,0.04536226956476118,652,It wouldn't be so bad if the sea wasn't made of chocolate syrup.
7688,3520,8,24,113,145,1.2758620689655173,0.046406044225715745,652,All sugar and carbs? And your point is ...?
3348,3520,9,22,114,145,1.2758620689655173,0.04742685295581093,652,"I'm pretty sure it's real, because I hate candy canes."
4542,3520,6,28,111,145,1.2758620689655173,0.04429390544367285,652,Sweet island dude!
2697,3520,6,28,111,145,1.2758620689655173,0.04429390544367285,652,Even worse luck. You don't do gluten and  I have diabetes.
183,3526,8,19,100,127,1.2755905511811023,0.05083623342619631,652,I gave up sweets for Lent.
7656,3526,7,21,99,127,1.2755905511811023,0.049591715558244584,652,It may look inviting but my mother said I should never swim after eating.
2189,3528,8,30,129,167,1.2754491017964071,0.04218328320109104,652,"Gretel, do you think that kindly old woman on that other island is willing to share?"
3850,3528,8,30,129,167,1.2754491017964071,0.04218328320109104,652,Legend has it that's about where the good ship Lollipop went down.
8095,3528,10,26,131,167,1.2754491017964071,0.043860222473317334,652,Do you really think those sharks put that much time and effort into such an elaborate decoy?
7387,3531,7,24,107,138,1.2753623188405796,0.046872025458178125,652,I expect a massive sugar high at low tide.
6562,3531,8,22,108,138,1.2753623188405796,0.047987220104410026,652,I’ve stopped going there ever since I heard they substituted sugar for high fructose corn syrup”
6177,3531,7,24,107,138,1.2753623188405796,0.046872025458178125,652,We could float on the pastries and row with the candy canes
1509,3531,6,26,106,138,1.2753623188405796,0.04572964298740044,652,I picked a bad time to give up sugar.
420,3535,7,27,115,149,1.2751677852348993,0.044525289408853794,652,But what if it's NOT heatstroke?
1081,3535,8,25,116,149,1.2751677852348993,0.04553236341888473,652,And YOU said not to bring my swim trunks.
3073,3535,11,19,119,149,1.2751677852348993,0.048428093945673795,652,Moby had one last trick up his sleeve.
4473,3535,6,29,114,149,1.2751677852348993,0.04349490401616014,652,"I'm not saying it was a bad pun, just easy."
5123,3535,8,25,116,149,1.2751677852348993,0.04553236341888473,652,"For the hundredth time, we are NOT swimming over there, Hansel"
9117,3540,7,30,123,160,1.275,0.04247640854661405,652,Is it a figment of your imagination if we both see the same thing?
8380,3540,9,26,125,160,1.275,0.04428857626320113,652,Do you think we could learn to swim?
9371,3540,1,31,88,120,1.275,0.04260840516231734,652,If the sharks don't kill you the sugar will.
2160,3540,6,32,122,160,1.275,0.04154069006188522,652,"You just had to fire our only flare at the Good Ship ""Lollipop""..."
1626,3540,8,28,124,160,1.275,0.04339195357690323,652,Guess who gets rescued first.
8067,3540,10,13,97,120,1.275,0.055461521725939544,652,You shouldn’t have thrown the lamp after your first wish didn’t appear quick enough.
7690,3546,8,31,132,171,1.2748538011695907,0.04150665719915627,652,That has to be a “dessert-ed” island
9855,3546,8,31,132,171,1.2748538011695907,0.04150665719915627,652,I’m stuffed unless you want to split the cheesecake.
2113,3548,5,26,100,131,1.2748091603053435,0.04604554297149816,652,It may look enticing now but it's just not sustainable in the long run.
2204,3548,9,18,104,131,1.2748091603053435,0.05089156389742101,652,That sure is a deserted island.
2218,3548,8,20,103,131,1.2748091603053435,0.04972435483572397,652,"Yeah, but then what are our chances of ever getting a dental appointment?"
4895,3548,6,24,101,131,1.2748091603053435,0.047303613388792874,652,"If  it’s real, my low carb diet is over."
6956,3548,8,20,103,131,1.2748091603053435,0.04972435483572397,652,"You gotta admit, that whale carcass is looking *pretty* good right now..."
7231,3548,3,30,98,131,1.2748091603053435,0.04342018428504746,652,"I don’t know, Rob, it just looks too sweet."
9802,3548,6,24,101,131,1.2748091603053435,0.047303613388792874,652,It's just a troptical illusion.
8882,3555,1,37,104,142,1.2746478873239437,0.0388943770986428,652,"Call me paranoid, but that seems a little too attractive."
4326,3555,8,23,111,142,1.2746478873239437,0.04703194038056216,652,Do you think they have ICEs at the border?
4044,3555,9,21,112,142,1.2746478873239437,0.04808215403689606,652,"The thing is if we ate that, we'd die anyway!"
270,3555,6,27,109,142,1.2746478873239437,0.044857810626764444,652,"Sharks or gluten, tough call."
3046,3555,5,29,108,142,1.2746478873239437,0.04373023042884195,652,"Like...hey, man....imagine 'Gilligan's Island' meets the 'Food Network,' you know what I mean?"
3486,3555,10,19,113,142,1.2746478873239437,0.04910991404690957,652,"Yeah, I know. Desserted Island. Hilarious."
8520,3561,6,30,117,153,1.2745098039215685,0.04273430336804582,652,Are you saying I picked the wrong island?
9196,3561,7,28,118,153,1.2745098039215685,0.04372893774558989,652,There’s no way to get rescued on a desserted island.
9090,3561,8,26,119,153,1.2745098039215685,0.04470144637887213,652,Wouldn't it be sweet...
9458,3561,8,26,119,153,1.2745098039215685,0.04470144637887213,652,I wish we had a board game.
9020,3561,7,28,118,153,1.2745098039215685,0.04372893774558989,652,You choose. Die of hunger or die of diabetes?
9002,3561,9,24,120,153,1.2745098039215685,0.045653243262321286,652,Looks like Christmas on Easter Island.
7291,3561,13,16,124,153,1.2745098039215685,0.04927693038725829,652,I told you to book the dessert island!
1952,3561,3,36,114,153,1.2745098039215685,0.03960079226904003,652,I picked the wrong week to start my diet.
5042,3561,8,26,119,153,1.2745098039215685,0.04470144637887213,652,"If one of us swims over, it will no longer be desserted"
4683,3561,9,24,120,153,1.2745098039215685,0.045653243262321286,652,"Forget the currents and the  sharks, that much sugar will  kill ya!"
4631,3561,10,22,121,153,1.2745098039215685,0.04658559790723082,652,It's a trap.  The last guy sank trying to swim back.
1593,3561,8,26,119,153,1.2745098039215685,0.04470144637887213,652,It received 5 stars in Fodor's Stranded Island Ports of Call.
72,3561,7,28,118,153,1.2745098039215685,0.04372893774558989,652,I'd rather be on a desserted island.
5983,3561,5,32,116,153,1.2745098039215685,0.04171596064274043,652,"As a dentist, I consider ourselves the lucky ones."
8887,3575,10,25,129,164,1.274390243902439,0.044380635905183125,652,I wonder why the sharks put all their goodies on that island?
9095,3575,11,23,130,164,1.274390243902439,0.04521567806011169,652,This is worse than the Fyre Festival.
8425,3577,9,30,136,175,1.2742857142857142,0.0416547250070347,652,You go. I am in the middle of  a colon cleanse.
9661,3578,7,20,97,124,1.2741935483870968,0.05035763739529594,652,I've always hated Candyland.
59,3579,6,25,104,135,1.2740740740740741,0.046347677402674696,652,And all we have are mushrooms...
3752,3579,9,19,107,135,1.2740740740740741,0.04979741116928703,652,Without my glasses that hallucination looks like a big bunny.
6352,3579,6,25,104,135,1.2740740740740741,0.046347677402674696,652,But it will spoil your appetite.
6606,3579,5,27,103,135,1.2740740740740741,0.04513921666476789,652,It makes me wish that I had learned to swim. And that  I  didn't have diabetes.
7776,3579,8,21,106,135,1.2740740740740741,0.04867467349299314,652,Darn. Looks like we should have spell checked our Airbnb search.
9741,3579,5,27,103,135,1.2740740740740741,0.04513921666476789,652,That you think 'Airbnb should have spellcheck' is precisely how we got here.
5634,3585,8,24,114,146,1.273972602739726,0.04612581420895325,652,It was put there by the sharks.
8098,3585,10,20,116,146,1.273972602739726,0.048130420307929946,652,"Mark, I think it’s fair to admit we should have splurged for the “All-Inclusive.”"
5464,3585,6,28,112,146,1.273972602739726,0.04403003649623462,652,"Trust me, the grass will be no greener there"
2145,3585,8,24,114,146,1.273972602739726,0.04612581420895325,652,"Coconuts are high in saturated fats too, you know."
2858,3585,4,32,110,146,1.273972602739726,0.041829385499677504,652,"Considering what I've been reading about coconut oil, I'd say that IS the healthier choice."
555,3585,7,26,113,146,1.273972602739726,0.04509010340583965,652,It boils down to shade vs calories
4149,3585,10,20,116,146,1.273972602739726,0.048130420307929946,652,Time for dessert island!
3258,3592,5,33,119,157,1.2738853503184713,0.04102582306830125,652,"I know we're starving, but I really prefer salty to sweet."
4475,3592,9,25,123,157,1.2738853503184713,0.04483029586946742,652,"I'm telling you, I've been over there. It's all gluten-free."
4783,3592,8,27,122,157,1.2738853503184713,0.04391009121393259,652,"I don't know how to explain it, my body just feels better when I cut out sugar."
5413,3592,7,29,121,157,1.2738853503184713,0.042970184931970835,652,"Boy, I know an illusion when I see one!"
6856,3592,8,27,122,157,1.2738853503184713,0.04391009121393259,652,The sharks are nothing compared to the toothache.
35,3597,7,32,129,168,1.2738095238095237,0.04110532708852036,652,We'll only go on cheat day.
6831,3598,6,23,99,128,1.2734375,0.047984531102717234,652,Whaddaya wanna bet they're not gluten-free?
7570,3598,6,23,99,128,1.2734375,0.047984531102717234,652,No way!  I'd have to be on the treadmill for a week!
8280,3598,5,25,98,128,1.2734375,0.046684941138279756,652,"Wait,you gave the genie your wish in writing? You must have forgotten the second ""s."""
6368,3601,9,20,110,139,1.2733812949640289,0.04876298529440736,652,You go ahead...I'm vegan.
8140,3601,6,26,107,139,1.2733812949640289,0.04544266157650377,652,"Yes,that used to be Big Rock Candy Mountain,but now it's just Pleasure Island due to global warming!"
8198,3601,8,22,109,139,1.2733812949640289,0.04768190768276031,652,Are we out of floss?
6321,3601,6,26,107,139,1.2733812949640289,0.04544266157650377,652,The strawberry was a mistake - it was too much.
2322,3601,4,30,105,139,1.2733812949640289,0.043087198354569624,652,"Burl, could this be the ""Big Rock Candy Mountain ? "" "" Go back to sleep ,Woody."
4616,3601,8,22,109,139,1.2733812949640289,0.04768190768276031,652,"Empty calories, eh?"
2861,3601,10,18,111,139,1.2733812949640289,0.04982060968492759,652,This South Beach Diet isn't getting any easier.
527,3601,9,20,110,139,1.2733812949640289,0.04876298529440736,652,Just write the Genie back and ask for world piece.
5972,3601,5,28,106,139,1.2733812949640289,0.04428059480857658,652,"Ours is more of a paleo island, though"
5,3610,10,21,119,150,1.2733333333333334,0.04720052578733677,652,"Sure makes your eyes glaze over, doesn't it?"
210,3610,7,27,116,150,1.2733333333333334,0.04426548608975301,652,I think we should complain to the zoning commission
687,3610,7,27,116,150,1.2733333333333334,0.04426548608975301,652,I think psychologists have gone too far with the marshmallow test replications.
3304,3610,9,23,118,150,1.2733333333333334,0.04624288243598217,652,That reminds me; I'm going to miss my dentist appointment.
4953,3610,11,19,120,150,1.2733333333333334,0.04813912227299142,652,"To think, we could have been on a deserted""island."
4987,3610,6,29,115,150,1.2733333333333334,0.04324289305942818,652,I can’t - I’m training for a marathon.
7822,3610,9,23,118,150,1.2733333333333334,0.04624288243598217,652,I decided to throw it out because it didn't spark joy.
8917,3610,9,23,118,150,1.2733333333333334,0.04624288243598217,652,"I can't remember if it's two ""S""s or one."
8537,3618,8,28,125,161,1.2732919254658386,0.043155411807833464,652,"I don’t know, I heard moving is one of the more stressful life events."
8391,3618,11,22,128,161,1.2732919254658386,0.045774543394359234,652,"Ted... I think you’re losing it, man."
2918,3618,8,28,125,161,1.2732919254658386,0.043155411807833464,652,That's just a dessert ile.
5968,3618,12,20,129,161,1.2732919254658386,0.046614896487226824,652,The addition of the sharks has meant that this is the best diet I’ve ever been on.
1969,3618,7,30,124,161,1.2732919254658386,0.042246299444459,652,I am NOT giving up my summer body.
357,3618,11,22,128,161,1.2732919254658386,0.045774543394359234,652,Good thing I'm on the small beach diet.
2200,3618,10,24,127,161,1.2732919254658386,0.04491847138326595,652,"Next time we use the teleportation device, let's check our spelling."
5373,3625,7,19,95,121,1.2727272727272727,0.051157403079194336,652,"Well if God’s so perfect, why aren’t all islands dessert-ed?"
5435,3625,9,27,129,165,1.2727272727272727,0.04329690580175037,652,I hear its all saccharine.
5746,3625,6,24,102,132,1.2727272727272727,0.04699002641840444,652,"Well, you say mirage, I say meringue”."
6042,3625,3,30,99,132,1.2727272727272727,0.04314025173536369,652,I'm staying away from carbs.
6256,3625,7,25,111,143,1.2727272727272727,0.04567561723105038,652,"I'm starving, but I'd rather not risk a cavity."
6923,3625,8,20,104,132,1.2727272727272727,0.04939011464665993,652,This was the worst time to go Paleo.
7840,3625,8,20,104,132,1.2727272727272727,0.04939011464665993,652,"Tom, you have made your point. Spelling is a cornerstone of civilisation..."
8811,3625,3,33,107,143,1.2727272727272727,0.041137449902482845,652,Someday we’ll laugh about this.
9168,3625,8,23,112,143,1.2727272727272727,0.04674136354105388,652,I have to admit the sharks are getting more and more clever at disguising themselves.
9296,3625,7,25,111,143,1.2727272727272727,0.04567561723105038,652,Some retirement planner you are!
9565,3625,7,22,103,132,1.2727272727272727,0.04820501015253788,652,"Well, it's down to you and me on, ""Survivor: Paleo""."
9937,3625,7,22,103,132,1.2727272727272727,0.04820501015253788,652,Remind me why we came over here.
7035,3625,5,32,117,154,1.2727272727272727,0.04148250850951955,652,"Yes, most of the inhabitants arrived there on the Good Ship Lollipop."
4771,3625,6,27,110,143,1.2727272727272727,0.04458440257755946,652,It’s our just deserts that this one’s just desert and that one’s just desserts.
6443,3625,7,25,111,143,1.2727272727272727,0.04567561723105038,652,Wait till she gets out of the pool then we can just walk there.
4279,3625,6,27,110,143,1.2727272727272727,0.04458440257755946,652,I had to move from there.  Dentist bills were killing me.
265,3625,5,32,117,154,1.2727272727272727,0.04148250850951955,652,"That won't work, I'm doing paleo."
1331,3625,4,25,92,121,1.2727272727272727,0.04694525268130202,652,All for the best. My dentist said to stay away from sweets.
4686,3625,8,26,120,154,1.2727272727272727,0.044445987734701146,652,"You go ahead, I'm cutting back on sweets."
1995,3625,7,22,103,132,1.2727272727272727,0.04820501015253788,652,You never heard of Shark Bait Island?
2277,3625,6,27,110,143,1.2727272727272727,0.04458440257755946,652,I dare you to eat that entire island.
2571,3625,6,30,118,154,1.2727272727272727,0.04249330476752751,652,"I swear the message in my bottle said, ""A raft would come in HANDY."""
1919,3625,10,16,106,132,1.2727272727272727,0.05167885705796982,652,"Yeah, the mescalin often has that effect on you."
2875,3625,6,27,110,143,1.2727272727272727,0.04458440257755946,652,"But you've gotta admit, we look great."
2959,3625,7,28,119,154,1.2727272727272727,0.04348060933208722,652,This is very thoughtful but I was hoping for some protein.
3050,3625,4,34,116,154,1.2727272727272727,0.040446459355779806,652,"I really, really hate sharks."
3301,3625,8,20,104,132,1.2727272727272727,0.04939011464665993,652,"Sure, you had to sail on 'The Good Ship Lollipop!'"
3507,3625,10,16,106,132,1.2727272727272727,0.05167885705796982,652,"Nah, not worth it. A palm tree in hand is worth two donuts in the sand and I only see one donut over there."
2654,3625,6,27,110,143,1.2727272727272727,0.04458440257755946,652,My Doctor said I should watch my sugar
1105,3654,7,29,122,158,1.2721518987341771,0.04273252894281875,652,"Ignore it, it's just a cartoonist's meme."
3693,3654,9,25,124,158,1.2721518987341771,0.044579371238452174,652,Don't go.  Too many ants!
4171,3654,8,27,123,158,1.2721518987341771,0.04366571521150535,652,This year's Fyre Festival looks a lot more interesting
6769,3654,7,29,122,158,1.2721518987341771,0.04273252894281875,652,They call it “Candy Land.”
9699,3658,10,20,117,147,1.272108843537415,0.04783820065902891,652,I heard cavity searches are mandatory for visitors
6364,3658,4,32,111,147,1.272108843537415,0.04158564273400371,652,Now you know why I told you to spell “desert” with two esses!
6301,3658,6,28,113,147,1.272108843537415,0.04376918552853482,652,Our island looked so much better in the brochure
5485,3658,8,24,115,147,1.272108843537415,0.0458488551881332,652,Bet you wish we hadn't eaten the good ship Lollipop now.
5477,3658,4,32,111,147,1.272108843537415,0.04158564273400371,652,"I know it's tempting, but I've already lost five pounds on the keto diet."
4732,3658,4,32,111,147,1.272108843537415,0.04158564273400371,652,It must be a mirage. There's no way that pie is only 90 calories.
1863,3658,9,22,116,147,1.272108843537415,0.04685408714485814,652,"No, unfortunately, that's just where Route 66 attractions go to die."
2133,3658,7,26,114,147,1.272108843537415,0.044821083899732446,652,You have to jump the shark to get there
1526,3658,8,24,115,147,1.272108843537415,0.0458488551881332,652,"See? Once you stop eating sugar, you no longer care."
910,3658,6,28,113,147,1.272108843537415,0.04376918552853482,652,Seriously?
646,3658,6,28,113,147,1.272108843537415,0.04376918552853482,652,"Is ours spelled with one 's', or two?"""
598,3658,7,26,114,147,1.272108843537415,0.044821083899732446,652,"Tough break, with the gluten sensitivity and all."
3211,3658,5,30,112,147,1.272108843537415,0.042691376666907206,652,The sand is always sweeter on the other isle.
9381,3671,6,25,105,136,1.2720588235294117,0.046049740755039065,652,They have a serious ant situation over there.
8992,3671,4,29,103,136,1.2720588235294117,0.04362010660072977,652,"I mean, I have high blood sugar anyway."
9777,3671,6,25,105,136,1.2720588235294117,0.046049740755039065,652,Do you hear the music too?
6168,3671,7,23,106,136,1.2720588235294117,0.04721769885837242,652,"Well, they just didn't spark joy."
8447,3671,8,21,107,136,1.2720588235294117,0.04835745596444856,652,If only we were stranded on the dessert island.
997,3676,3,28,94,125,1.272,0.04454211490264018,652,I've heard the sharks in these waters are very clever at disguise.
1640,3676,7,20,98,125,1.272,0.050001290305931756,652,What I wouldn’t give for a chute or ladder!
6556,3676,8,18,99,125,1.272,0.05127534778353611,652,"Yes, those are the remains of the Good Ship Lollipop."
7800,3676,3,28,94,125,1.272,0.04454211490264018,652,I think the Good Ship Lollipop got stranded too.
8343,3676,6,22,97,125,1.272,0.04869390900506499,652,The grass is greener here.
8957,3681,6,32,124,162,1.271604938271605,0.0410959919954237,652,"Why yes, I did play Candyland when I was a child. Why do you ask?"
6765,3682,8,25,118,151,1.271523178807947,0.04500063755686408,652,"No, really, treats in the ocean will serve us far better than pie in the sky."
9765,3682,6,29,116,151,1.271523178807947,0.04299368487374794,652,"No way, Bob, its definitely hamburgers, biscuits, and two large antennas”"
9931,3682,9,23,119,151,1.271523178807947,0.04597126930241102,652,"Dang, now I wish I'd taken swim lessons."
4784,3682,7,27,117,151,1.271523178807947,0.04400860324724808,652,Spelling was never my strong suit.
3077,3682,3,35,113,151,1.271523178807947,0.03979392261101545,652,Lucky for us. Refined sugar is a killer.
3821,3682,5,31,115,151,1.271523178807947,0.04195422169785289,652,I’m rethinking my low carb diet.
2800,3682,8,25,118,151,1.271523178807947,0.04500063755686408,652,good call on writing candyland in the bottle message
4437,3682,8,25,118,151,1.271523178807947,0.04500063755686408,652,Survivor Candyland...piece of cake!
2335,3690,6,26,108,140,1.2714285714285714,0.04515914207938474,652,Care to join me? I've always wanted to visit a desserted island.
2662,3690,5,28,107,140,1.2714285714285714,0.04400651304553963,652,"The ""Desert Island Diet"" is harder than I thought it would be."
3891,3690,4,30,106,140,1.2714285714285714,0.042822870846178,652,A spoonful of sugar helps the loneliness go down.
7145,3690,9,20,111,140,1.2714285714285714,0.048452790240629914,652,"Man, that place looks sweet!"
7698,3690,6,26,108,140,1.2714285714285714,0.04515914207938474,652,Go ahead. But don’t say I didn’t warn you about empty calories
9491,3690,6,26,108,140,1.2714285714285714,0.04515914207938474,652,"Let's not get too friendly with the new neighbors. First of all, their landscaping is atrocious and if we invite them over for coffee, the next thing you know they' ll be borrowing tools and just dropping in without calling first."
577,3696,6,23,100,129,1.2713178294573644,0.047658265997511384,652,"interesting,a deserted dessert island"
4853,3696,8,19,102,129,1.2713178294573644,0.0501354004661881,652,If only we had the good ship lollipop to get there.
9805,3696,6,23,100,129,1.2713178294573644,0.047658265997511384,652,It's bait. Sharks are casting for us.
755,3699,8,29,129,166,1.2710843373493976,0.04221037941879041,652,"Nah, it's not worth it. If the sharks don't get you, the diabetes will."
7825,3699,12,21,133,166,1.2710843373493976,0.045538923254611334,652,Don't be fooled; it's the Trojan submarine wanting to invade our island.
9440,3701,8,26,121,155,1.270967741935484,0.044193349621440434,652,"I may be sunburned, but those guys are really baked."
5044,3701,7,28,120,155,1.270967741935484,0.043234997053330476,652,I still prefer it here on the Island of Vegan Treats.
9149,3701,7,28,120,155,1.270967741935484,0.043234997053330476,652,"You go on ahead, I'm gonna wait for the one with health insurance."
1106,3701,7,28,120,155,1.270967741935484,0.043234997053330476,652,What are you talking about sweetie? All I see are palm trees.
1449,3701,5,32,118,155,1.270967741935484,0.04125155280809132,652,"Sure, but then you'll want to brush your teeth."
9743,3706,7,25,112,144,1.2708333333333333,0.045396840800028745,652,Guess it wasn't such a great idea making the hull out of sugar too
9662,3706,6,27,111,144,1.2708333333333333,0.04431419701966919,652,I’m watching my weight but you go ahead.
8248,3706,11,17,116,144,1.2708333333333333,0.04949114610840552,652,"Three years and we haven't even caught, much less eaten, a single kid. I'm beginning to think that witch didn't know what she was talking about"
7024,3706,8,23,113,144,1.2708333333333333,0.04645425978043619,652,This sugar-free diet is really killing me.
6586,3706,4,31,109,144,1.2708333333333333,0.04206539983463682,652,"I’m watching my carbs, but you go ahead."
6581,3706,7,25,112,144,1.2708333333333333,0.045396840800028745,652,This is what a low carb diet does to mirages.
6149,3706,8,23,113,144,1.2708333333333333,0.04645425978043619,652,"Next time first we play CandyLand, then Battleship"
4424,3706,10,19,115,144,1.2708333333333333,0.048499983979362775,652,Now that's my idea of a deserted island!
3642,3706,8,23,113,144,1.2708333333333333,0.04645425978043619,652,That's what's left of the Good Ship Lollipop
3422,3706,8,23,113,144,1.2708333333333333,0.04645425978043619,652,"I'd join you, but I want to look thin for my rescuer."
2483,3706,6,27,111,144,1.2708333333333333,0.04431419701966919,652,I'm not sure how they do it- the icing never melts!!
675,3706,7,25,112,144,1.2708333333333333,0.045396840800028745,652,Remember… a lifetime on the hips.
5496,3706,8,23,113,144,1.2708333333333333,0.04645425978043619,652,That used to be the summit of the big rock candy mountain.
9467,3719,6,24,103,133,1.2706766917293233,0.046680440407283315,652,Meh. I prefer savory.
8212,3719,10,16,107,133,1.2706766917293233,0.051329798195871676,652,It was the “Jaws Breakers” sign that stopped me from swimming over.
2567,3719,10,16,107,133,1.2706766917293233,0.051329798195871676,652,Looks like we are getting rescued by the good ship lollipop
7603,3719,6,24,103,133,1.2706766917293233,0.046680440407283315,652,I could sure use a quick burst of energy.
1245,3719,5,26,102,133,1.2706766917293233,0.04544383731668337,652,I heard the sharks are looking for a younger diet.
2119,3719,5,26,102,133,1.2706766917293233,0.04544383731668337,652,We need Chutes and Ladders to get there.
361,3719,8,20,105,133,1.2706766917293233,0.04906022675980432,652,"Ted, there could be a jelly doughnut on the other side"
4435,3726,6,21,95,122,1.2704918032786885,0.04943370578426822,652,"Yes, I get it; two esses. Very funny."
5911,3727,8,27,124,159,1.270440251572327,0.04342396619375543,652,"You say deserted, I say desserted. What’s the dif?"
7491,3728,6,28,114,148,1.2702702702702702,0.04351130374357006,652,"Has anyone escaped this godforsaken island?"" ""Yeah it was a piece of cake!"
9764,3728,7,26,115,148,1.2702702702702702,0.04455515926155409,652,That witch from Hansel and Gretel...she’s offering “thrilling” getaways on her private island.
6482,3728,5,30,113,148,1.2702702702702702,0.042441782362525486,652,I swear it's closer!
7324,3728,9,22,117,148,1.2702702702702702,0.04657273390662092,652,Maybe I should have voted 'remain'
5668,3728,5,30,113,148,1.2702702702702702,0.042441782362525486,652,"Remember, carbs are your worst enemy."
1170,3728,6,28,114,148,1.2702702702702702,0.04351130374357006,652,"If we swim over there, we’ll have to wait half an hour before eating anything."
6004,3728,9,22,117,148,1.2702702702702702,0.04657273390662092,652,I finally understand what it is to be desserted.
1492,3735,4,39,131,174,1.2701149425287357,0.03748833127477099,652,Maybe we should rethink that paleo diet?
3097,3735,10,27,137,174,1.2701149425287357,0.042473751777993965,652,"Just my luck, a dentist had to row me to shore."
3966,3737,11,15,111,137,1.27007299270073,0.051286214817394045,652,"No, that's not Tahiti its the lost island of Diabetes."""
6850,3737,6,25,106,137,1.27007299270073,0.04575548923918324,652,"Shall we go for it, even though it is a mirage?"
5939,3737,7,23,107,137,1.27007299270073,0.04691382528075054,652,Ever been to a desserted island before?
5908,3737,4,29,104,137,1.27007299270073,0.04334605381814431,652,"It looks appealing, but the parking is terrible."
8918,3737,8,21,108,137,1.27007299270073,0.048044242208911604,652,"It's OK for a day or two, but I'm more of a Chutes and Ladders guy."
2256,3737,4,29,104,137,1.27007299270073,0.04334605381814431,652,Why do you keep calling me Hansel?
1038,3737,9,19,109,137,1.27007299270073,0.049148666476155164,652,Take your pick. Starvation or going off your Keto diet.
935,3737,6,25,106,137,1.27007299270073,0.04575548923918324,652,Ignore it... it's just Fantasy Island
544,3737,6,25,106,137,1.27007299270073,0.04575548923918324,652,Ever tried swimming in chocolate?
1288,3737,8,21,108,137,1.27007299270073,0.048044242208911604,652,So do you think minimalism was a good choice
712,3747,7,30,126,163,1.2699386503067485,0.04179324077973915,652,I'm on a diet anyway.
2244,3747,9,26,128,163,1.2699386503067485,0.04356782871513237,652,"If I was stuck on a dessert island, I would bring..."
6561,3747,5,34,124,163,1.2699386503067485,0.039939882959209964,652,Looks like I picked  the wrong week to give up sweets.
6993,3747,7,30,126,163,1.2699386503067485,0.04179324077973915,652,I'd prefer a yellow submarine.
5918,3751,6,29,117,152,1.269736842105263,0.04274723541948937,652,I'm more a savory kind of guy.
3081,3751,6,29,117,152,1.269736842105263,0.04274723541948937,652,Don't believe it.  The grass always looks greener on another island!
5406,3751,7,27,118,152,1.269736842105263,0.04375459417878221,652,Those little round things are skulls.
2813,3754,3,25,87,115,1.2695652173913043,0.04674245637679414,652,"I still say, they should have invited us.."
9238,3755,4,30,107,141,1.2695035460992907,0.04256163374546885,652,"Say it with me: 'Empty calories; nothing to see here."""
8925,3755,5,28,108,141,1.2695035460992907,0.04373568096734234,652,At last we know what happened to Amelia Earhart!
8150,3755,11,16,114,141,1.2695035460992907,0.05020669801171414,652,"Who cares if it’s one “s” or two, you said"
7322,3755,9,20,112,141,1.2695035460992907,0.04814642541302546,652,"Stay strong, man, just two more weeks till swimsuit season."
6663,3755,6,26,109,141,1.2695035460992907,0.04487902530437653,652,The wreck of the good ship Lollipop still haunts my dreams.
6601,3755,5,28,108,141,1.2695035460992907,0.04373568096734234,652,But ours is all inclusive.
4727,3755,6,26,109,141,1.2695035460992907,0.04487902530437653,652,"You’re the one that wanted to play “Chutes and Ladders,” and not “Candyland.”"
5550,3755,4,30,107,141,1.2695035460992907,0.04256163374546885,652,It would have gone straight to my hips anyway.
4446,3755,10,18,113,141,1.2695035460992907,0.04918735002666582,652,You want ants! That's how get ants.
2670,3755,8,22,111,141,1.2695035460992907,0.04708249311005425,652,It used to be part of a golf course but then the president was impeached and now they'll do anything to draw customers
1782,3755,10,18,113,141,1.2695035460992907,0.04918735002666582,652,I’m not going to undo months of Soulcycle in a moment of weakness Gary!
725,3755,6,26,109,141,1.2695035460992907,0.04487902530437653,652,"Just our luck, you can’t swim and I’m on Atkins."
6477,3755,5,28,108,141,1.2695035460992907,0.04373568096734234,652,Let's save it for dessert.
5901,3768,8,29,130,167,1.2694610778443114,0.04198825055139145,652,"Damn autocorrect! I typed ""dessert island."""
8735,3769,9,24,123,156,1.2692307692307692,0.04487474880977718,652,Quit humming Big Rock Candy Mountain
8235,3769,8,19,103,130,1.2692307692307692,0.04979200810745508,652,"A dessert Island or a big rock candy mountain, I’d guess."
7729,3769,5,25,100,130,1.2692307692307692,0.04605933475683601,652,Oh.  You wanted the desserted island!
7154,3769,8,19,103,130,1.2692307692307692,0.04979200810745508,652,How come we didn’t get marooned on a dessert island?
4002,3769,6,23,101,130,1.2692307692307692,0.047336274701534606,652,I told you it wasn't a typo.
3731,3769,9,24,123,156,1.2692307692307692,0.04487474880977718,652,"I’m gluten sensitive, lactose intolerant, and I can’t swim. Is that reason enough?"
2836,3769,6,23,101,130,1.2692307692307692,0.047336274701534606,652,"I told you Bill, that island isn't Paleo"
2760,3769,3,29,98,130,1.2692307692307692,0.04339286980010143,652,"Yes, it's tempting, but the sugar and cholesterol could kill you."
122,3769,6,30,120,156,1.2692307692307692,0.04201909236197543,652,If only one of us could swim!
8837,3778,8,30,133,171,1.2690058479532165,0.041317205729658385,652,"I don’t think the Oompa-Loompas can help us, Mr. Wonka...."
8755,3779,8,23,114,145,1.2689655172413794,0.04617056958251709,652,"First the Titanic, then the Good Ship Lollipop."
6740,3779,8,23,114,145,1.2689655172413794,0.04617056958251709,652,"It may be hard to reach, but I bet it tastes as good as it looks."
6157,3779,9,21,115,145,1.2689655172413794,0.04719647164976508,652,Wednesday is my mirage cheat day.
4240,3779,6,27,112,145,1.2689655172413794,0.04404714081921775,652,"Yes, but think of the carbs..."
4204,3779,8,23,114,145,1.2689655172413794,0.04617056958251709,652,I wouldn’t trust it- I don’t see any tiramisu.
3721,3779,7,25,113,145,1.2689655172413794,0.04512134810664488,652,"As hallucinations go, that’s a cruel one."
1011,3779,7,25,113,145,1.2689655172413794,0.04512134810664488,652,"Twist of fate I  guess.  All that, but we have the coconut."
3037,3779,7,25,113,145,1.2689655172413794,0.04512134810664488,652,And if it turns out to be a mirage?
1726,3779,8,23,114,145,1.2689655172413794,0.04617056958251709,652,I used to live there before I went vegan.
1096,3779,8,23,114,145,1.2689655172413794,0.04617056958251709,652,Imagine being stranded on a dessert island instead.
538,3779,10,19,116,145,1.2689655172413794,0.048200543324739664,652,I 'd trade empty calories for shade any day.
3591,3779,5,29,111,145,1.2689655172413794,0.04294607285579174,652,It looks closer than it is.
3785,3791,5,22,92,119,1.26890756302521,0.04876699173833713,652,Next time wish for a dessert island.
6218,3791,8,16,95,119,1.26890756302521,0.05296705620570955,652,Go ahead.  I’m the one with diabetes.
5825,3793,10,23,127,160,1.26875,0.04496843319793042,652,"Boy, if only we weren't vegan."
7791,3793,7,29,124,160,1.26875,0.042264771709698806,652,I told you to get a travel agent that could spell
7847,3793,6,31,123,160,1.26875,0.041324261342118376,652,I guess global warming does have a sweet side to it.
9184,3793,9,25,126,160,1.26875,0.04408563974896443,652,"Well, somebody got to pick more than 3 things to have on their desert island."
9245,3797,8,20,106,134,1.2686567164179106,0.04873460969450579,652,"I know you're no-sugar-no-flour, but you know how to swim."
7598,3797,9,18,107,134,1.2686567164179106,0.049872668193208444,652,I'm holding out for more chocolate.
4415,3797,7,22,105,134,1.2686567164179106,0.04756933183724331,652,Should we be worried about what happens to sea level when the Sno Caps melt?
6437,3797,4,28,102,134,1.2686567164179106,0.043888253320673705,652,I wish we could have a vegan mirage.
2105,3801,7,15,86,108,1.2685185185185186,0.0552010728394295,652,"You go, I've never had much of a sweet tooth."
1390,3802,4,32,113,149,1.2684563758389262,0.04110622571362967,652,Nah. I'm more of a savory kinda guy.
3828,3802,5,30,114,149,1.2684563758389262,0.04219498209487799,652,"It might be the Big Rock Candy Mountain. After all, we got here by climbing a mountain to escape the rising oceans."
4582,3802,6,28,115,149,1.2684563758389262,0.04325634329846062,652,What do you think of the latest mirage?
5757,3802,9,22,118,149,1.2684563758389262,0.04629465844194008,652,Why couldn’t we be stranded on a dessert island?
6093,3802,9,22,118,149,1.2684563758389262,0.04629465844194008,652,The second 's' is silent
9449,3802,6,28,115,149,1.2684563758389262,0.04325634329846062,652,No thanks.  I’m watching my carbs.
6622,3808,5,23,95,123,1.2682926829268293,0.04770233284865596,652,"You said you wanted me alone on a ""desert"" island - genie's got a twisted sense of humor."
7867,3808,8,28,128,164,1.2682926829268293,0.04246056957046764,652,"Good thing it's my cheat day."""
8174,3808,8,17,98,123,1.2682926829268293,0.05172381098854155,652,"Are we, as an island, truly past autocorrect jokes?"
9786,3808,5,34,125,164,1.2682926829268293,0.039729710180000224,652,Don't do it man... You're in Ketosis.
8452,3812,6,25,107,138,1.2681159420289856,0.04546485812221544,652,That coconut we shared  was laced with LSD
2259,3812,6,25,107,138,1.2681159420289856,0.04546485812221544,652,Too bad we weren’t desserted on that island.
6198,3812,4,29,105,138,1.2681159420289856,0.04307528616827969,652,I think you’re sugarcoating the merits of swimming to another island.
455,3812,5,27,106,138,1.2681159420289856,0.044286191993398845,652,"It’s tempting, but we’ll spoil our appetites."
914,3812,3,31,104,138,1.2681159420289856,0.04182934084685285,652,That's nothing--wait 'til you see the mirage with the babes in it!
1990,3817,9,23,121,153,1.2679738562091503,0.04543727077123655,652,Don't be fooled.  That is the infamous and lethal confectionfish.
2448,3817,12,17,124,153,1.2679738562091503,0.04819277447040354,652,Looks like another Trump campaign trick.
5596,3817,8,25,120,153,1.2679738562091503,0.04448085276985102,652,"Oh, man!  We must’ve been asleep when the Good Ship Lollipop sailed past!"
5665,3817,10,21,122,153,1.2679738562091503,0.04637396777443322,652,It's obviously a complex mirage.
4359,3821,5,20,87,112,1.2678571428571428,0.050706309304391906,652,"Forget it, Bob -- it's all empty calories."
10020,3821,6,33,129,168,1.2678571428571428,0.04002531125119733,652,"After all we have been through, we deserve to have our cake and eat it too."
4423,3823,4,26,97,127,1.2677165354330708,0.04534143118089715,652,Well... I'm glad we managed to escape that
4854,3823,5,24,98,127,1.2677165354330708,0.04669935501144436,652,No one is looking.
6953,3823,6,22,99,127,1.2677165354330708,0.04801889352575499,652,"If you gain the weight back, I am moving to the other side of this Island"
9621,3823,7,20,100,127,1.2677165354330708,0.049303128829625766,652,It's probably just a 'Hansel and Gretel' ploy from the local cannibals!
6409,3827,7,24,111,142,1.267605633802817,0.04570832658874256,652,It all looks better everywhere else
2707,3827,7,24,111,142,1.267605633802817,0.04570832658874256,652,It could be where The Good Ship Lollipop was shipwrecked.
5149,3827,6,26,110,142,1.267605633802817,0.044602253291466165,652,"For the last time, Mark, eating the candy cane first would be a stupid choice."
8859,3827,8,22,112,142,1.267605633802817,0.046788259642886874,652,"Yesterday, I imagined sushi. Oh, wait ..."
6084,3831,10,22,125,157,1.267515923566879,0.04552680875727029,652,Bali Pie awaits us.
8750,3831,9,24,124,157,1.267515923566879,0.04462097038717284,652,They say the sand is always sweeter on the other island.
5027,3831,10,22,125,157,1.267515923566879,0.04552680875727029,652,All those Hollywood types said the Sno-Caps would have melted by now.
7908,3831,8,26,123,157,1.267515923566879,0.04369635775399191,652,"Maybe Candy Island is real, and the sharks are a mirage?"
2923,3831,9,24,124,157,1.267515923566879,0.04462097038717284,652,I never quite got the hang of where and wear either.
1415,3831,7,28,122,157,1.267515923566879,0.04275175275514142,652,I'd swim over in a minute if there were mixed nuts.
4079,3831,6,30,121,157,1.267515923566879,0.041785799577232385,652,It looks okay but I’m really craving coconut.
332,3831,10,22,125,157,1.267515923566879,0.04552680875727029,652,"And you're a dentist, you say?"
9891,3839,4,27,100,131,1.2671755725190839,0.04445061981555055,652,Did your wife sign you up for the Weight Watchers' retreat too?
9583,3839,7,21,103,131,1.2671755725190839,0.04825118691053638,652,Aw..why couldn't we have been marooned on that desserted island?
9538,3839,7,21,103,131,1.2671755725190839,0.04825118691053638,652,"Don't believe it. Our palm tree's a mirage too, y'know."
9411,3839,9,17,105,131,1.2671755725190839,0.050626639849669246,652,"Yeah, right. A desserted isle!"""
8432,3839,5,25,101,131,1.2671755725190839,0.04575256729499358,652,Well it’s a shorter swim than the buffet was.
6420,3839,6,23,102,131,1.2671755725190839,0.04701847749746068,652,It figures - we’re stuck here when we could have been stranded on a desserted island instead.
5556,3839,5,25,101,131,1.2671755725190839,0.04575256729499358,652,Maybe we could spend the winter there.
4818,3839,8,19,104,131,1.2671755725190839,0.049453178364709964,652,I'm really missing that extra 's'.
4625,3839,8,19,104,131,1.2671755725190839,0.049453178364709964,652,"If we had only done some advance planning like our neighbors, The Wonkas."
9608,3848,6,27,113,146,1.2671232876712328,0.04378318191339136,652,I heard Sammy Davis Jr. liked to stay there
9233,3848,10,19,117,146,1.2671232876712328,0.04790469980721477,652,"Too bad we picked ""desert island"" instead of ""dessert island"""
7379,3848,7,25,114,146,1.2671232876712328,0.044849083934353454,652,Wish we had forks.
7226,3848,7,25,114,146,1.2671232876712328,0.044849083934353454,652,How was I supposed to know the difference?
5849,3848,7,25,114,146,1.2671232876712328,0.044849083934353454,652,Remember how bored you got playing that game with your kid?
3154,3848,8,23,115,146,1.2671232876712328,0.045890234702387844,652,"You know, sometimes I think you need glasses.  That's a humpback whale, my friend."
4566,3848,9,21,116,146,1.2671232876712328,0.046908282342565076,652,"Just my luck, nothing vegan."
3326,3848,6,27,113,146,1.2671232876712328,0.04378318191339136,652,"No, you go ahead...I'm trying to watch my weight."
2804,3848,3,33,110,146,1.2671232876712328,0.040417163242766535,652,Marie Antoinette comes to mind...
1149,3848,3,33,110,146,1.2671232876712328,0.040417163242766535,652,Because dessert islands are bad for your teeth.
5252,3848,7,25,114,146,1.2671232876712328,0.044849083934353454,652,"Enough,already! You were right. We shouldn't have booked passage  on the Good Ship Lollipop!"
2253,3859,8,27,126,161,1.2670807453416149,0.0429481884656501,652,Well...our strict coconut diet is actually much more healthy.
3867,3859,9,25,127,161,1.2670807453416149,0.043842749047405725,652,I told you we should have taken “The Good Ship Lollipop”
5955,3861,7,22,106,135,1.2666666666666666,0.04725757139521219,652,"Sorry, I'm on a diet."
9598,3861,7,26,117,150,1.2666666666666666,0.044032392659054245,652,"When I flipped the Card it said ""go back to start"" . . . What's your story?"
8819,3861,8,28,129,165,1.2666666666666666,0.0422337609523278,652,At least this island is low-fat.
8688,3861,6,32,127,165,1.2666666666666666,0.04044590095625991,652,"It could be a trick, sugar doesn't float."
8253,3861,8,24,118,150,1.2666666666666666,0.04503706320236822,652,"Yes, I'd rather be stranded in the dessert aisle."
5643,3861,3,30,102,135,1.2666666666666666,0.0423207369515159,652,But my doctor told me to limit the sugar in my diet.
9105,3861,4,32,114,150,1.2666666666666666,0.040870468891880944,652,"I thought you said Caribbean, not Carb-Island."
4251,3861,8,24,118,150,1.2666666666666666,0.04503706320236822,652,Good thing I can't swim...I'm diabetic.
3977,3861,7,26,117,150,1.2666666666666666,0.044032392659054245,652,A good ship ran aground on that island.
3883,3861,9,18,108,135,1.2666666666666666,0.04954184789852578,652,Sweet place but the taxes will kill you.
2806,3861,7,22,106,135,1.2666666666666666,0.04725757139521219,652,"Didn't know there was such a thing as a dessert island""

Vince Creo, Madison, N"
1624,3861,7,26,117,150,1.2666666666666666,0.044032392659054245,652,Being surrounded by a sea of caramel lessens the attraction.
595,3861,7,30,128,165,1.2666666666666666,0.04134949496875358,652,The nightmares began on day 17 of Whole30 . . .
5243,3861,7,22,106,135,1.2666666666666666,0.04725757139521219,652,What's the one thing you would take with you if you were trapped on a dessert island?
790,3875,9,27,133,169,1.2662721893491125,0.04238992652320577,652,Our break is over. Let's go back.
4799,3875,6,33,130,169,1.2662721893491125,0.03981932616505114,652,That was sweet.  Now let's bring back to the one with the women.
9596,3877,5,31,118,154,1.2662337662337662,0.04124598715960179,652,I'm thinking it might be a trap.
8413,3877,3,35,116,154,1.2662337662337662,0.039133956880474115,652,"I know, right? What are the odds we'd both have blood sugar issues?"
8123,3877,9,23,122,154,1.2662337662337662,0.045174785091514194,652,"I’m betting it’s a sea monster.  But, you’re the optimist, go for it!"
6879,3877,5,31,118,154,1.2662337662337662,0.04124598715960179,652,"Off by one ""S""..."
5700,3877,8,25,121,154,1.2662337662337662,0.0442253182039528,652,"Now that's a Dessert-ed Island I would  
NOT mind being stranded on"
4211,3877,6,29,119,154,1.2662337662337662,0.042262440707957816,652,"Well, we get to see where bonbons play on the sunny beach of Peppermint Bay"
2082,3877,8,25,121,154,1.2662337662337662,0.0442253182039528,652,Don't be fooled - all that stuff is bad for you.
2481,3877,6,29,119,154,1.2662337662337662,0.042262440707957816,652,And I thought this island was deserted.
1448,3877,6,29,119,154,1.2662337662337662,0.042262440707957816,652,If we both concentrate real hard maybe we can make it drift over here
1088,3877,6,29,119,154,1.2662337662337662,0.042262440707957816,652,I'd love to but sweets make me breakout.
779,3877,6,29,119,154,1.2662337662337662,0.042262440707957816,652,"On the plus side, we get unlimited salad bar."
328,3877,13,15,126,154,1.2662337662337662,0.048788225622161646,652,I'm not falling for that witch's trick again.
3105,3877,8,25,121,154,1.2662337662337662,0.0442253182039528,652,And that was the end of the good ship Lollipop ...
7110,3890,7,23,109,139,1.2661870503597121,0.04631734650488074,652,"Stanley, this is not the visualization that we agreed upon..."
9998,3890,6,25,108,139,1.2661870503597121,0.045177784061393216,652,The theme park hallucination was better.
9527,3890,9,19,111,139,1.2661870503597121,0.04851623868730769,652,You said the palm tree looked closer
9355,3890,8,21,110,139,1.2661870503597121,0.047429537229541886,652,I'm just worried about what my dentist would say.
5848,3890,7,23,109,139,1.2661870503597121,0.04631734650488074,652,According to legend it was once inhabited by a tribe of misfit toys. This is all that's left of their civilization.
394,3890,6,25,108,139,1.2661870503597121,0.045177784061393216,652,And if they're not sugar free?
1868,3890,8,21,110,139,1.2661870503597121,0.047429537229541886,652,Now THAT is definitely fake news.
1535,3890,7,23,109,139,1.2661870503597121,0.04631734650488074,652,"But when it’s gone, it’s gone!"
1320,3890,3,31,105,139,1.2661870503597121,0.04157209315192029,652,There should be enough fat in that donut to float us to at least Hawaii
5697,3890,10,17,112,139,1.2661870503597121,0.04957912696810145,652,"Maybe it’s an illusion, but if I see Sammy Davis Jr., I’m swimming over!"
7007,3900,5,23,96,124,1.2661290322580645,0.047365516232269395,652,Still... No milk.
8980,3901,3,36,119,158,1.2658227848101267,0.03853493042179865,652,I just don’t think this is the best week to go Keto.
6182,3901,10,22,126,158,1.2658227848101267,0.045269420674413266,652,"Hey, now that is a Desert Island!"
3603,3901,8,26,124,158,1.2658227848101267,0.043451917541463006,652,I’m starting to regret we went with the paleo option
2255,3901,3,36,119,158,1.2658227848101267,0.03853493042179865,652,What happened to the eight guys who swam over?
1665,3901,6,30,122,158,1.2658227848101267,0.04155499762800144,652,"It's better to eat nothing than junk food, right?"
3124,3901,8,26,124,158,1.2658227848101267,0.043451917541463006,652,Out of all the places for the North Pole to shift...
7070,3907,5,28,110,143,1.2657342657342658,0.04320354997142997,652,I knew I should have used spell-check...
9167,3907,3,32,108,143,1.2657342657342658,0.040860257190267125,652,"The diet requires some self control, but I don't think that should be much of a problem."
8775,3907,6,26,111,143,1.2657342657342658,0.04432876928557099,652,Did we really pay extra for this view?
8294,3907,8,22,113,143,1.2657342657342658,0.046497590247801576,652,Welcome to Diabetes Island.
7382,3907,7,24,112,143,1.2657342657342658,0.0454261251111397,652,I bet it's owned by a politician.
6742,3907,8,22,113,143,1.2657342657342658,0.046497590247801576,652,I suspect Amelia Earhart died from diabetes.
8751,3907,5,28,110,143,1.2657342657342658,0.04320354997142997,652,I don’t even know what’s real anymore. They could be ‘alternative snacks’.
4347,3907,4,30,109,143,1.2657342657342658,0.042048230330113914,652,What I wish is for you to grow up
232,3907,6,26,111,143,1.2657342657342658,0.04432876928557099,652,"Desert, one S. Dessert, 2 S's. And you think spelling doesn't matter."""
2831,3907,5,28,110,143,1.2657342657342658,0.04320354997142997,652,I've never fully appreciated that game until now.
6115,3907,3,32,108,143,1.2657342657342658,0.040860257190267125,652,"Pretty sweet, dude."
3303,3907,3,32,108,143,1.2657342657342658,0.040860257190267125,652,I'm trying to decide if it's worth the calories.
3318,3907,7,24,112,143,1.2657342657342658,0.0454261251111397,652,"I'm sorry.  I really thought it was spelled with one ""s."""
2120,3920,6,22,100,128,1.265625,0.04768815691594056,652,... we shouldn't have banished Willy!
4748,3920,5,24,99,128,1.265625,0.04638026319434138,652,I actually don’t even like sweets.
5405,3920,4,26,98,128,1.265625,0.04503440149389559,652,"Damn, I wish we could swim."
8890,3923,7,25,115,147,1.2653061224489797,0.044579994213738955,652,I'm disappointed.  I thought the good ship Lollypop stopped there.
8390,3923,4,31,112,147,1.2653061224489797,0.041325682132910276,652,He's just trying to compete with the good ship Lollipop!
7723,3923,9,21,117,147,1.2653061224489797,0.04662351128270054,652,It would have never occurred to me that climate change would mean we'd die and go to Candy Land.
7468,3923,5,29,113,147,1.2653061224489797,0.04243818992211959,652,Go ahead.  I'm fasting this week.
6704,3923,9,21,117,147,1.2653061224489797,0.04662351128270054,652,You didn't tell me that you had ordered ile flottante for dessert.
6691,3923,5,29,113,147,1.2653061224489797,0.04243818992211959,652,"Honestly, I would have preferred the dessert'd one."
4605,3923,6,27,114,147,1.2653061224489797,0.04352226928804891,652,"Well Ralph, we finally bonded. We're having the same hallucination!"
4302,3923,8,23,116,147,1.2653061224489797,0.04561319813620343,652,"You know, that there dessert island was once a PIEninsula."
1797,3923,6,27,114,147,1.2653061224489797,0.04352226928804891,652,The punishment was all the more cruel because of their coconut allergy.
1777,3923,6,27,114,147,1.2653061224489797,0.04352226928804891,652,And my third wish was I chose you.
707,3923,5,29,113,147,1.2653061224489797,0.04243818992211959,652,"We should have done a more thorough Air B&B search for this ""island seclusion"" trip."
6636,3923,7,25,115,147,1.2653061224489797,0.044579994213738955,652,"That figures, we’ve been pulling up Swedish fish for weeks."
7142,3935,7,21,104,132,1.2651515151515151,0.04792701155749111,652,Let's just call GrubHub.
7528,3935,6,23,103,132,1.2651515151515151,0.04670479649701895,652,"Darn, I wanted the pizza delivered first."
3689,3935,3,29,100,132,1.2651515151515151,0.042829391226308085,652,I moved over here when my A1C reached the danger level.
1406,3935,4,27,101,132,1.2651515151515151,0.044158998786431834,652,And me without a toothbrush.
619,3935,6,23,103,132,1.2651515151515151,0.04670479649701895,652,I finally understand the 'Medicare for all' debate.
3622,3935,6,23,103,132,1.2651515151515151,0.04670479649701895,652,Is dessert-ed a word?
201,3941,7,30,129,166,1.2650602409638554,0.04113102928238062,652,"No thanks, I'm borderline diabetic."
7976,3941,8,28,130,166,1.2650602409638554,0.042009295637463806,652,“Here comes the good ship Lollipop.”
2951,3943,7,26,118,151,1.2649006622516556,0.04377545226709975,652,The Joneses just have different tastes than we do.
115,3943,8,24,119,151,1.2649006622516556,0.04477265283562814,652,The cruelty of it all is that I lost my toothbrush.
1094,3943,8,24,119,151,1.2649006622516556,0.04477265283562814,652,Desert or dessert?
1422,3943,8,24,119,151,1.2649006622516556,0.04477265283562814,652,"Trust me: once you’ve been on the No Sugar diet a month, the cravings will go away."
2237,3943,6,28,117,151,1.2649006622516556,0.04275499971276549,652,Damn. I was wishing for The Good Ship Lollipop!
6034,3943,7,26,118,151,1.2649006622516556,0.04377545226709975,652,"Next year ,5 star all inclusive."
6232,3943,6,28,117,151,1.2649006622516556,0.04275499971276549,652,"Of course it’s a funny looking rescue ship, so what ?"
7572,3943,5,30,116,151,1.2649006622516556,0.041709588582099735,652,When you type “dessert island” instead of “desert island”
8216,3943,9,22,120,151,1.2649006622516556,0.04574812195806766,652,I'm really starting to hate Martha Stewart.
9060,3943,4,32,115,151,1.2649006622516556,0.040637292711713374,652,I don't think I'm gluten free anymore.
9633,3953,8,20,108,136,1.2647058823529411,0.04809587161956923,652,"Fyre Fest VII will be different, you said..."
9941,3953,6,24,106,136,1.2647058823529411,0.04577497070560295,652,Funny...The only difference between here and there is an 's'.
7772,3953,6,24,106,136,1.2647058823529411,0.04577497070560295,652,"PAY NO ATTENTION, IT'S ONLY THE SHARKS.  THEY'RE JUST TRYING TO SUCKER US IN."
6197,3953,6,24,106,136,1.2647058823529411,0.04577497070560295,652,Dessert island not desert island!
4230,3953,7,22,107,136,1.2647058823529411,0.04694976469560254,652,"Yes! For the last time, ''dessert island' - I get it!"
6077,3953,5,26,105,136,1.2647058823529411,0.04456922123197992,652,Well? Still glad you didn't cash in the extra 10 thousand miles?
6748,3953,7,22,107,136,1.2647058823529411,0.04694976469560254,652,"Why are you looking at the other survivors like that?"""
8641,3960,5,31,119,155,1.264516129032258,0.041015001654154525,652,Maybe Mom was right about swim lessons coming in handy one day.
4201,3960,9,23,123,155,1.264516129032258,0.044915243324909135,652,"I told you ""dessert"" has two S's!"
4123,3960,4,33,118,155,1.264516129032258,0.0399805350155413,652,Yes but it wasnt MY new years resolution
3398,3960,9,23,123,155,1.264516129032258,0.044915243324909135,652,It's not a mirage. It's pre-production for Season 38 - Survivor: Candy Land.
5519,3960,8,25,122,155,1.264516129032258,0.043972626739534455,652,Figures that would appear right after I give up sugar for Lent.
3135,3960,6,29,120,155,1.264516129032258,0.04202401148452718,652,I would.... but I really want to stick with this gluten-free diet.
1563,3960,8,25,122,155,1.264516129032258,0.043972626739534455,652,This reminds me of the view of the city from my place in Jersey.
1427,3960,9,23,123,155,1.264516129032258,0.044915243324909135,652,I guess we're not the only things baking in this sun
3331,3960,6,29,120,155,1.264516129032258,0.04202401148452718,652,Diabetes or starvation? You decide.
5763,3969,4,24,93,121,1.2644628099173554,0.04660453613180722,652,Let's do another juice cleanse instead.
1804,3970,8,30,136,174,1.264367816091954,0.04068996672962488,652,Now that's what I call all inclusive.
5768,3970,8,30,136,174,1.264367816091954,0.04068996672962488,652,They’re killing themselves with that stuff.
8350,3972,7,23,110,140,1.2642857142857142,0.04602460833093375,652,I've been having these bizarre dreams about Shirley Temple lately.
9613,3972,7,23,110,140,1.2642857142857142,0.04602460833093375,652,My nutritionist always said sweets would be my undoing.
8940,3972,8,21,111,140,1.2642857142857142,0.047127905692218745,652,"I get that, but there are rare circumstances when bad carbs are actually good carbs."
9645,3972,7,23,110,140,1.2642857142857142,0.04602460833093375,652,"The joke is on the sharks, we're diabetic."
8578,3972,4,29,107,140,1.2642857142857142,0.04254338730354498,652,I don't think it's worth the calories.
7919,3972,6,25,109,140,1.2642857142857142,0.044894205072559736,652,We’ve the wrong kind of dessert island
4484,3972,7,23,110,140,1.2642857142857142,0.04602460833093375,652,"I thought the island was deserted, not desserted."
6620,3972,5,27,108,140,1.2642857142857142,0.04373459415815174,652,"maybe so, but I'm still going for it."
5845,3972,5,27,108,140,1.2642857142857142,0.04373459415815174,652,Trevor actually got a little over half way.
2532,3972,5,27,108,140,1.2642857142857142,0.04373459415815174,652,"Ok, let’s go, but remember the one bite rule!"
123,3972,9,19,112,140,1.2642857142857142,0.04820595832315205,652,"So? The appetizer, soup and entree atolls were also buffet style."
7237,3972,9,19,112,140,1.2642857142857142,0.04820595832315205,652,This is what's left from the Good Ship Lollipop?
5690,3984,6,30,123,159,1.2641509433962264,0.04132664881900787,652,You called Uber Eats and all you could think of was to order a dessert tray?
3912,3985,10,27,141,178,1.2640449438202248,0.04162550025318213,652,Wish we were on the misspelled island.
642,3986,7,19,99,125,1.264,0.049701041723359256,652,Candyland always looked more inviting in the board game.
6873,3986,4,25,96,125,1.264,0.04564095500965716,652,Did we miss the entr'ee?
6694,3988,5,28,111,144,1.2638888888888888,0.04294214579750938,652,Too bad you're off sugar.
340,3988,4,30,110,144,1.2638888888888888,0.04179596617581002,652,I will swim for cake. You?
813,3988,4,30,110,144,1.2638888888888888,0.04179596617581002,652,It’s all yours. I’m on a low sugar diet.
1356,3988,8,22,114,144,1.2638888888888888,0.046210422818557334,652,"Funny, usually there's a swarm of people around the dessert island."
8830,3992,6,31,126,163,1.2638036809815951,0.040660513406971355,652,It's a mirage or alternatively perhaps we are.
3688,3992,9,25,129,163,1.2638036809815951,0.043364714188327,652,It's called Christmas Island for a reason.
999,3992,11,21,131,163,1.2638036809815951,0.045077479529285466,652,"I said ""desserted island"", not ""deserted island""!"
3893,3995,5,24,100,129,1.2635658914728682,0.046065365596917485,652,Is that what a wall looks like?
5626,3995,9,16,104,129,1.2635658914728682,0.051054030512866236,652,Looks like the Good Ship Lollypop hit a sandbar.
6551,3995,6,22,101,129,1.2635658914728682,0.047361819418023005,652,"I've heard of mirage, but never meringue."
8313,3995,3,28,98,129,1.2635658914728682,0.04335631263797886,652,Three more days till I complete my Sugar Free January!
8678,3995,7,20,102,129,1.2635658914728682,0.04862371817943557,652,"""Tell me the difference between 'there,' 'they're' and 'their' and then I'll believe you MEANT to choose this island."""
8818,3995,2,30,97,129,1.2635658914728682,0.041936211256555035,652,Feh!  I'm more of a meat and potatoes guy myself.
8960,3995,4,26,99,129,1.2635658914728682,0.044731352277456546,652,My teeth hurt
5134,4002,6,27,115,148,1.2635135135135136,0.043264352955627354,652,I remember before global warming there used to be a land bridge
6770,4002,5,29,114,148,1.2635135135135136,0.04218857159601243,652,Christmas Island no doubt.
7096,4002,7,25,116,148,1.2635135135135136,0.044314025996588666,652,Sometimes I wish I weren't on the Paleo Diet....
7525,4002,9,21,118,148,1.2635135135135136,0.04634209993883322,652,Our good luck!  We’ve landed right by the big rock candy atoll.
4892,4002,8,23,117,148,1.2635135135135136,0.045339404091624,652,I hear they die young... but happy.
9140,4002,7,25,116,148,1.2635135135135136,0.044314025996588666,652,Look at it this way: our island is deserted too.
9354,4002,8,23,117,148,1.2635135135135136,0.045339404091624,652,For want of an “s” we starve.
4975,4002,9,21,118,148,1.2635135135135136,0.04634209993883322,652,"On the bright side, we'll have plenty of time to study that list of commonly misspelled words."
7664,4002,4,31,113,148,1.2635135135135136,0.04108463106752489,652,"Dessert Island,so near,yet so far."
9853,4002,5,29,114,148,1.2635135135135136,0.04218857159601243,652,"Milk and honey” was so 3,600 years ago."
4278,4002,6,27,115,148,1.2635135135135136,0.043264352955627354,652,"It's gotta be real, mirages are only in cartoons."
4597,4002,3,33,112,148,1.2635135135135136,0.03995019707832988,652,The island is always sweeter on the other side of the channel.
3670,4002,7,25,116,148,1.2635135135135136,0.044314025996588666,652,Why couldn’t we be stuck on a dessert-ed island?
3040,4002,8,23,117,148,1.2635135135135136,0.045339404091624,652,I'm ready to take the bitter with the sweet
2893,4002,6,27,115,148,1.2635135135135136,0.043264352955627354,652,NOW can we invent a boat?
2388,4002,6,27,115,148,1.2635135135135136,0.043264352955627354,652,I've always dreamed of getting to the Big Rock Candy Island.
1888,4002,8,23,117,148,1.2635135135135136,0.045339404091624,652,The cartoonist thinks he's funny. It's––DESSERTED.
818,4002,9,21,118,148,1.2635135135135136,0.04634209993883322,652,We had a choice.. sugar or palm oil.  No point having second thoughts.
356,4002,7,25,116,148,1.2635135135135136,0.044314025996588666,652,"Ah, sweet redemption."
4688,4002,6,27,115,148,1.2635135135135136,0.043264352955627354,652,"No carrot cake, bummer."
1571,4022,10,24,133,167,1.2634730538922156,0.04347935965149285,652,That'll wreak havoc with our Paleo diet.
5921,4023,5,30,117,152,1.263157894736842,0.0414709098441645,652,Let's go there for our honeymoon.
8234,4023,8,24,120,152,1.263157894736842,0.04451125128015218,652,And we have to be on the desert island!
5542,4023,9,17,107,133,1.263157894736842,0.04994270679907134,652,I can’t eat all that junk food.
9386,4023,5,30,117,152,1.263157894736842,0.0414709098441645,652,What are you in the mood for?
9562,4023,6,28,118,152,1.263157894736842,0.04250852548658324,652,I know it is close but I have never been much for sweets.
3625,4023,2,31,100,133,1.263157894736842,0.04119254540021517,652,You know it could just be cannibals teasing us.
8840,4023,7,21,105,133,1.263157894736842,0.047607054407015306,652,Sometimes I wish I wasn’t a vegan.
2967,4023,8,24,120,152,1.263157894736842,0.04451125128015218,652,It happened this morning.  The ship was the SS Lollypop.
2592,4023,5,25,103,133,1.263157894736842,0.045150739708304057,652,"So Gretel, what are the chances?"
2551,4023,8,24,120,152,1.263157894736842,0.04451125128015218,652,"As your dentist, i have to recommend you not to do it."
2027,4023,4,27,102,133,1.263157894736842,0.043871039760350776,652,These 'pop-up' stores are getting out of hand.
1746,4023,6,23,104,133,1.263157894736842,0.046395155595813774,652,Look on the bright side — at least we won’t die from diabetes.
1745,4023,6,23,104,133,1.263157894736842,0.046395155595813774,652,We should have sailed with the Good Ship Lollipop!
1265,4023,5,30,117,152,1.263157894736842,0.0414709098441645,652,Guess we picked the wrong time to go paleo.
516,4023,5,25,103,133,1.263157894736842,0.045150739708304057,652,We should open a dentist hut
39,4023,9,22,121,152,1.263157894736842,0.04547955437628567,652,You'd think we would've crashed over there.
3491,4039,7,32,136,175,1.262857142857143,0.03966550263718428,652,We picked the wrong week to quit sugar.
1831,4039,10,26,139,175,1.262857142857143,0.042076079123842355,652,Once it has cooled down we can swim across the hot chocolate and get somthing to eat....
553,4041,7,27,122,156,1.2628205128205128,0.04276639324281545,652,I call this the Island Diet
6401,4041,9,23,124,156,1.2628205128205128,0.04465859786062159,652,I would have much preferred a Tapas Isle to a Dessert Isle.
7232,4041,7,27,122,156,1.2628205128205128,0.04276639324281545,652,I could really go for a burger right now.
5819,4044,10,16,111,137,1.2627737226277371,0.04997860533326708,652,"Had to forget the extra S, didn’t you, Bob?"
8855,4044,3,30,104,137,1.2627737226277371,0.041790735125958815,652,Yet another mirage on the rocks.
8075,4044,8,20,109,137,1.2627737226277371,0.04778259701132749,652,I hear they’re building a wall and we’re paying for it.
7890,4044,1,34,102,137,1.2627737226277371,0.03913797552833434,652,Hey - Desert island. Dessert Island. It's close. Give me a break.
5295,4044,5,26,106,137,1.2627737226277371,0.044284872770276734,652,Might be time to rethink your paleo diet.
4629,4044,5,26,106,137,1.2627737226277371,0.044284872770276734,652,Would it still be deserted if we were on it?
3758,4044,7,22,108,137,1.2627737226277371,0.04664583979511086,652,"Well, we're out of coconuts, you want to try swimming over to that dessert island?"
1267,4044,6,24,107,137,1.2627737226277371,0.045480679010271745,652,I dunno...I've been trying to cut back on sugar.
902,4044,4,28,105,137,1.2627737226277371,0.0430558677687934,652,"Ya, and just over the horizon is Rock Candy Mountain."
629,4044,10,16,111,137,1.2627737226277371,0.04997860533326708,652,I guess it's a desert island.
268,4044,5,26,106,137,1.2627737226277371,0.044284872770276734,652,"Over there, I heard the tribal council does not judge."
9490,4055,5,32,123,160,1.2625,0.040132935548290886,652,This is when I hate the gluten-free thing.
9368,4055,7,28,125,160,1.2625,0.04204622718063757,652,"I've heard of crash diets, but this is ridiculous."
8426,4055,5,32,123,160,1.2625,0.040132935548290886,652,"I never envisioned Candyland as an island, did you?"
7148,4055,7,28,125,160,1.2625,0.04204622718063757,652,If I knew it was gluten-free I'd swim for it
6064,4055,7,28,125,160,1.2625,0.04204622718063757,652,It's probably all made from soy.
4801,4055,9,24,127,160,1.2625,0.043876165791102366,652,I don't think we're dressed for it
2370,4055,7,28,125,160,1.2625,0.04204622718063757,652,Well at least we have something to look forward to.
6296,4062,5,27,109,141,1.2624113475177305,0.0434637466358263,652,Darn that autocorrect!
6260,4062,7,23,111,141,1.2624113475177305,0.04573545142240031,652,You go. I'm doing Atkins.
5438,4062,9,19,113,141,1.2624113475177305,0.04789953822322482,652,The crew of the Good Ship Lollipop trashed it.
4772,4062,6,25,110,141,1.2624113475177305,0.04461406049909625,652,"This is better then TV, yesterday it was a bikini contest!"
4257,4062,9,19,113,141,1.2624113475177305,0.04789953822322482,652,Any chance you're a dentist?
7114,4062,6,25,110,141,1.2624113475177305,0.04461406049909625,652,Its so retro.
1697,4062,8,21,112,141,1.2624113475177305,0.04682999721764306,652,I told you The Good Ship Lollipop wasn’t a good choice for our vacation.
1556,4062,4,29,108,141,1.2624113475177305,0.04228214929529463,652,"On the bright side, your cholesterol levels are fabulous."
1044,4062,8,21,112,141,1.2624113475177305,0.04682999721764306,652,You really see it too?
673,4062,7,23,111,141,1.2624113475177305,0.04573545142240031,652,"No, you meant a dessert-ed island? Hilarious, Universe."
3950,4062,4,29,108,141,1.2624113475177305,0.04228214929529463,652,"But no, Big Rock Candy Mountain wasn't good enough for you. You had to insist on a cruise."
8281,4062,7,23,111,141,1.2624113475177305,0.04573545142240031,652,...if only I’d paid attention in spelling class!
9438,4074,8,16,98,122,1.2622950819672132,0.05179775617580556,652,"Don’t go there. It’s the modern Circe’s island. You eat, turn fat and orange, and start spouting nonsensical policy ideas like the need to dissolve the post WW2 western alliance."
4555,4074,7,18,97,122,1.2622950819672132,0.05047300811289448,652,"I’d settle for the Good Ship
Lollipop."
3697,4076,5,33,126,164,1.2621951219512195,0.03950805227642463,652,"Looks really good, but I gave up sweets for lent."
6910,4076,5,33,126,164,1.2621951219512195,0.03950805227642463,652,"Remember, Palm Beach Diet"
8794,4078,6,26,113,145,1.2620689655172415,0.043791444141491366,652,Moses....At low tide we walk!
2066,4078,5,28,112,145,1.2620689655172415,0.04268378075316585,652,"...but is it a rescue, or just another alien-abduction trick?"
3192,4078,7,24,114,145,1.2620689655172415,0.04487177309412216,652,"You see, I always knew in my heart the Candyland was a real place."
4077,4078,5,28,112,145,1.2620689655172415,0.04268378075316585,652,"I mean sure, that's nice if you go for that sort of thing."
4553,4078,7,24,114,145,1.2620689655172415,0.04487177309412216,652,Do you think they have anything that is lactose and gluten free?
4738,4078,8,22,115,145,1.2620689655172415,0.04592669660691276,652,"Do you have to be getting back, or shall I pour you a glass of wine?"
4995,4078,7,24,114,145,1.2620689655172415,0.04487177309412216,652,Can we use this homophone to call for help?
6367,4078,6,26,113,145,1.2620689655172415,0.043791444141491366,652,Ready for another swim?
7041,4078,4,30,111,145,1.2620689655172415,0.041546596717075446,652,"Nah, I’m trying to cut back on carbs."
8949,4078,10,18,117,145,1.2620689655172415,0.047966992218081234,652,They’re survivors from the Good Ship Lollipop
8985,4078,6,26,113,145,1.2620689655172415,0.043791444141491366,652,Is it possible you misspelled the destination? I think a dessert island sounds like more fun.
3649,4089,7,19,100,126,1.2619047619047619,0.049349510125834724,652,"Do you think they’re made with organic, fair trade sugar?"
9626,4089,4,25,97,126,1.2619047619047619,0.04532572965444112,652,"Oh man, I think my insulin went down with the ship!"
2634,4089,8,28,132,168,1.2619047619047619,0.041567256865472406,652,Diabetic huh? Bummer.
8664,4092,6,27,116,149,1.261744966442953,0.04300938393335905,652,Do you think our kids will be upset if we don't save them anything?
6660,4092,5,29,115,149,1.261744966442953,0.04194177374360649,652,I'll go over first.....
8420,4092,6,27,116,149,1.261744966442953,0.04300938393335905,652,Go figure. Germs everywhere. Look at that half-eaten donut.
6847,4092,8,23,118,149,1.261744966442953,0.045068797958914913,652,"You say ""desert."" I say ""dessert."" Desert, dessert, desert, dessert. Let’s call the whole thing off!"
6778,4092,10,19,120,149,1.261744966442953,0.047038133387666464,652,I'm here to study the predatory strategies of giant mollusks. You?
6709,4092,7,25,117,149,1.261744966442953,0.04405112743045617,652,How it feels in the first week while dieting
5847,4092,7,25,117,149,1.261744966442953,0.04405112743045617,652,Mirage or not..you're diabetic.
722,4092,8,23,118,149,1.261744966442953,0.045068797958914913,652,Is that one 's' or two?
5561,4092,12,15,122,149,1.261744966442953,0.048928268268254825,652,Seems like spelling _did_ count.
4176,4092,9,21,119,149,1.261744966442953,0.046063991045378366,652,It's a vegan bakery - don't bother.
3448,4092,4,31,114,149,1.261744966442953,0.040846268656912516,652,"I see it. Do you see it, too?"
1827,4092,7,25,117,149,1.261744966442953,0.04405112743045617,652,"And the rising seas,
Killed the cigarette trees 
and the lemonade springs
Where no bluebirds sing
In the Big Rock Candy Mountains!"
753,4092,5,29,115,149,1.261744966442953,0.04194177374360649,652,Now you have children designing their own submarines.
5824,4092,8,23,118,149,1.261744966442953,0.045068797958914913,652,"Just wait, pretty soon we’ll see the Good Ship Lollipop."
663,4106,7,31,134,172,1.2616279069767442,0.04007114244383266,652,But our island is vegan.
9194,4106,9,27,136,172,1.2616279069767442,0.04173362395913673,652,"Sure, it's tempting, but I'm saving myself for the beach."
3171,4108,5,24,101,130,1.2615384615384615,0.04575458392739736,652,I told you Trump would save us.
2562,4108,6,22,102,130,1.2615384615384615,0.04703979735018118,652,I can't believe you traded our raft for a half dozen cupcakes.
127,4108,6,22,102,130,1.2615384615384615,0.04703979735018118,652,"OK, my turn. Something beginning with “C”."
951,4108,4,26,100,130,1.2615384615384615,0.04443221090596759,652,You go. I'm more of a savory gal.
2482,4108,5,24,101,130,1.2615384615384615,0.04575458392739736,652,"All wax, it's a Japanese island."
831,4113,8,24,121,153,1.261437908496732,0.044252809299484865,652,That definitely doesn't look like a Russian sub to me!
971,4113,6,28,119,153,1.261437908496732,0.04226479039206945,652,I'm sticking to South Beach.
3666,4113,8,24,121,153,1.261437908496732,0.044252809299484865,652,I'll race you for the cake.
5321,4113,7,26,120,153,1.261437908496732,0.04327021861385808,652,"You go if you want, I'm doing Keto."
7549,4113,5,30,118,153,1.261437908496732,0.04123485412706176,652,I can never remember. Is it one 's' or two?
7852,4113,9,22,122,153,1.261437908496732,0.04521405138783825,652,"Oh great, the only good thing about being marooned was losing fifty pounds."
8535,4113,7,26,120,153,1.261437908496732,0.04327021861385808,652,Told you I was spelling it right.
9591,4113,9,22,122,153,1.261437908496732,0.04521405138783825,652,Maybe we should not have sailed on the Good Ship Lollpop
8873,4121,3,29,102,134,1.2611940298507462,0.04227975466244136,652,"Nah, you go ahead. I’m on a diet."
8824,4121,9,17,108,134,1.2611940298507462,0.04960748691599403,652,"Welcome to America, Jerry."
6094,4121,8,19,107,134,1.2611940298507462,0.04846320158106015,652,I'd rather be stranded on a desserted island.
2741,4121,7,21,106,134,1.2611940298507462,0.04729123657563231,652,To die of hunger or to die of obesity?
5557,4121,3,29,102,134,1.2611940298507462,0.04227975466244136,652,But are they gluten-free?
1741,4121,7,21,106,134,1.2611940298507462,0.04729123657563231,652,It's the old two-palm tree mirage trick.
1489,4121,7,21,106,134,1.2611940298507462,0.04729123657563231,652,It's okay to have one cheat day.
1242,4121,3,29,102,134,1.2611940298507462,0.04227975466244136,652,I see Willy Wonka survived the plane crash also.
2304,4121,8,19,107,134,1.2611940298507462,0.04846320158106015,652,The Good Ship Lollipop just completely ignored us!
9427,4130,8,25,124,157,1.2611464968152866,0.04347559233033532,652,"Restraint is the ultimate trip, bro."
7904,4130,8,25,124,157,1.2611464968152866,0.04347559233033532,652,We can swim over but we will never make it back.
6416,4130,6,29,122,157,1.2611464968152866,0.0415548853183028,652,"Desserted is not a word,bruh."
5636,4130,9,23,125,157,1.2611464968152866,0.044404802057903814,652,I told you before you wished that dessert was spelled with 2 “s”s!
5389,4130,9,23,125,157,1.2611464968152866,0.044404802057903814,652,"But is it gluten-free, vegan, non-GMO and sustainably produced?"
4215,4130,7,27,123,157,1.2611464968152866,0.042526083891482463,652,"When I was a kid, long before the cruise ship sank, I believed 'Candy Land' was only a board game."
2867,4130,4,33,120,157,1.2611464968152866,0.03954098960776125,652,"If you say that ""grass is greener"" thing one more time you're going for a swim!"
1015,4130,4,33,120,157,1.2611464968152866,0.03954098960776125,652,I don't trust it.
4690,4130,8,25,124,157,1.2611464968152866,0.04347559233033532,652,You go.  I'm on a gluten-free diet.
5617,4139,5,26,107,138,1.2608695652173914,0.04400401468716787,652,"Yeah, dude, my mom wanted me to take swimming lessons too.  But I had just got my new joystick system."
6863,4139,8,20,110,138,1.2608695652173914,0.04747328592987294,652,Who would have ever thought you'd be able to swim to the top of Big Rock Candy Mountain.
6515,4139,4,28,106,138,1.2608695652173914,0.04278512341680797,652,No I can’t. I’m diabetic.
7381,4139,8,20,110,138,1.2608695652173914,0.04747328592987294,652,That must be the good breast.
5756,4139,6,30,125,161,1.2608695652173914,0.040877163295304914,652,It's Amazon's new dessert delivery service.
9030,4139,10,16,112,138,1.2608695652173914,0.04965164571868151,652,Imagine what it’s like to be stranded on a dessert island
9240,4139,4,22,89,115,1.2608695652173914,0.04797494343742813,652,"Unfortunately, that Island isn't on Atkins.  I'll wait for the Steak and Cheese Island to float by."
9512,4139,8,26,127,161,1.2608695652173914,0.0427343185528518,652,"Candy ""Crash"" level one!"
3430,4139,5,26,107,138,1.2608695652173914,0.04400401468716787,652,"Looks good, but there's no coconut tree."
8935,4139,7,22,109,138,1.2608695652173914,0.046345726385314936,652,It's just as well. My dentist told me to cut back on sweets.
2792,4139,5,26,107,138,1.2608695652173914,0.04400401468716787,652,"What, no cigarette trees!"
5612,4139,6,24,108,138,1.2608695652173914,0.04519004128550317,652,"Just goes straight to the thighs, man."
2661,4139,10,16,112,138,1.2608695652173914,0.04965164571868151,652,"Oh, the difference one letter can make."
2691,4139,6,30,125,161,1.2608695652173914,0.040877163295304914,652,"I’m staying here.  Look at it! Over the top, and not a single palm tree.  And, I bet it has ants."
2529,4139,10,22,129,161,1.2608695652173914,0.04451405941140623,652,I heard it's from the wreck of The Good Ship Lollipop.
1962,4139,7,22,109,138,1.2608695652173914,0.046345726385314936,652,My inner child is hallucinating again.
1781,4139,7,22,109,138,1.2608695652173914,0.046345726385314936,652,Let’s invite our neighbors over for coffee.
1553,4139,6,24,108,138,1.2608695652173914,0.04519004128550317,652,I’m not a big sweets person.
1365,4139,6,24,108,138,1.2608695652173914,0.04519004128550317,652,They say sugar is more deadly than smoking.
975,4139,5,26,107,138,1.2608695652173914,0.04400401468716787,652,I understand the estate of Michael Jackson has plans for it.
601,4139,3,30,105,138,1.2608695652173914,0.04153047390765598,652,You're right.  It is a great view.
391,4139,7,22,109,138,1.2608695652173914,0.046345726385314936,652,"I can't, I'm on the South Beach Diet."
389,4139,4,28,106,138,1.2608695652173914,0.04278512341680797,652,At least you spelled it ‘isle’ and not ‘aisle’.
3150,4162,6,31,128,165,1.2606060606060605,0.04022935878161647,652,You can go. I've got better things to do.
10017,4162,5,33,127,165,1.2606060606060605,0.03930001880371855,652,"Distractions aside, what did you think of Roma?"
8256,4164,8,21,113,142,1.2605633802816902,0.04653574554365965,652,That? It's the Island of Discarded Fruitcakes
5802,4164,6,25,111,142,1.2605633802816902,0.044337290981409164,652,Man it’s never easy to stick with the low-carb isle
3461,4164,5,27,110,142,1.2605633802816902,0.04319612541308653,652,If ifs and buts were candy and nuts...
1901,4164,7,23,112,142,1.2605633802816902,0.04544981289771381,652,Something tells me they aren't gluten free.
1999,4164,11,15,116,142,1.2605633802816902,0.04965124344772624,652,"Unfortunately, I don't see an insulin island nearby."
3114,4164,7,23,112,142,1.2605633802816902,0.04544981289771381,652,I understand the natives are part of a carbo cult.
4942,4170,5,34,130,169,1.2603550295857988,0.03870999361770568,652,Think the Goodship Lollipop is in the vicinity?
7944,4171,5,28,113,146,1.2602739726027397,0.04242840480501643,652,Disney got into the submarine business when sea level started rising.
10016,4171,4,30,112,146,1.2602739726027397,0.04130007533902064,652,I suspect shark bait.
9863,4171,8,22,116,146,1.2602739726027397,0.04564635218905256,652,WHAT HAPPENED TO THOSE HULA GIRLS WHO WERE OVER THERE LAST WEEK?
9729,4171,5,28,113,146,1.2602739726027397,0.04242840480501643,652,"I know it's a mirage, but it smells great!"
9260,4171,9,20,117,146,1.2602739726027397,0.04666972015618461,652,Empty calories. No thanks.
8496,4171,7,24,115,146,1.2602739726027397,0.044599508482464946,652,"I'd rather be marooned on a dessert island,as well."""
4512,4171,6,26,114,146,1.2602739726027397,0.04352749528272793,652,"Honestly, I can't tell if it's the dehydration or my sweet tooth talking."
292,4171,2,34,110,146,1.2602739726027397,0.038945469575159306,652,We picked a hell of a time to go on a diet.
2811,4171,4,30,112,146,1.2602739726027397,0.04130007533902064,652,"If that’s the Big Rock Candy Mountain, then this might be the lake of gin we can both jump in!"
2793,4171,7,24,115,146,1.2602739726027397,0.044599508482464946,652,You go ahead. I'm trying to cut back on carbs.
1490,4171,6,26,114,146,1.2602739726027397,0.04352749528272793,652,"Being stranded on a dessert island sounds does sound better, but just think of the empty carbs."
970,4171,7,24,115,146,1.2602739726027397,0.044599508482464946,652,"Well, there goes the neighborhood!"
839,4171,5,28,113,146,1.2602739726027397,0.04242840480501643,652,Aren't you glad we're doing keto?
305,4171,4,30,112,146,1.2602739726027397,0.04130007533902064,652,Too bad you're a vegan!
4333,4171,4,30,112,146,1.2602739726027397,0.04130007533902064,652,I would but that kind of stuff goes straight to my hips.
3204,4186,6,20,97,123,1.2601626016260163,0.048758269408004706,652,"Once we get there, we can build a Good Ship Lollypop."
4133,4186,5,22,96,123,1.2601626016260163,0.04737181455611305,652,I’m positive the brochure said “Spend a sweet week on our DESSERT  island”
7321,4186,8,16,99,123,1.2601626016260163,0.05141914894582732,652,"Nah, I don't want to spoil my appetite."""
7631,4186,4,24,95,123,1.2601626016260163,0.04594353918685369,652,"It seems enticing, but all those refined sugars will kill you."
6011,4190,6,27,117,150,1.26,0.04275731422181576,652,this is the last time I use an on-line Travel Agen
9828,4190,5,29,116,150,1.26,0.04169775126850502,652,I really shouldn't.  I just started the keto diet.
4207,4190,6,27,117,150,1.26,0.04275731422181576,652,"Must definitely be inhabited, don't you think ?"
726,4190,7,25,118,150,1.26,0.0437912477337203,652,"But we’re vegans, Charles."
2437,4190,7,25,118,150,1.26,0.0437912477337203,652,Look at all the calories we're saving.
1360,4190,7,25,118,150,1.26,0.0437912477337203,652,With our luck it is probably vegan.
3236,4190,7,25,118,150,1.26,0.0437912477337203,652,"The sweetest temptation is sitting next to me."""
7043,4197,6,34,137,177,1.2598870056497176,0.03844582671181271,652,There go the neighbors — showing off their decorating skills again.
7707,4197,8,30,139,177,1.2598870056497176,0.04008097132468578,652,There goes the Good Ship Lollipop.
1297,4199,5,23,99,127,1.2598425196850394,0.04638217211292898,652,"Be carful, No ones ever came back from there!"
1954,4199,5,23,99,127,1.2598425196850394,0.04638217211292898,652,"Unreal, even my mirages are childlike."
3567,4199,5,23,99,127,1.2598425196850394,0.04638217211292898,652,I keep waiting for bathing suit season to end.
3925,4199,6,21,100,127,1.2598425196850394,0.04771048382553092,652,I would argue that it’s actually a triple entendre...
6668,4199,5,23,99,127,1.2598425196850394,0.04638217211292898,652,"Well, my New Year's resolution was to eat more sugar."
8591,4199,9,15,103,127,1.2598425196850394,0.05149022623493599,652,You go.  I’m allergic to gluten.
8982,4205,8,24,122,154,1.2597402597402598,0.04399727866706485,652,"You know, being stuck on a desserted island isn't such a bad idea!"
8903,4205,10,20,124,154,1.2597402597402598,0.045886004464919236,652,Only half a donut?
8707,4205,7,26,121,154,1.2597402597402598,0.043021832739711885,652,But such a convenient delusion.
8300,4205,8,24,122,154,1.2597402597402598,0.04399727866706485,652,Waiting until cheat day is so much harder now.
8844,4205,8,24,122,154,1.2597402597402598,0.04399727866706485,652,We got the only genie who was hard of hearing.
4963,4205,10,20,124,154,1.2597402597402598,0.045886004464919236,652,I say fuck the Jones’s
4830,4205,7,26,121,154,1.2597402597402598,0.043021832739711885,652,This South Beach diet sucks”
4488,4205,10,20,124,154,1.2597402597402598,0.045886004464919236,652,Human flesh is much healthier
4242,4205,8,24,122,154,1.2597402597402598,0.04399727866706485,652,"I'd chance it, but I'm already pre-diabetic."
5004,4205,5,30,119,154,1.2597402597402598,0.04100138066744237,652,The candy isle always looks so good.
5314,4215,5,24,102,131,1.2595419847328244,0.045447841681542034,652,#1 I'm staying here. I just lost 30 lbs!
6548,4215,5,24,102,131,1.2595419847328244,0.045447841681542034,652,I guess we booked the bad ship lollipop
8439,4215,6,22,103,131,1.2595419847328244,0.046722009006535774,652,Nobody ever told me that palm leaves are loaded with THC.
3903,4218,6,29,123,158,1.259493670886076,0.04132410908906316,652,Not having a toothbrush really bugs me.
7122,4218,5,31,122,158,1.259493670886076,0.04033678639804298,652,"Yeah, it may seem like a good idea, but we'll just get a cramp swimming back."
8739,4220,6,23,106,135,1.2592592592592593,0.04578769832807442,652,"I said I wanted to be stuck on a desert island with Candy,not candy."
7350,4220,6,23,106,135,1.2592592592592593,0.04578769832807442,652,With our luck they won't be gluten free.
6456,4220,4,27,104,135,1.2592592592592593,0.04330585040333075,652,"I swear,that's all I think about."
5692,4220,4,27,104,135,1.2592592592592593,0.04330585040333075,652,"Bon Jovi.
I would bring Bon Jovi’s greatest hits. 
Wait what was your question?"
1383,4220,6,30,126,162,1.2592592592592593,0.04065595460513889,652,Talk about bad luck - We end up trapped on a desert island... right next to a DESSERT island.
3143,4220,7,28,127,162,1.2592592592592593,0.04158831423557151,652,What makes you think you’re living on a game board
1951,4220,8,26,128,162,1.2592592592592593,0.042500224905971565,652,It's one of the Calari Islands
1679,4220,8,19,108,135,1.2592592592592593,0.04814176936102199,652,"(This caption is for Feb.11 snake cartoon - due to weather conditions in the U.P., my New Yorker just arrived today)

"" At this point, Mr. Fenner, I'm going to suggest that you switch back to the comfort dog."""
9150,4220,9,24,129,162,1.2592592592592593,0.043392975850472526,652,Not today I'm fasting
3790,4220,5,32,125,162,1.2592592592592593,0.039701705363291234,652,Can you swim?
9210,4230,5,26,108,139,1.2589928057553956,0.043726586145981586,652,"OK, and now I'll make it disappear"
5106,4230,5,26,108,139,1.2589928057553956,0.043726586145981586,652,Now I wish one of us had learned to swim.
7010,4230,6,24,109,139,1.2589928057553956,0.044902992667942086,652,Let's not.  It's bad for our tooth.
9391,4230,3,30,106,139,1.2589928057553956,0.04127330259224871,652,Last one there gets the stupid candy canes.
6333,4230,3,30,106,139,1.2589928057553956,0.04127330259224871,652,Doesn’t faze me. I’m on keto this month.
97,4230,6,24,109,139,1.2589928057553956,0.044902992667942086,652,"Yeah I know, but for a real castaway experience it’s our little island hands down!"
5416,4230,5,26,108,139,1.2589928057553956,0.043726586145981586,652,"Tempting, but I'm on Atkins.."
1631,4230,5,26,108,139,1.2589928057553956,0.043726586145981586,652,Did you remember to bring the diabetes medication?
5566,4230,6,24,109,139,1.2589928057553956,0.044902992667942086,652,"Taking into account the swim and the fast, I think I can finally justify the calories."
1730,4239,6,32,132,170,1.2588235294117647,0.039405504175705416,652,So you're just telling me now that spelling matters ...
5964,4239,7,30,133,170,1.2588235294117647,0.04027911870455726,652,"When, did you say, is our cheat day?"
8885,4239,7,30,133,170,1.2588235294117647,0.04027911870455726,652,The dancing girls should start in about 15 minutes.
9466,4242,8,21,114,143,1.2587412587412588,0.04624508589457801,652,HTTP status 404 error. Re-direct. Load <desert_Island>.
9278,4242,8,21,114,143,1.2587412587412588,0.04624508589457801,652,"You had to spell-check it, didn’t you!"
8687,4242,6,25,112,143,1.2587412587412588,0.044063838426966706,652,We can die here or die later after eating all that sugar.
8469,4242,7,23,113,143,1.2587412587412588,0.0451676312546647,652,I'm never really been a dessert guy.
8050,4242,7,23,113,143,1.2587412587412588,0.0451676312546647,652,We’ll burn off the calories on the swim back
8695,4242,5,27,111,143,1.2587412587412588,0.04293167595934606,652,You have to wait another 30 minutes.
5228,4242,5,27,111,143,1.2587412587412588,0.04293167595934606,652,Wouldn't you know it - I just started my diet.
5104,4242,6,25,112,143,1.2587412587412588,0.044063838426966706,652,"Given the circumstances, I think we should take our chances with diabetes."
4841,4242,5,27,111,143,1.2587412587412588,0.04293167595934606,652,Now I know why the real estate price was cheaper over here.
2006,4242,4,29,110,143,1.2587412587412588,0.041768837001271146,652,"But, I have to carbohydrate load BEFORE I swim."
1717,4242,8,21,114,143,1.2587412587412588,0.04624508589457801,652,I'm not sure yet. Either we're hallucinating or we're being gentrified out of our ocean.
7069,4242,7,23,113,143,1.2587412587412588,0.0451676312546647,652,"Dammit, Steve. I told you it was the island with two S's."
7158,4254,5,20,91,116,1.2586206896551724,0.04916192633304226,652,I'll bet everyone there dreams about having some of our coconut filling.
9906,4254,6,33,135,174,1.2586206896551724,0.03881939401024628,652,Day 202: at least we now have a sweet view
9986,4256,5,28,114,147,1.2585034013605443,0.04217596891968897,652,"Bruh, this honeymoon sucks."
7566,4256,4,30,113,147,1.2585034013605443,0.041056356319077045,652,I hear Amazon pulled out.
7246,4256,6,26,115,147,1.2585034013605443,0.04326661893920212,652,I wonder if any of that is gluten free.
1233,4256,8,22,117,147,1.2585034013605443,0.04536933143282177,652,I told you there was such a thing as a DESSERT island!
1309,4256,4,30,113,147,1.2585034013605443,0.041056356319077045,652,I believe that's the Good Ship Lollipop's port of call.
136,4256,7,24,116,147,1.2585034013605443,0.04433044410499038,652,"Yeah, but they are empty calories."
6027,4256,5,28,114,147,1.2585034013605443,0.04217596891968897,652,Have you ever felt as though you were a pawn in someone elses’s board game?
5841,4263,6,27,118,151,1.2582781456953642,0.04250809678379129,652,"Amazon now delivers by island drone."""
8777,4263,4,31,116,151,1.2582781456953642,0.040377442349399294,652,"It's tempting, but I'm doing keto."
7937,4263,7,25,119,151,1.2582781456953642,0.043534337171142495,652,It's probably just a see food mirage.
7103,4263,5,29,117,151,1.2582781456953642,0.04145645994811443,652,Just keep an eye out for the Good Ship Lollipop.
5615,4263,6,27,118,151,1.2582781456953642,0.04250809678379129,652,'LOST' was never this confusing.
6041,4263,7,25,119,151,1.2582781456953642,0.043534337171142495,652,This diet is gonna kill us.
3751,4263,4,31,116,151,1.2582781456953642,0.040377442349399294,652,At least we won’t have to worry about anyone wanting to eat US.
3652,4263,4,31,116,151,1.2582781456953642,0.040377442349399294,652,"I don't see any shark fins, wanna go for it?"
2297,4263,7,25,119,151,1.2582781456953642,0.043534337171142495,652,And here I thought that Diabetes Island was a only a myth.
1795,4263,3,33,115,151,1.2582781456953642,0.03926878696787707,652,We’re gonna need a dentist.
5545,4263,8,23,120,151,1.2582781456953642,0.04453693673436995,652,"Day 23: Despite recent studies on refined carbohydrates, Dessert Island is starting to look like an almost reasonable alternative"
9950,4274,4,32,119,155,1.2580645161290323,0.039729615770672154,652,"I don’t know, I’m not really a sweets guy..."
8579,4274,7,18,99,124,1.2580645161290323,0.04974491414544795,652,It'd be easier if you imagined kale.
8431,4274,8,24,123,155,1.2580645161290323,0.043744612142876955,652,The original South Beach diet
7409,4274,5,30,120,155,1.2580645161290323,0.04077044946829279,652,"Yeah but, there's really no shade!"
7358,4274,9,22,124,155,1.2580645161290323,0.04469203812864336,652,wish we landed on the desserted island...
3854,4274,8,24,123,155,1.2580645161290323,0.043744612142876955,652,You always were a lousy speller!  Be careful what you wish for—THAT’S a desserted island!!!
1607,4274,5,30,120,155,1.2580645161290323,0.04077044946829279,652,I thought you said you wished for a boat.
1505,4274,5,22,97,124,1.2580645161290323,0.047035048593734724,652,"Huh, candy island. Bummer we don't have life savers to get us there."
721,4274,6,20,98,124,1.2580645161290323,0.04840894689803205,652,"You go right ahead.  The boat sinking almost killed me, and heck if I’ll let heart disease finish the job."
145,4274,4,24,96,124,1.2580645161290323,0.04561979233461597,652,I'm positive I typed 'dessert island.'  Stupid autocorrect!
5421,4274,7,26,122,155,1.2580645161290323,0.04277620729996249,652,"I could easily make the swim, but I'm diabetic."
9232,4285,5,31,123,159,1.2578616352201257,0.040115505230405954,652,You go. I’ve sworn off sweets
8226,4285,9,23,127,159,1.2578616352201257,0.04390557758976369,652,are you saying I'm fat?
4971,4285,6,29,124,159,1.2578616352201257,0.041095805817513,652,Had to correct the captain didn't you: It's pronounced 'Desert' Island.
2310,4285,9,23,127,159,1.2578616352201257,0.04390557758976369,652,Which is the one with two s’s again?
1807,4285,8,25,126,159,1.2578616352201257,0.04298939692052857,652,"I told you before you made your wish, stress the second syllable, the second syllable!"
3692,4285,8,25,126,159,1.2578616352201257,0.04298939692052857,652,You're on a diet too?  What luck.
3667,4291,6,21,101,128,1.2578125,0.04737978694937442,652,It's either a Good Ship Lollipop shipwreck or a Candy Crush mirage.
4394,4291,6,21,101,128,1.2578125,0.04737978694937442,652,Just when I'm trying to cut down on sweets.
6195,4293,5,32,126,163,1.2576687116564418,0.03948942974222289,652,I sure wish I hadn't given up sweets for Lent.
7165,4293,5,32,126,163,1.2576687116564418,0.03948942974222289,652,"It can't be a mirage, because I hate candy canes."
8155,4295,5,24,103,132,1.2575757575757576,0.04514506409940063,652,My physician told me to avoid sweets...that I would live longer. But what do they know?
8454,4295,4,26,102,132,1.2575757575757576,0.04384536910022607,652,"Keep in mind, no artificial flavors or preservatives were added to our island."
320,4297,6,31,130,167,1.2574850299401197,0.0398069722598191,652,"I finally figured out the catch...sand everywhere, and no moist towelettes in sight."
4367,4297,7,29,131,167,1.2574850299401197,0.04070306999953109,652,My hallucinations are defintely sweeter.
4882,4297,8,27,132,167,1.2574850299401197,0.04157986020033555,652,But I did spellcheck the travel request!
5931,4300,8,19,109,136,1.2573529411764706,0.047824483398717685,652,If you weren't such a stickler for spelling we'd be a lot better off.
8211,4300,3,29,104,136,1.2573529411764706,0.04174348934847243,652,"Yeah, but I keep hearing that 'Seems too good to be true'  in my head"
7045,4300,9,17,110,136,1.2573529411764706,0.04895011413906878,652,You up for another game of Candy Land?
6506,4300,8,19,109,136,1.2573529411764706,0.047824483398717685,652,This gluten-free diet is killing me.
5823,4300,6,23,107,136,1.2573529411764706,0.04548973827806604,652,I landed on a chute that dropped me here.  You?
8259,4300,6,23,107,136,1.2573529411764706,0.04548973827806604,652,Don't get your hopes up. 'Could be a dessert island. 'Could be the good ship Lollipop. Either way we're still marooned.
5622,4300,4,27,105,136,1.2573529411764706,0.043028494801232234,652,"Sadly, it's all that's left of the Good Rock Candy Mountain."
69,4300,4,27,105,136,1.2573529411764706,0.043028494801232234,652,"Remember, we're vegan now."
494,4300,3,29,104,136,1.2573529411764706,0.04174348934847243,652,Life...it’s not all sugar and spice...
5738,4300,7,21,108,136,1.2573529411764706,0.04667171252997456,652,"Ohhh, I just got it!"
4763,4300,5,25,106,136,1.2573529411764706,0.04427622191123931,652,"It's real, but I swear every flavor is coconut."
2643,4300,7,21,108,136,1.2573529411764706,0.04667171252997456,652,"No, thanks.  I’m doing low-carbs, no sugar.  But you should go."
3575,4312,7,30,134,171,1.2573099415204678,0.04007147148199086,652,"Hey, that candy island is back."
9841,4313,8,29,138,175,1.2571428571428571,0.040289824989123924,652,"OK, Willy Wonka, what now?"
8015,4313,5,26,109,140,1.2571428571428571,0.043452527605847675,652,It's just another one of their fake views.
5862,4313,5,26,109,140,1.2571428571428571,0.043452527605847675,652,"Too bad we can't swim.""  ""Oh, no, too bad you can't swim."
5684,4313,2,32,106,140,1.2571428571428571,0.03974666510011288,652,"Funny, I had this exact hallucination one week into Keto."
7397,4313,4,28,108,140,1.2571428571428571,0.04225336948005622,652,"Actually, there are no specific guidelines for when your cheat day
should occur."
4586,4313,7,22,111,140,1.2571428571428571,0.04575666073015567,652,We ARE on candy island... the Vikings named that one Salt Island as a deterrent...
2948,4313,2,32,106,140,1.2571428571428571,0.03974666510011288,652,If only we knew how to swim.
1787,4313,6,24,110,140,1.2571428571428571,0.04461946972181272,652,"Just one more ""S"" and we could have been stranded over there instead of here."
5105,4313,6,24,110,140,1.2571428571428571,0.04461946972181272,652,There’s gotta be a shark.
6652,4322,6,25,113,144,1.2569444444444444,0.04379364598089652,652,We lost the butterscotch bridge last year and scientists are predicting that the peppermints may be next.
8994,4322,7,23,114,144,1.2569444444444444,0.04488884633653656,652,Good ship lollipop my butt!
8523,4322,6,25,113,144,1.2569444444444444,0.04379364598089652,652,"The carbs alone will kill you, Tim."
7981,4322,4,29,111,144,1.2569444444444444,0.04151666212558399,652,"Well, they look GMO to me."
7927,4322,7,23,114,144,1.2569444444444444,0.04488884633653656,652,Do you think they have universal healthcare?
7460,4322,5,27,112,144,1.2569444444444444,0.042670344868245405,652,"Should we start swimming or you are still on your ""10 day no carb challenge""?"
9722,4322,9,19,116,144,1.2569444444444444,0.04700275225638798,652,I guess that this truly is a deserted island.
6454,4322,4,29,111,144,1.2569444444444444,0.04151666212558399,652,It’s either the Good Ship Lollipop; or a mirage.
5049,4322,7,23,114,144,1.2569444444444444,0.04488884633653656,652,Guess where I’d be right now if I weren’t diabetic.
6002,4322,3,31,110,144,1.2569444444444444,0.04032999053960716,652,"Don’t worry, they’ll see it."
5988,4322,7,23,114,144,1.2569444444444444,0.04488884633653656,652,You go ahead  - I'm strictly paleo this month.
4636,4322,4,29,111,144,1.2569444444444444,0.04151666212558399,652,I've heard the broker is really sugar-coating the amenities.
1904,4322,4,29,111,144,1.2569444444444444,0.04151666212558399,652,"Don't do it, that stuff will kill you."
1269,4322,8,21,115,144,1.2569444444444444,0.045957954943081275,652,You'll never get your A1C down with hallucinations like that.
1173,4322,6,25,113,144,1.2569444444444444,0.04379364598089652,652,There's fewer calories in the off-season!
6129,4322,6,25,113,144,1.2569444444444444,0.04379364598089652,652,A boy swam over from the other island once. He called himself the Lord of the Pies.
3155,4322,7,23,114,144,1.2569444444444444,0.04488884633653656,652,Do whatever you want... all I see is gluten.
5082,4339,7,24,117,148,1.2567567567567568,0.04406452590931787,652,"Oh, it's all great until Lord Licorice kicks your ass."
9162,4339,7,24,117,148,1.2567567567567568,0.04406452590931787,652,"You go on ahead, I am dieting."
8141,4339,5,28,115,148,1.2567567567567568,0.04192642504314524,652,"Dude, I'm OK with the mirage, but I'm disturbed about the irony of the strawberry on the cake?"
7120,4339,8,22,118,148,1.2567567567567568,0.045095577465758,652,I can't believe the Amazon driver screwed up so badly!
7004,4339,8,22,118,148,1.2567567567567568,0.045095577465758,652,"I think ""gluten free"" is the least of our problems."
6356,4339,9,20,119,148,1.2567567567567568,0.04610357654594072,652,"Pretty sweet, asymmetrically speaking."
4934,4339,4,30,114,148,1.2567567567567568,0.04081539481055208,652,I really wish I'd read Life of Pi.
3262,4339,5,28,115,148,1.2567567567567568,0.04192642504314524,652,"If there were grass,it would be greener."
429,4339,2,34,112,148,1.2567567567567568,0.038497261289951165,652,I couldn't make it past the swedish fish.
947,4339,12,14,122,148,1.2567567567567568,0.04900332397296249,652,"It’s not that I don’t like your fantacy, I’m just saying I can’t swim and I’m diabetic."
4786,4339,5,28,115,148,1.2567567567567568,0.04192642504314524,652,I thought CandyLand  was a game.
1678,4339,8,22,118,148,1.2567567567567568,0.045095577465758,652,I told you we should have waited for a decent mirage to come along and not settled for this dumb tree.
3044,4339,7,24,117,148,1.2567567567567568,0.04406452590931787,652,You swim?
1032,4339,5,28,115,148,1.2567567567567568,0.04192642504314524,652,Unfortunately I’m diabetic
2752,4353,5,29,118,152,1.256578947368421,0.041217856416234246,652,You thinkin' what I'm thinkin'? Sugar high?
4610,4353,7,25,120,152,1.256578947368421,0.04328034702992404,652,A third candy cane would make a more pleasing presentation.
9618,4353,3,33,116,152,1.256578947368421,0.0390465739350836,652,With a whiff of coffee I'd be there in a jiffy
9719,4353,7,25,120,152,1.256578947368421,0.04328034702992404,652,"Well, I guess this means survival of the fattest!"
9919,4353,7,25,120,152,1.256578947368421,0.04328034702992404,652,"In your mirage you see sweets.  In mine, I see a sexy woman."
5704,4353,4,31,117,152,1.256578947368421,0.04014689666473146,652,"No thanks, I don't like to eat sweets before a big meal."
9445,4359,8,24,124,156,1.2564102564102564,0.043494763450623725,652,"Sure am glad we're here, cuz that sh**'ll kill ya"
3293,4359,6,28,122,156,1.2564102564102564,0.04154959056053535,652,"I mean it's technically just one cheat meal, right? Let's go for it."
3617,4359,8,24,124,156,1.2564102564102564,0.043494763450623725,652,My hallucinations are giving me diabetes
3852,4359,6,28,122,156,1.2564102564102564,0.04154959056053535,652,Don’t worry! The Keto hallucinations go away after the first week!
6376,4359,5,20,92,117,1.2564102564102564,0.04879002532739663,652,"I thought I requested a dessert island experience, not a desert island experience, but I put too much trust in my spell checker."
9747,4364,8,25,127,160,1.25625,0.04275025745628459,652,I picked a poor time to start a no-sugar diet.
9229,4364,4,33,123,160,1.25625,0.03889883165049543,652,Forget it ... they don't use raw cacao.
636,4364,7,27,126,160,1.25625,0.041820666665864606,652,"I'm not falling for it, the sugar over there will kill you."
3539,4364,10,21,129,160,1.25625,0.044551287489601604,652,It's a trap! Sugar never saved anyone!
1135,4368,4,23,94,121,1.256198347107438,0.04624900508174865,652,I suppose the main dish might still be coming.
9711,4368,6,19,96,121,1.256198347107438,0.049137079326263634,652,"When they offered ‘desert island’ or ‘dessert island,’ I thought it was Hobson’s choice."
2981,4370,6,30,128,164,1.2560975609756098,0.040220430356588004,652,Too bad we gave up sweets for lent.
5650,4370,6,30,128,164,1.2560975609756098,0.040220430356588004,652,My trainer would kill me .....
9993,4370,8,26,130,164,1.2560975609756098,0.042039462606503646,652,We should weigh the pros and cons before we just up and move.
6803,4373,6,20,99,125,1.256,0.04806447282959729,652,It is low sugar induced mirage ...not a parallel universe
8028,4373,2,28,95,125,1.256,0.04235639876251322,652,It's all for the best anyway. I'm on an Atkins diet.
9152,4373,5,22,98,125,1.256,0.0467029045169846,652,What we call the new South Beach Diet.
9077,4376,3,37,128,168,1.255952380952381,0.03679975310313832,652,But note they don't have coconut.
4989,4376,7,29,132,168,1.255952380952381,0.040489082802291125,652,I wish I listened to my mother and took swimming lessons.
1237,4378,6,21,102,129,1.255813953488372,0.047053529233251866,652,"It's the good ship, Lollipop!"
5776,4378,8,17,104,129,1.255813953488372,0.04956089865327294,652,Dessert has 2 s’s. Why?
7557,4378,4,25,100,129,1.255813953488372,0.044404803245696116,652,Don't you have a dental appointment next week?
9374,4378,4,25,100,129,1.255813953488372,0.044404803245696116,652,How long do think that doughnut will float?
225,4382,8,18,107,133,1.255639097744361,0.04850714578165413,652,"I would, but I just went Keto"
699,4382,5,24,104,133,1.255639097744361,0.044846178122827915,652,The carbs are real.
5385,4382,8,18,107,133,1.255639097744361,0.04850714578165413,652,I wonder if they're vegan.
9578,4382,6,22,105,133,1.255639097744361,0.04609881624051918,652,I’m not sure we need the calories.
7912,4386,7,21,109,137,1.2554744525547445,0.04636785759716212,652,Why couldn't we be stranded on a dessert island instead of a desert island?
7612,4386,8,19,110,137,1.2554744525547445,0.04751126629660043,652,Not even if the ocean were fluoridated.
7958,4386,7,21,109,137,1.2554744525547445,0.04636785759716212,652,It must have been dropped off by the good ship Lollipop.
6685,4386,7,21,109,137,1.2554744525547445,0.04636785759716212,652,"My glucose level might handle the sugar on the island, but swimming through maple syrup is a deal breaker."
4194,4386,6,23,108,137,1.2554744525547445,0.04519553087634805,652,I hear it's being scouted as the location for the next seven seasons of Survivor
6228,4386,5,25,107,137,1.2554744525547445,0.04399197431622221,652,You still on paleo?
5885,4386,9,17,111,137,1.2554744525547445,0.0486277969073477,652,I could be a mirage.  Let's wait 'til he tide goes out and walk over
6503,4386,1,33,103,137,1.2554744525547445,0.03880624919283046,652,"You go ahead, I'm on a sugar-free diet."
95,4394,5,26,110,141,1.2553191489361701,0.043181780792555385,652,I heard whoever wins this survivor challenge gets diabetes.
3582,4394,2,32,107,141,1.2553191489361701,0.03950588341798156,652,"Just my luck, my cheat day was yesterday"
4815,4394,7,22,112,141,1.2553191489361701,0.04546757567326129,652,"Well we have the sweeter view"""
5182,4394,5,26,110,141,1.2553191489361701,0.043181780792555385,652,"But, dude, palm sugar has a lower glycemic index and may make you feel fuller for longer..."
7309,4394,8,20,113,141,1.2553191489361701,0.04656841805556057,652,Do we get a cheat day?
7726,4394,6,24,111,141,1.2553191489361701,0.04433941040440235,652,"I would, but I gave up swimming for Lent."
9450,4394,4,28,109,141,1.2553191489361701,0.04199225011621295,652,"Yeah, but I heard the healtcare insurance over there is very bad."
9981,4401,7,23,115,145,1.2551724137931035,0.044613399299023804,652,This cruise for diabetics was a horrible idea
8956,4401,4,29,112,145,1.2551724137931035,0.04126740935865803,652,This sort of thing always happens on my fast days.
8486,4401,6,25,114,145,1.2551724137931035,0.04352665799715286,652,"Of all the deserted islands I could be on, I'm glad I'm on the one with you."
5148,4401,9,19,117,145,1.2551724137931035,0.04671109373842782,652,Why couldn't we get stuck on the dessert isle?
3445,4401,7,23,115,145,1.2551724137931035,0.044613399299023804,652,The new neighbors have all the luck
3736,4401,4,29,112,145,1.2551724137931035,0.04126740935865803,652,"If we swim over there and eat it, we'll  just crash again in a couple hours."
2664,4401,9,19,117,145,1.2551724137931035,0.04671109373842782,652,Oh no! It's the President's imagination again!
3743,4401,8,21,116,145,1.2551724137931035,0.04567429077311616,652,The ad actually did say “Cruise the Carbibean” but I assumed it was a typo.
8001,4409,9,20,120,149,1.25503355704698,0.045825521845310295,652,Do you think that fish contained hallucinogens ?
9968,4409,6,26,117,149,1.25503355704698,0.04275388038170801,652,It is a mirage. There is no water.
9733,4409,7,24,118,149,1.25503355704698,0.04380170098592749,652,I told you we should have double checked the spelling first.
8988,4409,9,20,120,149,1.25503355704698,0.045825521845310295,652,It must be a niche bakery that caters to the stranded!
8139,4409,4,30,115,149,1.25503355704698,0.040577146826249216,652,"Please, enough about nutritional value."
5794,4409,6,26,117,149,1.25503355704698,0.04275388038170801,652,I should have played more Candyland.
432,4409,6,26,117,149,1.25503355704698,0.04275388038170801,652,Do you think a pun makes it more likely we'll be rescued?
3922,4409,6,26,117,149,1.25503355704698,0.04275388038170801,652,We sure could use the Good Ship Lollipop!
1873,4409,6,26,117,149,1.25503355704698,0.04275388038170801,652,"If that is Temptation Island, then I think I know where we are."
1754,4409,4,30,115,149,1.25503355704698,0.040577146826249216,652,Maybe we could swim over later for dessert.
1653,4409,10,18,121,149,1.25503355704698,0.04680462769814771,652,Dessert Island’s a metaphor for the most insatiable hunger hidden in the darkest corners of our souls. The gumdrops represent cannibalism…namely because they’re made of human flesh. The candy canes are beastiality. It’s pretty fucked up over there.
1022,4409,8,22,119,149,1.25503355704698,0.04482503464391083,652,"I should have known, what with my sweet tooth, that my hallucinations would not involve sex."
4209,4409,5,28,116,149,1.25503355704698,0.04167972608026823,652,"Objects may appear closer than they are, y'know..."
7809,4422,7,25,121,153,1.2549019607843137,0.04302922959626292,652,That must be cheat day island
9845,4422,9,21,123,153,1.2549019607843137,0.044983477229521916,652,"Sweet island, man."
9408,4422,2,35,116,153,1.2549019607843137,0.03770302427684534,652,It's what I like to call island time meets dessert time.
8618,4422,8,23,122,153,1.2549019607843137,0.04401720017962765,652,Looks like the Dylan’s pop-up is finally open.
7896,4422,6,27,120,153,1.2549019607843137,0.04201803526632825,652,"Yes, I can see how, in your weakened state, that seems like Nirvana.
But Marx tells us, that is just an ephemeral representation  of proletariat naivety."
5084,4422,8,23,122,153,1.2549019607843137,0.04401720017962765,652,"I checked, none of them are gluten-free."
442,4422,3,33,117,153,1.2549019607843137,0.03882676076658846,652,"Between the jellyfish and lemon sharks, I'm fine right here."
4480,4422,7,25,121,153,1.2549019607843137,0.04302922959626292,652,This is the most effective diet I've ever done.
1275,4422,5,29,119,153,1.2549019607843137,0.04098189814585094,652,Your parents have a warped sense of humor.
401,4422,6,27,120,153,1.2549019607843137,0.04201803526632825,652,So let it be a lesson to you. Don’t rely on spellcheck.
306,4422,6,27,120,153,1.2549019607843137,0.04201803526632825,652,Looks nice but no one has survived there longer than a few weeks.
84,4422,6,27,120,153,1.2549019607843137,0.04201803526632825,652,Good thing we're vegan.
4649,4422,5,29,119,153,1.2549019607843137,0.04098189814585094,652,It's the Island of Misfit Desserts.
5494,4435,6,28,123,157,1.2547770700636942,0.04131638680094925,652,The Good Ship Lollipop must be on the way.
5788,4435,6,28,123,157,1.2547770700636942,0.04131638680094925,652,That looks like a pretty sweet place.
8002,4435,8,24,125,157,1.2547770700636942,0.04324768725541133,652,"Maybe it’s the dehydration, but have you considered we might be cake toppers on the tropical episode of Bake Wars?"
9939,4435,5,30,122,157,1.2547770700636942,0.040316057606833856,652,They know it's my birthday.
3841,4439,8,25,128,161,1.2546583850931676,0.04251370176061516,652,Are you seeing this too?
7230,4439,9,23,129,161,1.2546583850931676,0.043417215352246255,652,Our exile will end when there’s a new Lord of the Pies.
8728,4439,8,25,128,161,1.2546583850931676,0.04251370176061516,652,Can't swim either. How long do you think before the Uber Boat arrives?
2363,4442,7,28,130,165,1.2545454545454546,0.0409193548756596,652,"Yes, I know, but it's probably inhabited by a cannibalistic old witch."
2639,4442,5,32,128,165,1.2545454545454546,0.03907139546299037,652,We’ve been here too long or not long enough.
9494,4444,6,20,100,126,1.253968253968254,0.04772475040753304,652,Figures they were rescued by the Good Ship Lollipop.
587,4444,6,20,100,126,1.253968253968254,0.04772475040753304,652,I don’t see the Twinkie.
8318,4444,7,18,101,126,1.253968253968254,0.04903708727530064,652,I always thought the Big Rock Candy Mountain would be bigger.
913,4447,6,21,103,130,1.2538461538461538,0.046731625028052344,652,DESERT ISLAND? DESSERT ISLAND? YOU DECIDE.
2729,4447,6,21,103,130,1.2538461538461538,0.046731625028052344,652,I wish those survivors from The Good Ship Lollipop had washed up on our island
3888,4447,5,23,102,130,1.2538461538461538,0.04543769573146975,652,I can never remember which.  Are we stranded on the desert or the dessert island?
4513,4447,2,29,99,130,1.2538461538461538,0.04131346560451004,652,"Eat healthy"" they said,""dude,Diabetes Island looks so much more fun to me"
5230,4447,6,21,103,130,1.2538461538461538,0.046731625028052344,652,I’m holding onto a few things while I figure out if they spark joy or not.
5510,4447,7,19,104,130,1.2538461538461538,0.04799067995079202,652,"You just had to tell the travel agent you were gluten free, didn't you?"
5535,4447,9,15,106,130,1.2538461538461538,0.05041454681828528,652,Don't worry... I'm a dentist.
8460,4447,5,23,102,130,1.2538461538461538,0.04543769573146975,652,I spy something sweet.
9857,4447,6,21,103,130,1.2538461538461538,0.046731625028052344,652,"If you were on a dessert-ed island, what would you eat first?"
5573,4456,6,22,106,134,1.2537313432835822,0.04579325782901285,652,"Damn auto-correct—I thought I’d booked the package with the “dessert island,” but no buffet for us."
9997,4456,5,24,105,134,1.2537313432835822,0.04455111235379425,652,"Does that make this a palm treed island, then?"
9394,4456,2,30,102,134,1.2537313432835822,0.040597278973574756,652,What a difference one little ‘s’ makes ...
4275,4456,7,20,107,134,1.2537313432835822,0.04700258836732817,652,"If that thing is due to a spelling error, then maybe the universe really is a simulation."
3840,4456,5,24,105,134,1.2537313432835822,0.04455111235379425,652,Just my luck to have a salty tooth.
3453,4456,5,24,105,134,1.2537313432835822,0.04455111235379425,652,Maybe we'll get lucky and those processed foods will kill us.
2807,4456,5,24,105,134,1.2537313432835822,0.04455111235379425,652,"I think we better not go there, our health plan doesn't cover dental."
1747,4456,6,22,106,134,1.2537313432835822,0.04579325782901285,652,Just remember  we chose  the  nuts
939,4456,3,28,103,134,1.2537313432835822,0.041956643224789834,652,Maybe it was a mistake to go paleo.
7585,4465,6,23,109,138,1.2536231884057971,0.044905008291859914,652,"Hey, these hallucinations are pretty sweet."
6741,4465,11,13,114,138,1.2536231884057971,0.05045188186457454,652,"Damn, Sammy Davis Jr. singing the Candyman is going to be in my head all day."
5569,4465,6,23,109,138,1.2536231884057971,0.044905008291859914,652,I’m switching to the North Beach diet.
5355,4465,7,21,110,138,1.2536231884057971,0.046067844452383516,652,It’s not worth the calories.
5326,4465,6,23,109,138,1.2536231884057971,0.044905008291859914,652,Makes me kinda sorry we're vegan.
7777,4465,4,27,107,138,1.2536231884057971,0.042483958432542705,652,"So, Candy Land is real!"
3939,4465,5,25,108,138,1.2536231884057971,0.04371124851677211,652,So you’re type 1 too?
3720,4465,9,17,112,138,1.2536231884057971,0.04830961951912884,652,"A lot of difference between a “Dessert Island” and
a  “Deserted Island” !!!"
3490,4465,4,27,107,138,1.2536231884057971,0.042483958432542705,652,"Nah, let‘s wait for the cheese island to swim by. I‘m on a sugar-free diet."
1940,4465,8,19,111,138,1.2536231884057971,0.04720204249061685,652,I don't know. My doctor says too much sugar will kill me.
1648,4465,4,27,107,138,1.2536231884057971,0.042483958432542705,652,"The mermaids I could take, but this is really beyond the pale."
4999,4465,7,21,110,138,1.2536231884057971,0.046067844452383516,652,It's too bad we gave up candy for lent.
9363,4477,7,22,113,142,1.2535211267605635,0.045182036405808805,652,Look on the bright side.  At least we don't have to worry about dental decay!
7930,4477,7,22,113,142,1.2535211267605635,0.045182036405808805,652,I'll understand. But please don't try to come back.
6389,4477,6,24,112,142,1.2535211267605635,0.04406275403227522,652,That much sugar can’t be good for you anyway.
6276,4477,10,16,116,142,1.2535211267605635,0.0483847783541164,652,"Poor spelling aside, let's swim over to the desserted  island."
5103,4477,3,30,109,142,1.2535211267605635,0.04051982144960226,652,"Diabetes sucks, man!"
2862,4477,4,28,110,142,1.2535211267605635,0.041734231167887756,652,I'm telling you! They just have a REALLY good marketing department!
2545,4477,5,26,111,142,1.2535211267605635,0.042914288669879404,652,Well. There's only one way to find out for sure.
403,4477,5,26,111,142,1.2535211267605635,0.042914288669879404,652,"It's the Good Ship Lollipop, which means we're not lost Stan, we're on the sunny beach of Peppermint Bay"
5024,4477,5,26,111,142,1.2535211267605635,0.042914288669879404,652,but we have coconuts!
6417,4486,7,23,116,146,1.2534246575342465,0.04434123257792524,652,"If only we'd been shippwrecked, we could've ended up on a dessert island instead."
8987,4486,4,29,113,146,1.2534246575342465,0.04102103085809737,652,There's only one 's' in deserted.
8270,4486,9,19,118,146,1.2534246575342465,0.046422963381378184,652,"No, you can't sing The Good Ship Lollipop just one more time"
8049,4486,8,21,117,146,1.2534246575342465,0.04539403284374742,652,Tell me you’re not a dentist
7222,4486,6,25,115,146,1.2534246575342465,0.04326282001025936,652,Did we miss the Good Ship Lollipop?
6893,4486,5,27,114,146,1.2534246575342465,0.04215682962404238,652,Where's the good ship Lollypop?
6241,4486,7,23,116,146,1.2534246575342465,0.04434123257792524,652,Stupid auto correct. I typed dessert not desert.
6373,4486,9,19,118,146,1.2534246575342465,0.046422963381378184,652,You didn't finish your dinner.
5689,4486,6,25,115,146,1.2534246575342465,0.04326282001025936,652,I really shouldn't. I didn't finish my dinner!
5202,4486,5,27,114,146,1.2534246575342465,0.04215682962404238,652,"Now why couldn't we have been stranded on that ""desserted"" island?"
2292,4486,6,25,115,146,1.2534246575342465,0.04326282001025936,652,"So there it is, Christmas Island!"
2004,4486,10,17,119,146,1.2534246575342465,0.04742957769576217,652,"Well that finally proves it. When I was little, I really did know how to spell dessert island."
1028,4486,5,27,114,146,1.2534246575342465,0.04215682962404238,652,The good news is it's zero calorie... The bad news is it's a mirage.
706,4486,5,27,114,146,1.2534246575342465,0.04215682962404238,652,Water water everywhere and not a drop of milk.
334,4486,8,21,117,146,1.2534246575342465,0.04539403284374742,652,If only we had insulin!
5910,4486,5,27,114,146,1.2534246575342465,0.04215682962404238,652,Dessert for the Deserted.
9831,4502,5,28,117,150,1.2533333333333334,0.041435825874730124,652,Either its a mirage or we should learn to swim
9442,4502,9,20,121,150,1.2533333333333334,0.04555073545369884,652,"But hold on
It may spoil our appetite"
8920,4502,5,28,117,150,1.2533333333333334,0.041435825874730124,652,It's either a mirage or the Good Ship Lollypop capsized.
8635,4502,9,20,121,150,1.2533333333333334,0.04555073545369884,652,"Gotta be careful with genies. I asked for my own island, they asked for the sweet life."
8538,4502,7,24,119,150,1.2533333333333334,0.043541917540996115,652,I only hang on to fantasies that spark joy.
7696,4502,2,34,114,150,1.2533333333333334,0.0380587872912686,652,"I don't remember seeing Main Course Island, do you?"
7442,4502,7,24,119,150,1.2533333333333334,0.043541917540996115,652,Admit it. It’s better the the shark mirage.
7993,4502,8,22,120,150,1.2533333333333334,0.044557648521436594,652,"Just our luck to miss the ""Dessert Isle!"""
6603,4502,7,24,119,150,1.2533333333333334,0.043541917540996115,652,"We need to keep our bodies in beach shape, Bro."
6563,4502,6,26,118,150,1.2533333333333334,0.042501919068836526,652,What do you think? Hallucination or alien spaceship?
6377,4502,10,18,122,150,1.2533333333333334,0.046522628461704865,652,"No, no, it’s all you man. I’m on Keto."
4966,4502,4,30,116,150,1.2533333333333334,0.040341569222180476,652,I'm sorry. I only played Chutes and Ladders as a kid.
4000,4502,4,30,116,150,1.2533333333333334,0.040341569222180476,652,"Sure, we could make it, but think of the calories!"
3424,4502,7,24,119,150,1.2533333333333334,0.043541917540996115,652,That's how we get drawn into the water.
244,4502,8,22,120,150,1.2533333333333334,0.044557648521436594,652,But what if it's coconut?
7146,4502,4,30,116,150,1.2533333333333334,0.040341569222180476,652,Should we wait for the Good Ship Lollipop or chance it in Peppermint Bay?
9582,4518,7,25,122,154,1.2532467532467533,0.042780938132409324,652,"Yes, But think of our dental health!"
9570,4518,7,25,122,154,1.2532467532467533,0.042780938132409324,652,"I never realized sharks are so creative."""
9511,4518,6,27,121,154,1.2532467532467533,0.041777101738457396,652,I know what you think. But I'm quite sure this one had the far better yelp rating.
8981,4518,10,19,125,154,1.2532467532467533,0.04566022318123157,652,"And to think, the only thing that we have to eat are mushrooms."
5765,4518,8,23,123,154,1.2532467532467533,0.043761753910379876,652,- What if they're not vegan?
4019,4518,5,29,120,154,1.2532467532467533,0.04074854343214989,652,"Wow, life really does get sweeter ahead"
4286,4518,8,23,123,154,1.2532467532467533,0.043761753910379876,652,That is the mirage that appears when I am on a diet.
1610,4518,7,25,122,154,1.2532467532467533,0.042780938132409324,652,And you're SURE today is Yom Kippur?
1098,4518,6,27,121,154,1.2532467532467533,0.041777101738457396,652,They don't call this 'the Carbbean Sea' for nothing.
4579,4518,7,25,122,154,1.2532467532467533,0.042780938132409324,652,"Maybe it's a hallucination in the form of an ironic homophone, but it's worth a swim to check it out."
9384,4528,4,32,122,158,1.2531645569620253,0.03907409061031696,652,I knew this carb free diet would never last.
9957,4528,6,28,124,158,1.2531645569620253,0.04108571366290423,652,And we're here stuck on a deserted island.
8644,4528,6,28,124,158,1.2531645569620253,0.04108571366290423,652,It's a mirage let's eat the whole thing; there's no calories.
2038,4528,3,34,121,158,1.2531645569620253,0.038028395994832764,652,I’d go for it but I’m gluten free.
5127,4528,5,30,123,158,1.2531645569620253,0.040092520650449354,652,This view is not helping me with this fast.
3782,4528,6,28,124,158,1.2531645569620253,0.04108571366290423,652,Why did we sign up for the damn Wellness Retreat?
7627,4528,6,28,124,158,1.2531645569620253,0.04108571366290423,652,I left my toothbrush at home.
5055,4535,5,31,126,162,1.2530864197530864,0.03946553484613882,652,I hate this diet!
5587,4535,6,29,127,162,1.2530864197530864,0.040425359327943194,652,I think I'd rather be on a dessert island than a desert island.
6362,4535,8,25,129,162,1.2530864197530864,0.042279689556527916,652,"Tank, can we get a spellcheck on 'desert island'?"
9259,4535,7,27,128,162,1.2530864197530864,0.041362917122645615,652,I could never live there.  No protein.
7950,4539,6,30,130,166,1.2530120481927711,0.039793871028663635,652,They’re tough to swallow but once they kick in they’re the best mushrooms on the island!
8726,4540,5,20,94,119,1.2521008403361344,0.0480624258685221,652,"If your spelling wasn't so bad, we could be marooned on a dessert island like that one over there."
550,4540,3,24,92,119,1.2521008403361344,0.04500152301614558,652,"Candy is dandy, but a cruise ship would be quicker..."
3794,4540,5,20,94,119,1.2521008403361344,0.0480624258685221,652,Now I wish I took those swimming lessons
6848,4543,5,21,97,123,1.2520325203252032,0.04702745466282882,652,Think about what you’ll leave behind.
8933,4543,4,23,96,123,1.2520325203252032,0.04558839184199874,652,No question you can get there.  But I will bet on if you can make it back.
5883,4545,6,20,101,127,1.2519685039370079,0.047389685263170035,652,"Yeah, I try to steer clear of anything with palm oil."
9431,4545,5,22,100,127,1.2519685039370079,0.046052121475448175,652,Maybe we shouldn’t have marketed it as a desserted island.
6105,4545,8,16,103,127,1.2519685039370079,0.04995749216331898,652,"Now that's a ""desserted"" island I could really enjoy!"
2656,4545,7,18,102,127,1.2519685039370079,0.048690519059619776,652,I don't do gluten or refined sugar; I had a bad experience with my sister Gretel when we were growing up.
1743,4545,4,24,99,127,1.2519685039370079,0.04467452870973071,652,I hear that UBER is working on an island-to-island delivery app.
2289,4545,7,18,102,127,1.2519685039370079,0.048690519059619776,652,"I would, but I’m Paleo."
365,4545,5,22,100,127,1.2519685039370079,0.046052121475448175,652,My mirage is a little more whimsical.
2539,4545,6,20,101,127,1.2519685039370079,0.047389685263170035,652,Do you think there are any women on that island?
80,4553,6,21,104,131,1.251908396946565,0.046413990756227416,652,At least we have each other.
400,4553,4,25,102,131,1.251908396946565,0.043810716882134705,652,I think I hear Shirley Temple singing.
2754,4553,1,31,99,131,1.251908396946565,0.039586102074309626,652,"Ok, I’ll have the pretend cupcake, what will you have?"
5442,4553,2,29,100,131,1.251908396946565,0.04104265207724717,652,"The brochure said 'All you can eat desserts and bar.'"" 
""I think you misread it."
7616,4553,6,21,104,131,1.251908396946565,0.046413990756227416,652,Diabetic.  You?
9188,4553,3,27,101,131,1.251908396946565,0.042449253251738865,652,Dang it. I just cut out sugar.
6933,4559,8,18,109,135,1.2518518518518518,0.04786026107552733,652,The candy always seems sweeter on the other deserted island
7284,4559,6,22,107,135,1.2518518518518518,0.04549162506649493,652,Your text said we were going to the DESSERT island.
5986,4559,7,20,108,135,1.2518518518518518,0.046690965621885495,652,You go ahead. I have a gluten allergy.
3801,4559,6,22,107,135,1.2518518518518518,0.04549162506649493,652,Of all weeks to start a gluten free diet!
1842,4559,8,18,109,135,1.2518518518518518,0.04786026107552733,652,No I don't get the pun. Why don't you explain it to me again?
1579,4559,4,26,105,135,1.2518518518518518,0.042992689054808644,652,That's the real reason why fish wanted to walk on land.
9118,4565,5,25,109,139,1.2517985611510791,0.043433982204254526,652,But no!  You had to be worried about  your dental work!
7850,4565,6,23,110,139,1.2517985611510791,0.04461810422546896,652,Where else would you rather be?
7621,4565,9,17,113,139,1.2517985611510791,0.04799550466804937,652,Pity you're a gluten free diabetic who can't swim.
5855,4565,6,23,110,139,1.2517985611510791,0.04461810422546896,652,We better hurry.  They're going to build a fence.
6299,4565,5,25,109,139,1.2517985611510791,0.043433982204254526,652,It was on Fixer Upper.
3464,4565,4,27,108,139,1.2517985611510791,0.042216660165913016,652,You still doing keto?
2866,4565,6,23,110,139,1.2517985611510791,0.04461810422546896,652,Fantasy Island.
1483,4565,6,23,110,139,1.2517985611510791,0.04461810422546896,652,"And all this time we thought it was ""The Big Rock Candy Mountain""..."
19,4565,9,17,113,139,1.2517985611510791,0.04799550466804937,652,And just beyond that is an island with a stereo and ten records.
5748,4565,7,21,111,139,1.2517985611510791,0.045771602978594964,652,"Well, We can't go until we find the dinner island first!"
3750,4575,7,22,114,143,1.2517482517482517,0.044899980190093225,652,Funny thing—ever since I became a pescatarian sweets just don’t appeal to me.
9292,4575,6,24,113,143,1.2517482517482517,0.04378944124821906,652,I guess God doesn't use spell check
6708,4575,8,20,115,143,1.2517482517482517,0.04598370665040281,652,And we had to book the deserted isle...
6679,4575,5,26,112,143,1.2517482517482517,0.04264999541139124,652,It's a stop on the Cruise Ship 'Lollipop.'
4226,4575,6,24,113,143,1.2517482517482517,0.04378944124821906,652,"If only I weren't on the Atkins diet, I would swim over."
3679,4575,4,28,111,143,1.2517482517482517,0.041479260508742906,652,"On the bright side, we’ll burn off all those calories."
2148,4575,7,22,114,143,1.2517482517482517,0.044899980190093225,652,This is a desert island. That's a dessert deception.
3103,4575,7,22,114,143,1.2517482517482517,0.044899980190093225,652,This reminds me of how my parents couldn't afford to take us kids to Disney World.
2889,4575,5,26,112,143,1.2517482517482517,0.04264999541139124,652,Remind me to make a dental appointment
1981,4575,9,18,116,143,1.2517482517482517,0.047042473718436985,652,We need the Good  Ship Lollipop
1428,4575,4,28,111,143,1.2517482517482517,0.041479260508742906,652,"If you're really concerned about the calories...How about afterwards, we go for a nice swim."
3502,4575,9,18,116,143,1.2517482517482517,0.047042473718436985,652,"I'm sorry Kent, the Weight Watchers membership was a cruel anniversary gift."
7253,4587,8,21,118,147,1.251700680272109,0.04511712195395935,652,"One more ""s"" and we'd be there."
8466,4587,10,17,120,147,1.251700680272109,0.04713735900153452,652,"Tomato, tomato."
7795,4587,6,25,116,147,1.251700680272109,0.0430020787076315,652,Now that's what I call a mirage.
7552,4587,8,21,118,147,1.251700680272109,0.04511712195395935,652,I heard that Mexico will pay for it.
6646,4587,6,25,116,147,1.251700680272109,0.0430020787076315,652,Unfortunately it's refined sugar
9359,4587,8,21,118,147,1.251700680272109,0.04511712195395935,652,"Sorry, I could never remember whether it was ""s"" or double ""s""."
4800,4587,5,27,115,147,1.251700680272109,0.04190454406221098,652,Here it comes again.
3261,4587,7,23,117,147,1.251700680272109,0.044072289857606535,652,"I mean, it is greener."
2703,4587,7,23,117,147,1.251700680272109,0.044072289857606535,652,"The Big Rock Candy Mountain was cool, before climate change"""
1886,4587,5,27,115,147,1.251700680272109,0.04190454406221098,652,We'll burn the calories right off.
415,4587,6,25,116,147,1.251700680272109,0.0430020787076315,652,Don’t mess with a confectioner shark.”
4991,4587,10,17,120,147,1.251700680272109,0.04713735900153452,652,"Well, if you wanted a ‘desserted’ island, you should’ve spelled it with two ‘s’es."
9592,4599,8,22,121,151,1.2516556291390728,0.04429336582095581,652,"Wouldn't you know it.  Help finally arrives, and I'm diabetic."
8500,4599,5,28,118,151,1.2516556291390728,0.04119467918915452,652,it’s not exactly the big rock candy mountain
6343,4599,8,22,121,151,1.2516556291390728,0.04429336582095581,652,"Sure, we could swim for it but we don’t want to ruin our appetite for when we’re rescued."
3205,4599,5,28,118,151,1.2516556291390728,0.04119467918915452,652,Now this Wonka fella is just being spiteful.
2988,4599,7,24,120,151,1.2516556291390728,0.043285124869849506,652,probably not gluten-free anyway......
1459,4599,5,28,118,151,1.2516556291390728,0.04119467918915452,652,"Desert, dessert--you could spell it either way."
3476,4599,5,28,118,151,1.2516556291390728,0.04119467918915452,652,I guess we picked a bad time to go paleo.
6021,4606,5,29,121,155,1.2516129032258065,0.04051775137575749,652,"‘Enticing, yes, but we don’t have dental coverage.’"
9554,4606,6,27,122,155,1.2516129032258065,0.04153884154750915,652,We haven’t been out here long enough if that’s the best mirage we can conjure up.
7019,4606,9,21,125,155,1.2516129032258065,0.04446163400948276,652,It's probably all high fructose corn syrup anyway.
4092,4606,7,25,123,155,1.2516129032258065,0.04253542685421702,652,We had to discover the diet island.
717,4606,5,29,121,155,1.2516129032258065,0.04051775137575749,652,I think that island was booked by the more expensive cruise line.
3816,4606,7,25,123,155,1.2516129032258065,0.04253542685421702,652,Let's just stay over here...sugar makes me bloat.
1107,4606,4,31,120,155,1.2516129032258065,0.039470254572099274,652,"You go ahead, I'm doing Keto."
3896,4606,12,15,128,155,1.2516129032258065,0.04720379688623911,652,It's life's illusions I recall....
4654,4614,8,24,127,159,1.251572327044025,0.04276167559322021,652,Let’s swim over to that desserted island.
5795,4614,8,24,127,159,1.251572327044025,0.04276167559322021,652,You're the one who chose the no carb option.
8387,4614,10,20,129,159,1.251572327044025,0.044584570103790626,652,Ignore it. Its a corn syrup ad; Mirage.com is monetizing their streaming content
5318,4617,9,23,131,163,1.2515337423312884,0.042939374909403194,652,"I know there’s a wicked witch in there, somewhere."
9390,4617,10,21,132,163,1.2515337423312884,0.04381244434688865,652,So where’s the good ship Lollipop?
5140,4617,7,27,129,163,1.2515337423312884,0.04113768580672014,652,I wonder what they think of us
1338,4617,8,25,130,163,1.2515337423312884,0.04204818135866704,652,"Only if 
We could 
Build 
A
Wall"
1213,4617,8,25,130,163,1.2515337423312884,0.04204818135866704,652,I hate my mother for making me learn to spell.
4260,4617,4,33,126,163,1.2515337423312884,0.03827646936977903,652,So near and yet so far...
2174,4623,7,29,135,171,1.2514619883040936,0.03986006417835845,652,I ordered it from Amazon. How do you like it?
6938,4624,7,22,115,144,1.25,0.044621345688633046,652,I told you about climate change!
6610,4624,6,23,111,140,1.25,0.044334753871226124,652,Candy is dandy but liquor would really be a whole lot quicker !
6598,4624,6,23,111,140,1.25,0.044334753871226124,652,Looks like they want to surprise us.
6547,4624,9,20,123,152,1.25,0.04501074578332069,652,I told you low carb would be hard
6458,4624,4,22,94,120,1.25,0.04621530419392146,652,Oh to live on Sugar Mountain!
6450,4624,8,22,122,152,1.25,0.04403213440466003,652,And I had to pick this week to go off sweets.
6447,4624,7,16,97,120,1.25,0.05055712025979709,652,Don't fall for it.  It is not a desserted island.
6305,4624,5,25,110,140,1.25,0.04316011443339083,652,And you said spelling didn't matter
6119,4624,7,21,112,140,1.25,0.04547906467530975,652,They were salvaged from the Good Ship Lollipop before it sank.
5733,4624,4,28,112,144,1.25,0.041227287076512804,652,Nah. . .I'm waiting for filet mignon and a bottle of Pommard.
5691,4624,7,20,109,136,1.25,0.04638336040008698,652,The candy is always sweeter on the other island...
5514,4624,4,26,106,136,1.25,0.042715556140397404,652,"You go ahead, for some reason my dignity still matters."
4722,4624,6,27,123,156,1.25,0.04130321216307024,652,I always preferred Chutes and Ladders.
5478,4624,8,19,113,140,1.25,0.046595281377622505,652,Your obsession with Candy Crush is becoming a serious issue.
5166,4624,4,30,118,152,1.25,0.03987825669794682,652,I thought it was a little under priced for a Desserted Island.
4922,4624,8,23,125,156,1.25,0.04325946493965428,652,I hope it's the good ship Lollipop and not just a hallucination!
4889,4624,7,20,109,136,1.25,0.04638336040008698,652,"What, and risk diabetes."
4757,4624,4,31,121,156,1.25,0.03924957787174288,652,Climate change at the Big Rock Candy Mountains
6106,4624,2,27,95,124,1.25,0.042268793820328485,652,I think it will drive down property values.
7345,4624,11,16,125,152,1.25,0.04690675844110392,652,You can go. I have diabetes...
9715,4624,9,19,120,148,1.25,0.045857040618608895,652,I finally got Candy Crush to download.
7437,4624,7,23,118,148,1.25,0.04380651604022256,652,The brochure promised we will lose weight faster here.
4719,4624,5,29,122,156,1.25,0.0402894818662241,652,"Amazingly, there isn't a shred of coconut on their island."""
9920,4624,6,26,120,152,1.25,0.04200657220898526,652,I should have used spell checker for my wish list
9900,4624,9,19,120,148,1.25,0.045857040618608895,652,The calories alone will kill us
9839,4624,6,21,105,132,1.25,0.046100544855210326,652,I’m simply saying that our vision for the future shouldn’t be as consumerist and materialist as previous generations’...
9832,4624,9,15,108,132,1.25,0.049721640147515817,652,"Sucks for us, Roy, but I guarantee there will be songs written about the Wreck of the Good Ship Lollipop."
9783,4624,6,22,108,136,1.25,0.0451938453788867,652,''Looks like another unidentified frosted object.''
9635,4624,6,28,126,160,1.25,0.04063180276860005,652,"No, it's actually spelled differently."
9949,4624,5,20,95,120,1.25,0.04770650232563333,652,Do you think the cupcake is gluten free?
7352,4624,6,26,120,152,1.25,0.04200657220898526,652,Are you thinking what I'm thinking?
9407,4624,9,19,120,148,1.25,0.045857040618608895,652,"Last time I play Candy Land while watching ""Black Mirror""!"
9029,4624,9,14,105,128,1.25,0.050829729660139204,652,"Don’t be envious. After a while on a dessert island, the days grow stale."
8975,4624,5,26,113,144,1.25,0.04238884637277,652,"I can't, I'm doing a juice-cleanse."
8914,4624,6,23,111,140,1.25,0.044334753871226124,652,How did we miss the Good Ship Lollypop?!
8909,4624,8,23,125,156,1.25,0.04325946493965428,652,I'd been hoping for the Big Rock Candy Mountain.
8619,4624,2,31,107,140,1.25,0.03942677655029597,652,"No thanks, it would go right to my thighs."
8556,4624,5,26,113,144,1.25,0.04238884637277,652,First one there gets the strawberry!
8394,4624,4,29,115,148,1.25,0.040536709998599686,652,I'll bet $10 it's a mirage; but you'll have to swim over there to prove I'm wrong.
8249,4624,4,23,97,124,1.25,0.04526490492808352,652,They're as scared of us as we are of them.
9251,4624,8,21,119,148,1.25,0.044843500208385956,652,"The thing I miss most, really, is Candy Crush."
4554,4624,5,20,95,120,1.25,0.04770650232563333,652,What if we swim there and it’s actually all gluten free?
9558,4624,5,26,113,144,1.25,0.04238884637277,652,"No , you go ahead. I’m off carbs this week."
4438,4624,7,24,121,152,1.25,0.043031273331024834,652,"Awww, that's sweet."
2102,4624,6,17,93,116,1.25,0.05029895632611329,652,Meh... Even the candy canes are coconut.
2035,4624,7,23,118,148,1.25,0.04380651604022256,652,You go ahead.  I'm watching my figure.
2026,4624,4,27,109,140,1.25,0.04195259890620108,652,"OK, let's do it again. 
This time we'll add in the Mermaids."
1841,4624,4,27,109,140,1.25,0.04195259890620108,652,If only we had a Chute or a Ladder...
1432,4624,6,22,108,136,1.25,0.0451938453788867,652,"All-inclusive should include us, Fred."
1368,4624,4,24,100,128,1.25,0.044367825470805686,652,"Dude, it gets sweeter when you squint!"
1346,4624,4,28,112,144,1.25,0.041227287076512804,652,It’s a good thing we landed on Gumdrop Mountain before global warming flooded Candyland!
1301,4624,8,24,128,160,1.25,0.04252265396972455,652,It's called Stevia island.  It's just a mirage.
2153,4624,5,28,119,152,1.25,0.040956241685584586,652,Well Pat- we can either eat sweet ...or die tryin'
1264,4624,5,23,104,132,1.25,0.04482856025954131,652,Kick back and enjoy the mirage.
1110,4624,7,20,109,136,1.25,0.04638336040008698,652,"As long as its a delusion, I'd rather wait until we spot Asparagus Island!"
1067,4624,5,23,104,132,1.25,0.04482856025954131,652,"Nothing over there is vegan, dude."
1024,4624,6,22,108,136,1.25,0.0451938453788867,652,"Now, don't you wish you had taken those swimming lessons?"
994,4624,11,17,128,156,1.25,0.046038247845476866,652,Damn one-percenters.
757,4624,8,15,101,124,1.25,0.050729015290999296,652,That's deserted island...one S
474,4624,4,29,115,148,1.25,0.040536709998599686,652,"""With our luck, there'll be veggies on the other side."""
428,4624,7,23,118,148,1.25,0.04380651604022256,652,It's just as well. They're probably not gluten free.
378,4624,7,26,127,160,1.25,0.041587976007827945,652,My dentist would get a kick out of this.
1114,4624,8,21,119,148,1.25,0.044843500208385956,652,Counter-point: I bet they don't have any dentists.
4548,4624,8,26,134,168,1.25,0.041146597507639195,652,"None for me, thanks. I'm on the keto diet."
2187,4624,6,24,114,144,1.25,0.04351941398892446,652,And neither of us can swim!
2356,4624,7,25,124,156,1.25,0.04229265090918735,652,It’s not worth the empty calories.
4431,4624,7,16,97,120,1.25,0.05055712025979709,652,I'm beginning to think maybe we're not in the Mediterranean after all.
4391,4624,8,17,107,132,1.25,0.04854462975402247,652,"Yeah, so what do you think, dude - does 'random candy island' go in the 'we're probably in heaven' or the 'we're probably in hell' column?"
4351,4624,6,28,126,160,1.25,0.04063180276860005,652,"What, and risk dying from cavities and tooth decay?  No thanks."
4053,4624,5,23,104,132,1.25,0.04482856025954131,652,I knew we should’ve gone to Stormi’s party instead of Fyre Festival.
3901,4624,4,25,103,132,1.25,0.04351941398892446,652,They’re empty calories.
3863,4624,6,27,123,156,1.25,0.04130321216307024,652,I know it's tempting but it'll totally ruin my diet.
3506,4624,5,28,119,152,1.25,0.040956241685584586,652,The grass isn't always greener. Sometimes it's cake.
3350,4624,8,21,119,148,1.25,0.044843500208385956,652,Their theme was better than ours.
2243,4624,5,23,104,132,1.25,0.04482856025954131,652,"…yeah, but we have all seven Harry Potter books."
3320,4624,5,29,122,156,1.25,0.0402894818662241,652,Yea ... But do they have cocoanuts !
3238,4624,7,24,121,152,1.25,0.043031273331024834,652,Forget about a desert oasis- I’ll take a dessert oasis any day!
3104,4624,6,26,120,152,1.25,0.04200657220898526,652,That's not the Floating Island I ordered. And where's my espresso?
3066,4624,5,23,104,132,1.25,0.04482856025954131,652,So what I’m basically hearing is that that wasn’t chocolate we just ate.
2954,4624,9,20,123,152,1.25,0.04501074578332069,652,Be honest. Do you really like it here as much as at your mom's?
2911,4624,7,19,106,132,1.25,0.0473383634798584,652,Don't get excited--it's not The Good Ship Lollipop.
2820,4624,4,27,109,140,1.25,0.04195259890620108,652,You go ahead. I’m watching my carbs.
2412,4624,8,22,122,152,1.25,0.04403213440466003,652,I guess I forgot to add the 's'  when I was making my wish.
2400,4624,6,30,132,168,1.25,0.039376014115146754,652,I'm not sure giving up carbs was the right decision.
3284,4624,4,25,103,132,1.25,0.04351941398892446,652,How fortunate our shipwreck took place in the Straits of Diabetes.
8651,4709,3,37,133,173,1.2485549132947977,0.035882353739189875,652,"So you think the island is deserted. Is that with one ""s"" or two?"
9219,4709,9,25,139,173,1.2485549132947977,0.04111962208749598,652,"I thought ""deserted island"" wouldn't be so literal."
7027,4709,7,29,137,173,1.2485549132947977,0.039451193269242305,652,I’’ll wait here. I’m on a low carb diet.
1261,4712,8,25,132,165,1.2484848484848485,0.041592522892181356,652,"Sugar free or no gluten?  Oh, that's right... neither of us can swim."
2134,4712,3,35,127,165,1.2484848484848485,0.03688344900493547,652,Swim over if you want. I'm trying to cut down on my sugar intake.
697,4714,4,32,125,161,1.2484472049689441,0.03843912657581565,652,It came unstuck from a Disney theme park and it's all plastic.
537,4715,2,35,120,157,1.2484076433121019,0.036879828502872344,652,"OK, so it's not a mountain. But the part about ""the sun shines every day"" was true."
882,4715,7,25,125,157,1.2484076433121019,0.04205256635500158,652,Think there's any salt-water taffy there?
3280,4715,5,29,123,157,1.2484076433121019,0.040063695565756244,652,You go ahead. I'm not doing carbs right now.
7932,4715,6,27,124,157,1.2484076433121019,0.04107017189778616,652,I hope the clown arrives before the guests.
2434,4719,5,28,120,153,1.2483660130718954,0.04072046990626665,652,Seems like a lot of empty calories anyway.
9750,4719,6,26,121,153,1.2483660130718954,0.04176309353236026,652,That’s known as the hallucination diet.
2323,4719,5,28,120,153,1.2483660130718954,0.04072046990626665,652,"True enough, but palm oil has numerous negative environmental consequences."
7832,4722,4,29,116,149,1.2483221476510067,0.04029867661001796,652,It would be a real treat to go to that island.
2111,4722,8,21,120,149,1.2483221476510067,0.044573110983951156,652,Sure it looks tempting but I’m going to wait here for the Good Ship Lollipop.
4190,4722,8,21,120,149,1.2483221476510067,0.044573110983951156,652,Not for me. I am on the Paleo
4515,4722,6,25,118,149,1.2483221476510067,0.04248967850729419,652,"I would, but I'm trying to stay Keto."
4829,4722,7,23,119,149,1.2483221476510067,0.04354385721569028,652,"I know, Bill, but I’ve just always been more of a scone guy."
5173,4722,4,29,116,149,1.2483221476510067,0.04029867661001796,652,I'm beginning to think Darwin may have missed a few things.
6031,4722,7,23,119,149,1.2483221476510067,0.04354385721569028,652,"Rotate.  Time to stare at the island of helicopters, jet packs and speed boats."""
6543,4722,6,25,118,149,1.2483221476510067,0.04248967850729419,652,"Well, at least the grass is greener on this side."
3213,4722,5,27,117,149,1.2483221476510067,0.0414086712909991,652,Can't go. Diabetes.
5362,4731,7,22,116,145,1.2482758620689656,0.04434607292841478,652,That's all that's left of the Big Rock Candy Mountain.
1223,4731,4,28,113,145,1.2482758620689656,0.04097826085051929,652,Do you have dental floss?
7784,4731,4,28,113,145,1.2482758620689656,0.04097826085051929,652,It's only day one and I'm already seeing things.
5254,4731,5,26,114,145,1.2482758620689656,0.04213078806462358,652,"By any chance, are you a dentist?"
5365,4731,7,22,116,145,1.2482758620689656,0.04434607292841478,652,"Yes, we have no food, but who needs the empty calories?"
3654,4731,6,24,115,145,1.2482758620689656,0.043252615453394906,652,I'm trying to stay away from refined sugar.
541,4731,5,26,114,145,1.2482758620689656,0.04213078806462358,652,"Personally, I’d rather be on the Appetizer Archipelago."
2600,4731,7,22,116,145,1.2482758620689656,0.04434607292841478,652,Should we build a wall in case they decide to immigrate?
1987,4731,5,26,114,145,1.2482758620689656,0.04213078806462358,652,"Dessert, desert - what's in an ""s""?"
1514,4731,5,26,114,145,1.2482758620689656,0.04213078806462358,652,I was not specific enough during that desert island game
41,4731,8,20,117,145,1.2482758620689656,0.045413209804915894,652,"I’m glad the dolphins rescued us, but c’mon!"
3076,4731,7,22,116,145,1.2482758620689656,0.04434607292841478,652,"There's a woman on that island, but she's a real witch."
1963,4743,4,27,110,141,1.24822695035461,0.04169171895547657,652,You're no box of chocolates either!
6925,4743,6,23,112,141,1.24822695035461,0.044054893878545213,652,Too bad we gave up carbs.
7286,4743,7,21,113,141,1.24822695035461,0.04519016261581274,652,"I would, but I’m gluten-free"
7296,4743,6,23,112,141,1.24822695035461,0.044054893878545213,652,We’re better off without the carbs.
9316,4743,6,23,112,141,1.24822695035461,0.044054893878545213,652,Hungry?
8667,4748,5,24,108,137,1.2481751824817517,0.043688146360768294,652,"I still prefer meat, so I won't stop you."
311,4748,6,22,109,137,1.2481751824817517,0.04489984787719984,652,"I was sure ""dessert"" had only one S."
352,4748,8,18,111,137,1.2481751824817517,0.04723008313889821,652,Think of your waistline!
805,4748,7,20,110,137,1.2481751824817517,0.0460796977675794,652,Mirage or meringue?
5159,4748,4,26,107,137,1.2481751824817517,0.04244186524511072,652,And we just got our summer bodies back...
9254,4748,7,20,110,137,1.2481751824817517,0.0460796977675794,652,Or Wilbur Ross is now running the Coast Guard Office of Search and Rescue.
6441,4754,7,19,107,133,1.2481203007518797,0.047018675770621486,652,I can't- I'm on a starvation diet.
4536,4754,4,25,104,133,1.2481203007518797,0.04323184441548373,652,"Rick, we're ON a desert island! Did you just wish for a dessert island?"
3138,4754,7,19,107,133,1.2481203007518797,0.047018675770621486,652,"Yeah - I see it too! In fact, I started seeing it three days ago . . ."
3596,4754,9,15,109,133,1.2481203007518797,0.0493821648404393,652,"Personally, I prefer a non-deserted island."
4397,4754,5,23,105,133,1.2481203007518797,0.04452991733786778,652,I say we hit Entree Island first.
65,4759,4,24,101,129,1.248062015503876,0.044065182174039035,652,You go. I'm diabetic.
4426,4759,6,20,103,129,1.248062015503876,0.046733161053439894,652,I'm pretty sure the sharks put it there.
8241,4759,6,20,103,129,1.248062015503876,0.046733161053439894,652,Our sugar daddy has arrived!
9952,4759,7,18,104,129,1.248062015503876,0.04801158582107555,652,Funny how one ‘s’ makes so much difference.
354,4763,8,15,102,125,1.248,0.05036127544568475,652,It's a shame I'm still on my diet
5493,4763,4,23,98,125,1.248,0.04494584555059639,652,I know what my dentist would say.
9675,4765,6,18,97,121,1.2479338842975207,0.04878833766329071,652,"Since I’ve started keto, that really doesn’t appeal to me”"
9736,4765,3,24,94,121,1.2479338842975207,0.0443517615371859,652,I say it's an illusion ... would you still want to try to make it there if those are vegetables?
2598,4767,8,28,142,178,1.247191011235955,0.03948648167801395,652,"You go, I don’t have enough points."
5935,4768,6,31,137,174,1.2471264367816093,0.03839409864536054,652,They were out of pizza.
865,4769,7,28,135,170,1.2470588235294118,0.03984984408380814,652,Let's split that mirage down the middle!
8803,4769,6,30,134,170,1.2470588235294118,0.03896660659115111,652,Relax! It's the port of call for the good ship lollipop!
7997,4771,9,23,134,166,1.2469879518072289,0.04224163093794226,652,I'm off sugar and you have diabetes.
8065,4771,8,25,133,166,1.2469879518072289,0.04136829745311664,652,That's Christmas Island
1108,4773,6,28,128,162,1.2469135802469136,0.04018755239832282,652,They all died of diabetes.
7700,4773,10,20,132,162,1.2469135802469136,0.04383793234373681,652,"I don’t know, I think I’ll stay here. I don’t want to get diabetes."
8406,4773,8,24,130,162,1.2469135802469136,0.042052370206339076,652,"Well, I guess this means we're bringing the mains."
4173,4776,8,23,127,158,1.2468354430379747,0.04276833833089834,652,I'm not so sure. Aren't you familiar with the paradox of choice?
958,4776,8,23,127,158,1.2468354430379747,0.04276833833089834,652,You think it's gluten-free?
5074,4778,6,26,122,154,1.2467532467532467,0.04152235085119238,652,"I'd love to, but I haven't gotten my 10,000 steps in today."
9574,4778,4,30,120,154,1.2467532467532467,0.039425128339198694,652,I'm rethinking my pescatarian diet.
8738,4778,8,22,124,154,1.2467532467532467,0.043518622403021276,652,For want of an additional 's' we could be over there.
8176,4778,4,30,120,154,1.2467532467532467,0.039425128339198694,652,"Ugh, that's going to affect property values."
7744,4778,5,28,121,154,1.2467532467532467,0.040487321254757055,652,So you don't see the sharks?
7126,4778,5,28,121,154,1.2467532467532467,0.040487321254757055,652,"It is a tantalizing oasis, yet rather predictably gauche."
5570,4778,2,34,118,154,1.2467532467532467,0.03720988939670554,652,Yeah.. true... but think of all those calories we are avoiding on our island.
2856,4778,9,20,125,154,1.2467532467532467,0.044483175849756494,652,Is it really worth the calories?
433,4778,8,22,124,154,1.2467532467532467,0.043518622403021276,652,If only I wasn't on a low-carb diet.
2123,4778,8,22,124,154,1.2467532467532467,0.043518622403021276,652,What are the odds those are gluten-free?
1712,4778,8,22,124,154,1.2467532467532467,0.043518622403021276,652,"And you said I shouldn't bring LSD on the cruise.  Not so critical now, eh?"
1454,4778,4,30,120,154,1.2467532467532467,0.039425128339198694,652,"You know Tom, we could always just swim."
1339,4778,5,28,121,154,1.2467532467532467,0.040487321254757055,652,There's gotta be some middle ground.
1292,4778,5,28,121,154,1.2467532467532467,0.040487321254757055,652,Get ready to say good bye to our vegan diet.
467,4778,6,26,122,154,1.2467532467532467,0.04152235085119238,652,I wouldn’t touch that pun with a 110-foot pole.
2428,4778,9,20,125,154,1.2467532467532467,0.044483175849756494,652,That would’ve been the sweeter real estate deal.
9600,4794,6,25,119,150,1.2466666666666666,0.042237918507908104,652,We're being rescued by the Good Ship Lolipop?
7988,4794,10,17,123,150,1.2466666666666666,0.04628156862437344,652,The Good Ship Lollipop Went down around here.
7390,4794,3,31,116,150,1.2466666666666666,0.038930519955964624,652,On the bright side staring at it doesn't cause cavities
7338,4794,7,23,120,150,1.2466666666666666,0.04328426063240149,652,At least the grass is no greener.
6187,4794,6,25,119,150,1.2466666666666666,0.042237918507908104,652,Are the Sugarplum Fairies dancing for you too?
5447,4794,8,21,121,150,1.2466666666666666,0.044305898897400074,652,You texted for a Deserted Island not a Deserrted Island.
3872,4794,6,25,119,150,1.2466666666666666,0.042237918507908104,652,The guy there got stranded from The Good Ship Lollipop
2509,4794,5,27,118,150,1.2466666666666666,0.04116498878012371,652,"'Keto, Mike. Keto. We both committed to it.'"
2262,4794,7,23,120,150,1.2466666666666666,0.04328426063240149,652,Do you think they have any cigarettes?
1193,4794,4,29,117,150,1.2466666666666666,0.04006333539103722,652,It's the flotsam and jetsam from the Good Ship Lollypop.
3898,4794,4,29,117,150,1.2466666666666666,0.04006333539103722,652,Unfortunately I let my dental insurance lapse.
9011,4805,7,22,117,146,1.2465753424657535,0.04407410326605941,652,Eye candy is best kept afar.
8962,4805,5,26,115,146,1.2465753424657535,0.04187576812582842,652,Let’s just call it an ‘abandoned’ island so those mirages stop appearing.
8850,4805,7,22,117,146,1.2465753424657535,0.04407410326605941,652,Shark infested waters! That's the least of it. Just think what all those carbs will do to us!
6568,4805,7,22,117,146,1.2465753424657535,0.04407410326605941,652,No donut is an island . . .
5992,4805,6,24,116,146,1.2465753424657535,0.04298899007208366,652,Do you think there’s an insulin dispenser as well?
3022,4805,8,20,118,146,1.2465753424657535,0.04513313516693505,652,Not worth the risk. I’ve heard tales of deadly PIErates on these dessert islands.
5878,4805,6,24,116,146,1.2465753424657535,0.04298899007208366,652,I'd swim over there but I'm pre-diabetic.
2391,4805,7,22,117,146,1.2465753424657535,0.04407410326605941,652,I call it sweetrification.
950,4805,6,24,116,146,1.2465753424657535,0.04298899007208366,652,How should I know if it's gluten-free?
227,4805,5,26,115,146,1.2465753424657535,0.04187576812582842,652,"Here's the thing, Zak: I ate a piece of your foot last night, and you're made of marzipan."""
5882,4805,7,22,117,146,1.2465753424657535,0.04407410326605941,652,So that's what happened to 'The Good Ship Lollipop'!
8494,4816,6,23,113,142,1.2464788732394365,0.04377846231529865,652,Looks great until the sharks chase you back.
4252,4816,5,25,112,142,1.2464788732394365,0.04262233735759899,652,It doesn't look as iconic as this island.
7666,4816,6,23,113,142,1.2464788732394365,0.04377846231529865,652,Looks like Bernie’s Campaign Committee is putting together their platform.
1385,4816,5,25,112,142,1.2464788732394365,0.04262233735759899,652,The Good Ship Lollipop can't be far behind.
549,4816,8,19,115,142,1.2464788732394365,0.0460036303396386,652,Okay. We're both diabetic...and we're both cannibals. Now what?
2958,4816,7,21,114,142,1.2464788732394365,0.04490483140552997,652,"For Christ's sake, Tim, we're out of dental floss."
3149,4822,6,22,110,138,1.2463768115942029,0.04460956331318161,652,God must’ve had autocorrect off when she made that one.
3552,4822,5,24,109,138,1.2463768115942029,0.04340767923070482,652,As Mick Jagger said “You can’t always get what you want”
4680,4822,7,20,111,138,1.2463768115942029,0.045779904562916626,652,It sweetens the cliché.
7945,4822,8,18,112,138,1.2463768115942029,0.04692106333606209,652,"i'm on a diet, what's your excuse?"
8103,4822,2,30,106,138,1.2463768115942029,0.03958367147959845,652,"Maybe tonight there'll  be pie in the sky, and tomorrow a helicopter will come!"
9151,4822,4,26,108,138,1.2463768115942029,0.04217155550129456,652,Too bad I gave up candy for Lent.
9651,4822,5,24,109,138,1.2463768115942029,0.04340767923070482,652,I told you it was an unusual destination and you needed to use spellcheck!
8970,4829,2,29,103,134,1.2462686567164178,0.0402502651842164,652,And you really are a dentist?
8282,4829,6,21,107,134,1.2462686567164178,0.04548590166123932,652,It’s day ten of my no-sugar diet.
8107,4829,5,23,106,134,1.2462686567164178,0.04423512630593346,652,It's OK.  You'll get to like coconut
5408,4829,4,25,105,134,1.2462686567164178,0.042947939981654984,652,It's the docking pier for The Good Ship Lollypop!
3892,4829,6,21,107,134,1.2462686567164178,0.04548590166123932,652,All corn syrup and glutens.  Forget about it.
4773,4829,4,25,105,134,1.2462686567164178,0.042947939981654984,652,I never thought Candyland was a real place. The worst that could happen is we slide back to here.
4676,4829,6,21,107,134,1.2462686567164178,0.04548590166123932,652,"Yep; sea levels rose, and now it’s the Small Rock Candy Island."
1150,4829,7,19,108,134,1.2462686567164178,0.04670319154586742,652,Can you believe those idiots wanted to be rescued?
4833,4829,7,19,108,134,1.2462686567164178,0.04670319154586742,652,"Like the land of milk and honey, but better."
7749,4838,4,24,102,130,1.2461538461538462,0.043766522170656255,652,"I have a great name for it, but we'll have to pay a royalty to Hasbro."
8984,4838,3,26,101,130,1.2461538461538462,0.04238216462779693,652,The genie messed up slightly.
8243,4838,5,22,103,130,1.2461538461538462,0.0451084143735003,652,Doesn’t bother me. Not atoll.
5913,4838,5,22,103,130,1.2461538461538462,0.0451084143735003,652,I told you it was spelled with two esses.
166,4838,4,24,102,130,1.2461538461538462,0.043766522170656255,652,I didn't know you wanted to be on a dessert island with me!
3165,4838,5,22,103,130,1.2461538461538462,0.0451084143735003,652,"Tasty mirage.
But I'm still hungry."
1687,4838,5,22,103,130,1.2461538461538462,0.0451084143735003,652,More bad luck for a pair of  diabetics.
596,4838,7,18,105,130,1.2461538461538462,0.04767903329604257,652,You go ahead. Wilson says I need to cut back on refined sugar.
5069,4838,5,22,103,130,1.2461538461538462,0.0451084143735003,652,"I was hoping for,  you know,  milk and honey but this is OK too"
903,4847,6,19,101,126,1.246031746031746,0.047390988275359834,652,The Dental Association will stop at nothing!
5966,4847,6,19,101,126,1.246031746031746,0.047390988275359834,652,"Forget it, man: you’ll get fat... and there’s not a dentist in sight."
8577,4847,6,19,101,126,1.246031746031746,0.047390988275359834,652,"Consider yourself lucky, almost no one escapes Neverland."
8953,4850,6,18,98,122,1.2459016393442623,0.048429439073835824,652,Here comes that damn yellow submarine again
6462,4850,6,18,98,122,1.2459016393442623,0.048429439073835824,652,"The good ship Lollipop would've stopped here, but no, you
have to cut back on glutton."
3061,4850,5,20,97,122,1.2459016393442623,0.04700986675286886,652,These Disney theme parks are popping up just about everywhere
613,4850,5,20,97,122,1.2459016393442623,0.04700986675286886,652,You swim over and see. If it's real bring me back something gluten free.
2751,4854,5,33,137,175,1.2457142857142858,0.0373305853350088,652,"Yeah, but we need to brush and floss afterwards."
6063,4854,10,23,142,175,1.2457142857142858,0.041496744768877034,652,I have diabetes. You can't swim.  That desserted island is a no-go.
1016,4856,5,32,134,171,1.2456140350877194,0.03786720706234217,652,I haven't seen any sharks today.
6100,4856,10,22,139,171,1.2456140350877194,0.0421654197029309,652,I keep hoping I will wake up and find out this is just a nightmare about commonly confused expressions.
2415,4858,5,31,131,167,1.2455089820359282,0.038426471900896805,652,At least we're not obese
3321,4858,4,33,130,167,1.2455089820359282,0.03747597731691185,652,"Well, grass is always pinker on the other side of the mirage."
8057,4860,9,22,132,163,1.2453987730061349,0.04271695987428302,652,I wonder if they need fresh cocunuts?
9628,4860,4,32,127,163,1.2453987730061349,0.03802679122285304,652,"Your fantasies are working overtime, dear."
5724,4860,7,26,130,163,1.2453987730061349,0.04090547563374914,652,Just my luck. I've given up sugar and gluten.
2155,4863,4,31,124,159,1.2452830188679245,0.03860164331549569,652,"I don’t know about you, but I’d rather be in the shade."
2321,4863,4,31,124,159,1.2452830188679245,0.03860164331549569,652,The sugar high is just a mirage.
5007,4863,7,25,127,159,1.2452830188679245,0.04158030007535752,652,If the current does't get you your diabetes will!
6455,4863,7,25,127,159,1.2452830188679245,0.04158030007535752,652,Just des(s)ert?
8185,4867,6,26,123,155,1.2451612903225806,0.04128429993780832,652,"Before you go, remember, we'll always have ""the tree."""
9756,4867,2,34,119,155,1.2451612903225806,0.03700330659697081,652,"I'd swim there, but I can't afford the calories."
9319,4867,7,24,124,155,1.2451612903225806,0.04228688451418825,652,"I know you don’t have a toothbrush, but maybe just this one time!"
7704,4867,7,24,124,155,1.2451612903225806,0.04228688451418825,652,"Typo probably. We're deserted, one 's'."
4753,4867,7,24,124,155,1.2451612903225806,0.04228688451418825,652,"It appeared this morning. Mirage or metaphor. I'm not sure. Don't forget, neither of us can swim."
3919,4867,6,26,123,155,1.2451612903225806,0.04128429993780832,652,Dammit. I just started a cleanse this week.
3227,4867,7,24,124,155,1.2451612903225806,0.04228688451418825,652,Tell me again why we had to select the gluten-free option?
2653,4867,5,28,122,155,1.2451612903225806,0.04025675397735821,652,I counted 50 shark fins out there. Let’s give it a shot.
450,4875,10,17,124,151,1.2450331125827814,0.04600305913354047,652,The SS Cannibis wrecked there
1274,4875,8,21,122,151,1.2450331125827814,0.0440418097737016,652,You go.  I'm off sugar and gluten.
6487,4875,7,23,121,151,1.2450331125827814,0.043027674668663723,652,"I’ll draw off the gummy sharks, and you make a break for it."
6555,4875,7,23,121,151,1.2450331125827814,0.043027674668663723,652,Are you getting the munchies?
7272,4875,4,29,118,151,1.2450331125827814,0.03983064304201867,652,and they told me swimming would help me lose weight
7873,4880,6,24,117,147,1.2448979591836735,0.04272848347675213,652,"How did we get the ""desert"" island?"
9819,4880,6,24,117,147,1.2448979591836735,0.04272848347675213,652,Just our luck to get stuck in the Molasses Swamp just before we made it to the Candy Castle.
7682,4880,5,26,116,147,1.2448979591836735,0.04162373529739404,652,I call it  dess-ert island.
8448,4880,6,24,117,147,1.2448979591836735,0.04272848347675213,652,"Sure, go ahead. But I'm pretty sure the next island won't have insulin shots for your diabetes."
4180,4880,4,28,115,147,1.2448979591836735,0.040488855009644,652,Do you mind if I eat the doughnut?
5502,4880,8,20,119,147,1.2448979591836735,0.04485642897572416,652,Sex is always better than sugar!
3979,4880,9,18,120,147,1.2448979591836735,0.0458834085543973,652,It's where the Good Ship Lollypop docks.
9916,4887,5,25,113,143,1.2447552447552448,0.04235831268917647,652,What if they want us too?
9417,4887,6,23,114,143,1.2447552447552448,0.04350539863182021,652,I would like to know the catch!
7710,4887,6,23,114,143,1.2447552447552448,0.04350539863182021,652,"I don’t know, I’d really hate to get my hair wet."
6552,4887,4,27,112,143,1.2447552447552448,0.041179286026284054,652,"I know, I know, it's probably just a mirage, but should we swim over anyway to see if anything is gluten-free?"
4863,4887,5,25,113,143,1.2447552447552448,0.04235831268917647,652,"I knew changes were going to come after that ""Good Ship Lollipop"" hit that reef."
4731,4887,4,27,112,143,1.2447552447552448,0.041179286026284054,652,I really don't care for theme parks.
4421,4887,8,19,116,143,1.2447552447552448,0.045713300281128834,652,And you're sure the sharks didn't put it there?
4297,4887,8,19,116,143,1.2447552447552448,0.045713300281128834,652,So who would you choose to spend your life with on a dessert island?
3624,4887,4,27,112,143,1.2447552447552448,0.041179286026284054,652,Only if it's gluten-free.
1926,4887,5,25,113,143,1.2447552447552448,0.04235831268917647,652,The Great Pacific Diet Patch is always so big this time of year.
322,4887,8,19,116,143,1.2447552447552448,0.045713300281128834,652,The island is always sweeter on the other side of the water.
8921,4898,5,24,110,139,1.2446043165467626,0.04313069881830356,652,The grass always looks greener over there
8217,4898,7,20,112,139,1.2446043165467626,0.04548390934897567,652,Do you miss it?
4532,4898,10,14,115,139,1.2446043165467626,0.048801426755083435,652,"The good ship ""lollypop"" frequently sails these waters."
4320,4898,7,20,112,139,1.2446043165467626,0.04548390934897567,652,"They breathe through the candy canes.  If you get close, the cake eats you."
8540,4898,7,20,112,139,1.2446043165467626,0.04548390934897567,652,"I told you to use spellcheck when you answered the ""stranded on an island"" question!"
2976,4898,7,20,112,139,1.2446043165467626,0.04548390934897567,652,"This is nice, but I’d rather be stuck on a desserted island."
2764,4898,3,28,108,139,1.2446043165467626,0.040641460990527734,652,"Winters, we do the Big Rock Candy Mountain."
465,4898,6,22,111,139,1.2446043165467626,0.04432292403610714,652,I think I'm having my mom's nightmare.
235,4898,4,26,109,139,1.2446043165467626,0.041904567364428186,652,Let your conscience be your guide.
3200,4898,5,24,110,139,1.2446043165467626,0.04313069881830356,652,"Hansel, I believe we have been trapped in a cartoon cliche."
9549,4908,3,27,105,135,1.2444444444444445,0.04135176749720385,652,"This way, you won't be tempted."
5102,4908,5,23,107,135,1.2444444444444445,0.04394411580826142,652,Under the circumstances I'll settle for a 'sugar high.'
4241,4908,2,29,104,135,1.2444444444444445,0.039992628766177166,652,Honey -- I think we chose the wrong fantasy island.
2849,4908,4,25,106,135,1.2444444444444445,0.04266763404099585,652,I think we should stay with the palm oil here rather than risk that unhealthy pure cane sugar.
6842,4908,5,23,107,135,1.2444444444444445,0.04394411580826142,652,"I’m vegan so no, but go if you want"
1036,4908,6,21,108,135,1.2444444444444445,0.04518455082971872,652,"For a mirage, it's pretty generic."
1007,4908,9,15,111,135,1.2444444444444445,0.04871671778993393,652,I'm pretty sure they're also antennae.
890,4908,5,23,107,135,1.2444444444444445,0.04394411580826142,652,"Sure, but we have a more context-sensitive design sense."
1573,4908,8,17,110,135,1.2444444444444445,0.04756847982341376,652,"I've got to say, we took refudge on the wrong island."
767,4917,6,20,105,131,1.2442748091603053,0.046094191207963264,652,"You know, if global warming is real, that dessert island won't be here in 10 years."
9890,4917,6,20,105,131,1.2442748091603053,0.046094191207963264,652,Robinson let himself go lately.
1232,4919,6,19,102,127,1.2440944881889764,0.047056244461984,652,"Leave it for the sharks, let them rot their teeth."
4496,4919,6,19,102,127,1.2440944881889764,0.047056244461984,652,I'm on keto but don't hold back on my account.
5747,4919,6,19,102,127,1.2440944881889764,0.047056244461984,652,Somehow I thought your wish for “civilisation” would turn out different.
5784,4919,6,19,102,127,1.2440944881889764,0.047056244461984,652,It’ll go right to your hips!
8024,4919,5,21,101,127,1.2440944881889764,0.045708924357428474,652,You eat that crap?
2081,4924,5,31,132,168,1.244047619047619,0.03822500265005232,652,You'd think being stranded on an island would be the perfect opportunity to cut down on processed sugars...
9575,4924,6,29,133,168,1.244047619047619,0.03914635138842723,652,I heard a witch is stranded there.
6813,4926,8,14,101,123,1.2439024390243902,0.050772341450393485,652,"Hey Chip, why are we stranded on the deserted island rather than the dessert island?"
9192,4926,6,28,130,164,1.2439024390243902,0.03975266869690043,652,Did you hear any news recently about the Good Ship Lollypop going down in our area?
6024,4926,10,20,134,164,1.2439024390243902,0.04335367879285992,652,I dreamed of a “Sweet Thing” joining us...and this is what we got.
2353,4926,3,34,127,164,1.2439024390243902,0.03682152320673085,652,"Of course it looks good, but it's all empty calories."
2688,4926,7,26,131,164,1.2439024390243902,0.04068281415552227,652,I told you it was two Ss!
4533,4926,6,28,130,164,1.2439024390243902,0.03975266869690043,652,Was supposed to be your surprise birthday party... I might have messed up with the address
1961,4932,5,29,126,160,1.24375,0.03940085379625947,652,It’s only fair that we get our just deserts.
3158,4932,5,29,126,160,1.24375,0.03940085379625947,652,"Remind me again, which stage of Hansel and Gretel Syndrome are we in?"
8505,4932,3,33,124,160,1.24375,0.03735230348280676,652,So you're saying it's just a matter of perspective?
9190,4932,4,31,125,160,1.24375,0.03839024521506676,652,"It's ok, I'm not hungry."
5886,4936,8,22,126,156,1.2435897435897436,0.04301671715340813,652,Dessert island is looking pretty good right about now
5211,4936,5,28,123,156,1.2435897435897436,0.04002872714488858,652,At least we didn't wind up on THAT island. Sugar is so bad for you.
5003,4936,6,26,124,156,1.2435897435897436,0.0410488974611832,652,Big Rock Candy Mountain my ass
4705,4936,6,26,124,156,1.2435897435897436,0.0410488974611832,652,It just makes my teeth ache we look at it.
3332,4936,3,32,121,156,1.2435897435897436,0.03790610801654999,652,"Welcome, to Paleo Island."
2935,4936,7,24,125,156,1.2435897435897436,0.042044321480046803,652,I feel like this is the sequel of FYRE FESTIVAL!
1111,4936,4,30,122,156,1.2435897435897436,0.038981867719507075,652,"It's too bad I can't swim, and you are totally low-carb."
3999,4936,7,24,125,156,1.2435897435897436,0.042044321480046803,652,Do you think there's a sweeter life out there?
9749,4944,5,27,120,152,1.243421052631579,0.040685900502249725,652,It's still not Candy Land.
9584,4944,7,23,122,152,1.243421052631579,0.04277404880485733,652,Can we swim on an empty stomach?
9436,4944,6,25,121,152,1.243421052631579,0.04174303385499957,652,"Well, I’ll be. I always thought that dessert islands were a fiction of New Yorker cartoons."
6986,4944,6,25,121,152,1.243421052631579,0.04174303385499957,652,Of course it appears right when I’m on a diet!
7349,4944,8,21,123,152,1.243421052631579,0.043780790615302885,652,I said 'dessert' island you schmuck. What are we meant to do here?
4739,4944,6,25,121,152,1.243421052631579,0.04174303385499957,652,"That old witch from Hansel and Gretal never gives up, does she."
3244,4944,9,19,124,152,1.243421052631579,0.04476489699129966,652,"It isn't a mirage, it's an île flottante"
1690,4944,8,21,123,152,1.243421052631579,0.043780790615302885,652,We got stranded on the wrong island.
1572,4944,7,23,122,152,1.243421052631579,0.04277404880485733,652,"It must be a figment of your imagination. Why don't you lie down and take a nap. Meanwhile, I think I'm going to go swimming."
5222,4944,6,25,121,152,1.243421052631579,0.04174303385499957,652,I told you there were two s's!
9875,4954,6,24,118,148,1.2432432432432432,0.042471042471042476,652,I guess that’s the legendary en-suite dessert island
8487,4954,4,28,116,148,1.2432432432432432,0.040248380363222376,652,Thank god I am more of a salty rather than a sweets person.
7971,4954,5,26,117,148,1.2432432432432432,0.041374639396855886,652,The real mistake was using spellcheck.
9365,4954,7,22,119,148,1.2432432432432432,0.04353984510691705,652,And here I thought I could finally make my diet work.
7185,4954,5,26,117,148,1.2432432432432432,0.041374639396855886,652,'Probably cannibals.'
6799,4954,8,20,120,148,1.2432432432432432,0.04458303236985528,652,"Dang, that island looks sweet!"
3064,4954,6,24,118,148,1.2432432432432432,0.042471042471042476,652,They're on the Island of Misfit Carbs.
7568,4954,5,26,117,148,1.2432432432432432,0.041374639396855886,652,"Ok, so far so good, now we wait..."
2245,4962,3,29,112,144,1.2430555555555556,0.039723363255926035,652,I'm diabetic. And you?
2984,4962,8,19,117,144,1.2430555555555556,0.045426545917423,652,"Unless Captain Crunch pops out, I’m not interested."
5682,4962,6,23,115,144,1.2430555555555556,0.04323564362580423,652,I wish we hadn't started that diet.
6075,4962,6,23,115,144,1.2430555555555556,0.04323564362580423,652,"Yeah, but they don't have any coconuts!"
7247,4962,6,23,115,144,1.2430555555555556,0.04323564362580423,652,Still have doubts about evolution?
7290,4962,8,19,117,144,1.2430555555555556,0.045426545917423,652,"You know deserted is spelled with only one s, right?"
9198,4968,6,22,112,140,1.2428571428571429,0.04403986395070219,652,"Don't look, it's their fake news."
9156,4968,5,24,111,140,1.2428571428571429,0.04285714285714285,652,"If we swim over there we'll still be lost, plus we'll have acne."
7152,4968,4,26,110,140,1.2428571428571429,0.041640842582238206,652,It's even worse than you think. I'm on the keto diet.
5387,4968,6,22,112,140,1.2428571428571429,0.04403986395070219,652,"I would, but I'm dieting."
2379,4968,6,22,112,140,1.2428571428571429,0.04403986395070219,652,...but we don't have any shoots or ladders.
1042,4968,4,26,110,140,1.2428571428571429,0.041640842582238206,652,Looks like the boss remembered your birthday.
4703,4968,6,22,112,140,1.2428571428571429,0.04403986395070219,652,I wished for Scrabble!
571,4968,7,20,113,140,1.2428571428571429,0.04519164236576456,652,Heck of a time to be on a low-carb diet.
649,4976,7,28,138,173,1.2427745664739884,0.03923393848818495,652,I'd prefer that Desserted Island over ours.
5076,4976,7,28,138,173,1.2427745664739884,0.03923393848818495,652,"So, I see another Swiss family has moved into the hood."
204,4978,3,27,106,136,1.2426470588235294,0.041085918172157385,652,It's not a mirage. My mirage would be gluten-free.
272,4978,2,29,105,136,1.2426470588235294,0.03973814553015243,652,"Yes, I can swim.  But I'm pretty sure those aren't gluten free."
1613,4978,5,23,108,136,1.2426470588235294,0.04365681614360453,652,"Bradley, I just had an incredible idea for a children's board game - or my name's not Milton."
4584,4978,5,23,108,136,1.2426470588235294,0.04365681614360453,652,Seriously?  You wished for Candy Cane Island?
5129,4978,5,23,108,136,1.2426470588235294,0.04365681614360453,652,Of all the weeks to start Atkins...
5641,4978,6,21,109,136,1.2426470588235294,0.044887081189025055,652,I don't think so. I've been trying to lose weight.
8805,4978,5,23,108,136,1.2426470588235294,0.04365681614360453,652,I'd swim over but I've maxed out my dental plan.
2550,4978,8,17,111,136,1.2426470588235294,0.0472516135324224,652,This is so much better that being near the Isle of Man.
8364,4986,4,33,132,169,1.242603550295858,0.03708776156970467,652,"Man, as if being a diabetic isn’t bad enough..."
9938,4987,4,24,104,132,1.2424242424242424,0.04318085433421962,652,All yours. I’m more of a savoury guy.
4857,4987,5,22,105,132,1.2424242424242424,0.044499961820624365,652,"Well, that sure strikes the right note of middle aged whimsy."
8991,4987,7,18,107,132,1.2424242424242424,0.04702730530282264,652,"If you had to pick one person to be stranded with on a dessert island, who would it be?"
4254,4987,6,20,106,132,1.2424242424242424,0.04578107712844859,652,You think I'll be okay? I left my insulin on the plane.
3390,4987,3,26,103,132,1.2424242424242424,0.041820159732229155,652,"I told my mom I'm not into sweets, but she insisted I was getting too skinny out here."
1195,4987,5,22,105,132,1.2424242424242424,0.044499961820624365,652,I can hear the sirens calling from here.
1129,4987,6,20,106,132,1.2424242424242424,0.04578107712844859,652,"It's supposed to be another desert island. The cartoonist put in an extra ""s"" on that one."
4074,4987,6,28,131,165,1.2424242424242424,0.039538650574434626,652,It’s a port of call for the Good Ship Lollipop.
2618,4995,7,25,129,161,1.2422360248447204,0.04111829389481637,652,Sure wish I knew how to swim.
4503,4996,5,21,102,128,1.2421875,0.04539049423914243,652,It's tempting but we don't have a dental plan.
5282,4996,4,23,101,128,1.2421875,0.04401437800549532,652,I don't know.  I'm trying to stay away from carbs.
9109,4996,6,19,103,128,1.2421875,0.04672610045078247,652,I can see the headlines at home: Lost at Sea -- The Good Ship Lollipop ....
8186,4999,8,22,127,157,1.2420382165605095,0.042769998044863894,652,Candy is dandy but sex won't rot your teeth.
5915,4999,6,26,125,157,1.2420382165605095,0.04081610096642558,652,"Seriously, Honey, I didn't say 'desert' island to the genie."
4223,4999,5,28,124,157,1.2420382165605095,0.03980320063478991,652,It's Willie Wonka's private island.
786,4999,6,26,125,157,1.2420382165605095,0.04081610096642558,652,I don’t know about you...but this is not what I meant by “how sweet it would be to see land”!
98,4999,9,20,128,157,1.2420382165605095,0.043714208789428735,652,"They say that no one ever comes in, and no one ever comes out."
4125,4999,6,26,125,157,1.2420382165605095,0.04081610096642558,652,Im telling you if there is a witch we would have seen her
1396,5005,5,20,99,124,1.2419354838709677,0.0463328244815081,652,A dessert-ed island!
2648,5005,2,26,96,124,1.2419354838709677,0.04187289808157224,652,"On the bright side, I've been trying to stay away from carbs."
4881,5005,4,22,98,124,1.2419354838709677,0.04489543719436014,652,Our island is gluten-free.
9264,5008,4,29,120,153,1.2418300653594772,0.039373036003404145,652,"Evidently, the Candyman couldn't."
9774,5008,6,25,122,153,1.2418300653594772,0.041499814314480576,652,"Without a freshness date, I just can't."
5896,5008,5,27,121,153,1.2418300653594772,0.04045040514173947,652,I'm hoping it's a stop for Disney Cruises.
6309,5008,6,25,122,153,1.2418300653594772,0.041499814314480576,652,I thought we could finally diet in peace over here.
4081,5008,6,25,122,153,1.2418300653594772,0.041499814314480576,652,"If you draw a pink card, you go directly to Candyland.
If you draw a blue card, you'll be swimming with the sharks."
4160,5008,5,27,121,153,1.2418300653594772,0.04045040514173947,652,Thank God we're on the keto island.
3803,5008,5,27,121,153,1.2418300653594772,0.04045040514173947,652,"Mirage or not, the glycemic numbers have to be off the charts."
984,5008,7,23,123,153,1.2418300653594772,0.04252333359629594,652,"Go ahead, I'm on a diet."
5047,5016,7,15,98,120,1.2416666666666667,0.0502038328875526,652,Now this is a National Emergency!
7054,5016,9,11,100,120,1.2416666666666667,0.05292009903070132,652,But did you actually see the sharks making it?
9308,5018,8,20,121,149,1.2416107382550337,0.04431288780186817,652,"I Was better at Chutes and Ladders"""
8481,5018,3,30,116,149,1.2416107382550337,0.03886075677987928,652,"Damn, the tsunami got the Big Rock Candy Mountain!"
7816,5018,5,26,118,149,1.2416107382550337,0.04112843129319842,652,Tell me once again what we were doing when the Good Ship Lollipop sank.
7193,5018,6,24,119,149,1.2416107382550337,0.042216615001756684,652,Your going to desert me for a sleazy dessert.
6904,5018,8,20,121,149,1.2416107382550337,0.04431288780186817,652,"Just the tip of the iceberg, Jack."
6665,5018,8,20,121,149,1.2416107382550337,0.04431288780186817,652,Either we're meant to eat it or its meant to eat us.
2589,5018,6,24,119,149,1.2416107382550337,0.042216615001756684,652,I'm just trying to stay away from carbs.
2101,5018,3,30,116,149,1.2416107382550337,0.03886075677987928,652,You did agree that the palm tree was a nice touch
1799,5018,5,26,118,149,1.2416107382550337,0.04112843129319842,652,Sometimes I wonder whether we should have chosen the dessert island instead.
1793,5018,7,22,120,149,1.2416107382550337,0.04327744567062331,652,Too bad our politicians don't believe in Global Sweetening.
1654,5018,3,30,116,149,1.2416107382550337,0.03886075677987928,652,"So, Gretel, now we know where tropical witches live."
1236,5018,6,24,119,149,1.2416107382550337,0.042216615001756684,652,Looks unhealthy
2842,5018,7,22,120,149,1.2416107382550337,0.04327744567062331,652,Did you pack the dental floss?
5810,5031,7,21,117,145,1.2413793103448276,0.04406963106363406,652,What do we have to lose?
8111,5031,6,23,116,145,1.2413793103448276,0.04296913940808907,652,It doesn't look gluten free.
7255,5031,9,17,119,145,1.2413793103448276,0.04619202597105775,652,I heard the sharks in this area are highly intelligent predators.
6755,5031,6,23,116,145,1.2413793103448276,0.04296913940808907,652,Every day it's a different flying saucer...
4362,5031,6,23,116,145,1.2413793103448276,0.04296913940808907,652,"I told you the word had an extra s in it, didn’t I?"
3317,5031,4,27,114,145,1.2413793103448276,0.040678938779738834,652,Cavity Island?
4327,5031,7,21,117,145,1.2413793103448276,0.04406963106363406,652,"It’s not worth it, they’re probably loaded with corn syrup."
2476,5031,6,23,116,145,1.2413793103448276,0.04296913940808907,652,"You know I'm not doing carbs, right?"
554,5031,5,25,115,145,1.2413793103448276,0.04183971200735931,652,Too bad neither of us can swim.
4357,5031,8,19,118,145,1.2413793103448276,0.04514330318771376,652,"Deserted island? More like-""
""WE GET IT, STEVE!"
1655,5041,5,31,134,170,1.2411764705882353,0.037828162549369895,652,I'd be tempted only if there's also an island nearby with a giant insulin syringe.
4707,5041,4,33,133,170,1.2411764705882353,0.03689656132469899,652,"It's on the map, Diabetes Island."
9784,5043,6,22,113,141,1.2411347517730495,0.04376031847617875,652,"It's a mirage. And there's only one ""s"" in desert."
9111,5043,4,26,111,141,1.2411347517730495,0.0413803241643798,652,"I tell you, it’s spelled with one s, not two."
5503,5043,8,18,115,141,1.2411347517730495,0.04601738495747046,652,Do you have your credit card on you?
3183,5043,6,22,113,141,1.2411347517730495,0.04376031847617875,652,JUST WHEN IM FINALLY ABLE TO FIT INTO MY LEVIS....
1369,5043,5,24,112,141,1.2411347517730495,0.04258695047244958,652,"On second thought, I'll start my diet tomorrow."
1151,5043,5,24,112,141,1.2411347517730495,0.04258695047244958,652,"Really, I just can't risk it; I finally have my diabetes under control."
4618,5043,3,28,110,141,1.2411347517730495,0.04013744019435515,652,What makes you think it's a spaceship?
7039,5050,6,28,132,166,1.2409638554216869,0.039326868941969476,652,"That coconut milk was tasty, wasn't it?"
7147,5050,9,22,135,166,1.2409638554216869,0.042019765244015767,652,"Yeh, I’m also doing sugar free January.."
6145,5052,5,23,109,137,1.2408759124087592,0.04337315922182596,652,I picked the wrong week to be off sugar.
6229,5052,6,21,110,137,1.2408759124087592,0.04459342045456528,652,"Dude, that stuff will kill you."
6112,5052,7,19,111,137,1.2408759124087592,0.04578116812395045,652,I think I might have left out an s.
109,5052,3,27,107,137,1.2408759124087592,0.04082335761509968,652,It's true! The Garden of Eden is actually Cane enabled!
2965,5052,4,25,108,137,1.2408759124087592,0.04211755849911165,652,Sand is always sweeter on the other side.
2162,5052,5,23,109,137,1.2408759124087592,0.04337315922182596,652,I would try to swim to it but I'm diabetic.
3741,5052,5,23,109,137,1.2408759124087592,0.04337315922182596,652,Big Rock Candy...Island?
2016,5059,6,27,129,162,1.2407407407407407,0.03994240500744754,652,I'd swim over there if you were a dentist.
809,5060,5,22,106,133,1.2406015037593985,0.044201706232744095,652,*Insert Dessert Island Pun*
1623,5060,9,14,110,133,1.2406015037593985,0.04908640850680349,652,I knew we should’ve used a travel agent
5078,5060,4,24,105,133,1.2406015037593985,0.042893701954168785,652,"You go ahead, I'm committed to my Ketogenic diet."
5446,5060,6,20,107,133,1.2406015037593985,0.04547210134179587,652,I think it's the Disney submarine.
6046,5060,4,24,105,133,1.2406015037593985,0.042893701954168785,652,"I'm thinking major GMOs, herbicides, and pesticides. We're good."
7967,5060,2,28,103,133,1.2406015037593985,0.04015006020204168,652,"'Swim left,' you said"
8658,5060,6,20,107,133,1.2406015037593985,0.04547210134179587,652,I'm pretty sure it's the sharks.
9659,5067,8,22,128,158,1.240506329113924,0.042526039797506444,652,Calorie Island is very nice this time of year.
8896,5067,10,18,130,158,1.240506329113924,0.04438147553908046,652,I guess we should've taken the Goodship Lollipop.
5466,5067,5,28,125,158,1.240506329113924,0.03958013511357382,652,"Well, at least we’ll stay fit and trim."
5066,5067,3,32,123,158,1.240506329113924,0.03748780849078623,652,Strange. I see brunch
6055,5067,6,26,126,158,1.240506329113924,0.04058586885471601,652,I don’t care if we drown swimming back to the shade.
3341,5067,11,16,131,158,1.240506329113924,0.045280691537447224,652,The Oompa Loompas are quiet today
871,5067,7,24,127,158,1.240506329113924,0.041567275659774174,652,"Dude, there’s no way that’s not a mirage."
666,5067,8,22,128,158,1.240506329113924,0.042526039797506444,652,So Shirley Temple lied?
16,5067,6,26,126,158,1.240506329113924,0.04058586885471601,652,That must be Diabetes Island.  I noticed it on the map.
3543,5067,7,24,127,158,1.240506329113924,0.041567275659774174,652,Do you see it too?
4086,5077,3,25,101,129,1.2403100775193798,0.04230403091655634,652,"Calorie Island"" is a tempting place to visit but I wouldn't want to live there"
8344,5077,3,25,101,129,1.2403100775193798,0.04230403091655634,652,It is not what it looks like.
9373,5079,4,29,121,154,1.2402597402597402,0.03914803890931436,652,"I know you're hungry, Bob, but I'm your dietician, and I insist we stay put."
7518,5079,4,29,121,154,1.2402597402597402,0.03914803890931436,652,Think how lucky we are that coconut is gluten-free.
6080,5079,4,29,121,154,1.2402597402597402,0.03914803890931436,652,“Its either a mirage or we found the final resting place of the good ship Lollipop”
4461,5079,7,23,124,154,1.2402597402597402,0.04227548064677721,652,We can't swim over there! I don't have my toothbrush.
1948,5079,8,21,125,154,1.2402597402597402,0.04326775591291567,652,It's a Fake Mirage.
689,5079,4,29,121,154,1.2402597402597402,0.03914803890931436,652,Remember that scene in 'Papillon' where Steve McQueen eats a doughnut?
2743,5079,7,23,124,154,1.2402597402597402,0.04227548064677721,652,I wish I knew how to swim.
10011,5086,8,26,141,175,1.24,0.039670233450325,652,Global warming has certainly had its effect on the North Pole.
780,5086,4,28,118,150,1.24,0.039775657232500955,652,"We re going to die, but have slightly more shade."
2647,5086,2,32,116,150,1.24,0.03745840347707648,652,My doctor said take a relaxing vacation and avoid sugar.
2784,5086,4,28,118,150,1.24,0.039775657232500955,652,I'm giving Paleo one more week and then I'm going over
3057,5086,9,18,123,150,1.24,0.0450503074500306,652,I wonder if the owners of that abandoned amusement park still think global warming's not real.
4551,5086,8,20,122,150,1.24,0.044045939003832205,652,Simple sugars?! It looks pretty complex to me.
4822,5086,3,30,117,150,1.24,0.03863440758785399,652,Too bad I’m on a sugar-free diet.
3152,5093,9,23,139,171,1.239766081871345,0.041126881558970166,652,Dang sharks are at it again!
6987,5093,5,31,135,171,1.239766081871345,0.03763273293753654,652,The witch from Hansel & Gretel has really upped her game.
1660,5093,9,23,139,171,1.239766081871345,0.041126881558970166,652,"And to think that back in the States, they think this is just a raft of plastic straws."
9507,5096,1,33,112,146,1.2397260273972603,0.03676168257401895,652,"We haven’t had water for days, Will. It’s not what you think. Trust me on this one."
8544,5096,7,21,118,146,1.2397260273972603,0.043797958552999845,652,"Well, the second Fyre Festival looks promising."
7131,5096,4,27,115,146,1.2397260273972603,0.04043317004071793,652,It's not a mirage. There's cheesecake.
5539,5096,5,25,116,146,1.2397260273972603,0.041585027964775624,652,"You can't have your cake island and eat it, too."
5289,5096,5,25,116,146,1.2397260273972603,0.041585027964775624,652,Sharks or sugars... who knows
9379,5096,5,25,116,146,1.2397260273972603,0.041585027964775624,652,They call it the 'Plane Crash Diet.'
1634,5096,7,21,118,146,1.2397260273972603,0.043797958552999845,652,If I weren't watching my weight . . .
1306,5096,3,29,114,146,1.2397260273972603,0.03924752130074012,652,"No, I didn’t pack a spare toothbrush."
647,5096,6,23,117,146,1.2397260273972603,0.0427058293693113,652,20 minutes on the keto diet and i'm hallucinating
631,5096,6,23,117,146,1.2397260273972603,0.0427058293693113,652,Think they're gluten free?
284,5096,4,27,115,146,1.2397260273972603,0.04043317004071793,652,Do we really need the empty calories?
3890,5096,8,19,119,146,1.2397260273972603,0.04486350950048216,652,"Sure, we could swim it, but I worry about the health consequences of more refined sugar in my diet."
4006,5108,5,19,97,121,1.2396694214876034,0.04698161147287437,652,My favorite mirage!
1600,5109,7,26,134,167,1.2395209580838322,0.04002883027673873,652,So this is how we will work on delayed gratification issues?
6146,5110,7,20,115,142,1.2394366197183098,0.04461802216354853,652,"You go ahead, I don’t have my insulin.”"
9036,5110,5,24,113,142,1.2394366197183098,0.042320062146136025,652,If only we had some whipped cream.
8395,5110,6,22,114,142,1.2394366197183098,0.04348422450636393,652,I said stop with the 'good ship lollipop' wisecracks but would you listen?
8225,5110,6,22,114,142,1.2394366197183098,0.04348422450636393,652,"Technically it's an unlimited buffet but we really should have read the fine print."""
8223,5110,3,28,111,142,1.2394366197183098,0.03988994131756429,652,What did I tell you Diane? The perfect solution to our utter lack of self control.
7327,5110,5,24,113,142,1.2394366197183098,0.042320062146136025,652,Think any of it is Gluten Free?
6949,5110,6,22,114,142,1.2394366197183098,0.04348422450636393,652,Do you want to reconsider our Keto pledge?
5970,5110,4,26,112,142,1.2394366197183098,0.04112295635269635,652,Is it still important that we watch our weight?
3096,5110,3,28,111,142,1.2394366197183098,0.03988994131756429,652,"In the islands, Christmas comes early."
5501,5110,4,26,112,142,1.2394366197183098,0.04112295635269635,652,Cupcakes and candy canes are the best  hallucinations!
5307,5110,7,20,115,142,1.2394366197183098,0.04461802216354853,652,The grass always looks greener on the other island.
3621,5110,4,26,112,142,1.2394366197183098,0.04112295635269635,652,Our coconuts are more nutricious.
2007,5110,4,26,112,142,1.2394366197183098,0.04112295635269635,652,"Sure, it looks good, but it's just not worth the calories."
329,5110,5,24,113,142,1.2394366197183098,0.042320062146136025,652,"The grass is always greener, Phil."
5916,5110,4,26,112,142,1.2394366197183098,0.04112295635269635,652,At least we don't have to imagine what it looks like.
1441,5110,7,20,115,142,1.2394366197183098,0.04461802216354853,652,Too bad you lost your insulin in the crash
4177,5126,4,20,93,117,1.2393162393162394,0.046462818402408325,652,"And one, and two, and three:  ""On the good ship lollypop......."""
4764,5127,8,23,132,163,1.2392638036809815,0.041587045787783626,652,"I wanted to be stranded alone on a dessert Isle, but I never get what I wish for."
6056,5128,5,23,110,138,1.2391304347826086,0.04309307852185475,652,"With our luck, it's sugar-free!"
7011,5128,5,23,110,138,1.2391304347826086,0.04309307852185475,652,From just our desert to our just dessert  -- now we're talkin'
5853,5128,5,23,110,138,1.2391304347826086,0.04309307852185475,652,Let's wait for cheat day.
8467,5128,3,27,108,138,1.2391304347826086,0.0405640280408239,652,"Tune in next week for the finale of ""The Biggest Loser in... Paradise?"""
4491,5128,8,17,113,138,1.2391304347826086,0.04663017247321444,652,Can't wait for cheat day!
5759,5128,6,21,111,138,1.2391304347826086,0.044303498047984134,652,"Sweet, isn’t it ?"
2444,5128,8,17,113,138,1.2391304347826086,0.04663017247321444,652,Now if we only had the Good Ship Lollipop....
1759,5128,6,21,111,138,1.2391304347826086,0.044303498047984134,652,Ever hear of that fish which dangles a bait over it's mouth?
1591,5128,3,27,108,138,1.2391304347826086,0.0405640280408239,652,"I would volunteer, but I’m trying to lose a few pounds."
1033,5128,8,17,113,138,1.2391304347826086,0.04663017247321444,652,What's a mirage?
4416,5128,4,25,109,138,1.2391304347826086,0.04184766294183874,652,I thought Candy Land was just a game
7543,5139,8,22,129,159,1.2389937106918238,0.04228479750148614,652,"One wish, and you had to leave out the ""s."""
5343,5139,2,34,123,159,1.2389937106918238,0.03619855141219937,652,This is the third hallucination you have had in a week.
7133,5139,6,26,127,159,1.2389937106918238,0.040358160363694384,652,"That's good, but I was hoping for some of the great humor these situations are famous for."
7135,5139,6,26,127,159,1.2389937106918238,0.040358160363694384,652,"Well yeah, but the elementary school is only a 4."
5172,5143,3,21,89,113,1.238938053097345,0.045800811460775734,652,"Aw shucks, missed it by one S"
4723,5144,5,22,107,134,1.2388059701492538,0.04390733102351806,652,I hear they use artificial sweeteners.
5261,5144,4,24,106,134,1.2388059701492538,0.042610243685934766,652,"Our ship's name was the Lollipop, why?"
8989,5144,7,18,109,134,1.2388059701492538,0.04639283801274597,652,I’d rather be desserted.
9362,5144,6,20,108,134,1.2388059701492538,0.0451671846393246,652,"On Monday morning it seemed like a good idea to cut out all sugar and carbs, by Monday afternoon life no longer seemed worth living."
8592,5148,5,27,123,155,1.238709677419355,0.03998729476451437,652,They all died from obesity-related diseases.
8269,5148,4,29,122,155,1.238709677419355,0.03892552584131375,652,"I call it ""Island Pt. 2,"" but, sure, ""Candy Island"" sounds good too."
3923,5148,8,21,126,155,1.238709677419355,0.04301563999603261,652,I'm more ambivalent about sea level rise than I once was.
6599,5148,5,27,123,155,1.238709677419355,0.03998729476451437,652,this is nothing compared to the eruption
1622,5148,2,33,120,155,1.238709677419355,0.0367099741337424,652,"I dunno, man, I'm trying to watch my carbs."
1472,5148,7,23,125,155,1.238709677419355,0.04203044258281022,652,We would have to go off of the Keto diet.
1833,5148,7,23,125,155,1.238709677419355,0.04203044258281022,652,Not me. Too much gluten.
76,5155,5,21,104,130,1.2384615384615385,0.04476646637927324,652,You think they're gluten-free?
600,5155,5,21,104,130,1.2384615384615385,0.04476646637927324,652,I had hoped this would be an opportunity to drop a few pounds.
2587,5155,5,21,104,130,1.2384615384615385,0.04476646637927324,652,Guess I picked the wrong week to lay off the carbs.
3656,5155,7,17,106,130,1.2384615384615385,0.04735565099162219,652,I've never been much for sweets.
6202,5155,3,25,102,130,1.2384615384615385,0.042018035929025456,652,I don't know ... Fyre was pretty bad too.
8003,5155,3,25,102,130,1.2384615384615385,0.042018035929025456,652,Only you would wish for the Good Ship Lollipop!
7859,5161,5,26,120,151,1.2384105960264902,0.0406444870629624,652,That will kill you faster then this.
7633,5161,5,26,120,151,1.2384105960264902,0.0406444870629624,652,No. I'm on a paleo diet.
6947,5161,8,20,123,151,1.2384105960264902,0.043782130953883155,652,We should have booked the Good Ship Lollipop.
6839,5161,5,26,120,151,1.2384105960264902,0.0406444870629624,652,"If you’re worried about spoiling our appetites, I feel like we won’t be having dinner for a while."
5725,5161,7,22,122,151,1.2384105960264902,0.042761837777537365,652,I don’t know ... it was just there when I woke up.
597,5161,7,22,122,151,1.2384105960264902,0.042761837777537365,652,"I really picked the wrong month to go Paleo."""
4413,5161,6,24,121,151,1.2384105960264902,0.04171659800800959,652,Want to jump the shark?
2986,5161,4,28,119,151,1.2384105960264902,0.03954331938344031,652,"If we swim both ways,we burn more calories."
2032,5161,8,20,123,151,1.2384105960264902,0.043782130953883155,652,You can go but I'm staying on this Keto diet.
4840,5161,4,28,119,151,1.2384105960264902,0.03954331938344031,652,"I'd swim over, but my dentist said no sweets."
8446,5161,5,26,120,151,1.2384105960264902,0.0406444870629624,652,And just abandon my New Year’s resolution? Please - that’s such a cliche.
7586,5172,3,29,115,147,1.2380952380952381,0.039013715732043514,652,"First you look like a cheeseburger to me,and now THIS!"
6545,5172,1,33,113,147,1.2380952380952381,0.036547148931067024,652,It's not the sharks it's the gluten.
7786,5172,3,29,115,147,1.2380952380952381,0.039013715732043514,652,I would have booked a desserted island if I had known it would be so deserted.
6520,5172,1,28,97,126,1.2380952380952381,0.03972695926593183,652,I bet it's all coconut flavored.
8628,5172,5,20,101,126,1.2380952380952381,0.045674585936311615,652,Do you think it's a mirage?
9473,5172,5,30,133,168,1.2380952380952381,0.03798279670589456,652,Is that a mirage or are we playing candy land?
8166,5172,7,21,119,147,1.2380952380952381,0.043529551521729604,652,If only we had a gingerbread boat ...
5578,5172,9,22,137,168,1.2380952380952381,0.041567256865472406,652,Legend has it that's the island where the cruise ship's dessert chef washed up.
370,5172,7,21,119,147,1.2380952380952381,0.043529551521729604,652,"God, I miss gluten!"
4914,5172,9,22,137,168,1.2380952380952381,0.041567256865472406,652,"True. We both have diabetes and neither of us is a strong swimmer, but still..."
4106,5172,6,23,118,147,1.2380952380952381,0.042445658147416666,652,It's just as well.  I've been watching my sugars.
4104,5172,8,19,120,147,1.2380952380952381,0.04458710369376402,652,Why would Thiebaud have an installation way out here?
3334,5172,5,25,117,147,1.2380952380952381,0.04133335136970877,652,I've always wondered what it was like to live the sweet life.
2624,5172,5,25,117,147,1.2380952380952381,0.04133335136970877,652,"And here we are with our darn Diabetes."""
2300,5172,3,24,99,126,1.2380952380952381,0.04280420010332235,652,"It makes our coconut water suck, doesn’t it?"
1715,5172,5,30,133,168,1.2380952380952381,0.03798279670589456,652,"It’s just a mirage, one of the unanticipated symptoms of ketosis."
5551,5172,3,29,115,147,1.2380952380952381,0.039013715732043514,652,I'll stay here; I'm on a diet
3222,5189,7,25,132,164,1.2378048780487805,0.04044382392608217,652,"Yeah, but those candy canes don't look like they cast much shade."
449,5189,8,23,133,164,1.2378048780487805,0.04135842831698483,652,Some genies aren't certified.
1866,5189,8,23,133,164,1.2378048780487805,0.04135842831698483,652,Remember how huge The Big Rock Candy Mountain seemed to us when we were kids?
8161,5192,8,18,117,143,1.2377622377622377,0.04543370560766492,652,"That extra ""S"" really makes a difference."
9908,5192,4,26,113,143,1.2377622377622377,0.04086868459206661,652,It's out of our points!
9464,5192,4,26,113,143,1.2377622377622377,0.04086868459206661,652,"Well, at least the grass isn't greener on the other side."
9248,5192,3,28,112,143,1.2377622377622377,0.039645382127636096,652,You should see it when the sugarplum fairies are on spring break!
8336,5192,5,24,114,143,1.2377622377622377,0.04205641968267577,652,"Keto this, keto that. If it’s so great, that Island would be covered in cauliflower and unsalted nuts. Well, it’s not."
7032,5192,6,22,115,143,1.2377622377622377,0.04321152037090217,652,I can't believe we gave up sweets for lent.
8744,5192,6,22,115,143,1.2377622377622377,0.04321152037090217,652,"Like, none of that stuff is Paleo!"
3100,5192,7,20,116,143,1.2377622377622377,0.04433653740431731,652,I picked a bad month to go on a diet
2312,5192,8,18,117,143,1.2377622377622377,0.04543370560766492,652,Is this what it feels like to be on Keto?
1986,5192,4,26,113,143,1.2377622377622377,0.04086868459206661,652,Doesn't that grass looker greener?
1810,5192,2,30,111,143,1.2377622377622377,0.03838311175252409,652,"It get's better, they're building a wall."
972,5192,5,24,114,143,1.2377622377622377,0.04205641968267577,652,Are you seeing what I'm seeing?
5287,5192,5,24,114,143,1.2377622377622377,0.04205641968267577,652,It just suddenly occurred to me that getting stuck here is just desserts for us criminals.
5338,5205,6,17,99,122,1.2377049180327868,0.048066925254456445,652,"Well, no offense, but being alone on a desserted island doesn't look so bad after all."
9830,5205,5,19,98,122,1.2377049180327868,0.04663631960750775,652,Very tempting yes. But all I can think about is Hansel and Gretel.
8330,5207,8,22,130,160,1.2375,0.04204622718063757,652,"It’s tempting now, but after 10 days on the coconut-water cleanse you’ll see that dessert island for what it really is ... cavities, diabetes and sand."
8279,5207,6,26,128,160,1.2375,0.040132935548290886,652,Fyre Festival delivery snafu. Hungry?
7510,5207,3,32,125,160,1.2375,0.0370783421840769,652,​I’ve been so disgusted with myself since the holidays; I really shouldn’t.
6726,5207,6,26,128,160,1.2375,0.040132935548290886,652,"You know, I think things are better on the other side."
1504,5207,6,26,128,160,1.2375,0.040132935548290886,652,"Just don’t get roped into the talk, that there is one pricey timeshare."
1097,5207,5,28,127,160,1.2375,0.03914123354624906,652,Looks like the Good Ship Lollipop made a happy landing.
1516,5207,5,28,127,160,1.2375,0.03914123354624906,652,"Gotta hand it to you, this is one helluva view."
6962,5214,5,23,111,139,1.2374100719424461,0.042816509050704825,652,"To avoid the same mistake choosing in the future, remember the double-S means you want more."
9314,5214,4,25,110,139,1.2374100719424461,0.04158111389481739,652,You go ahead.  No way I'm eating dessert before supper.
9191,5214,5,23,111,139,1.2374100719424461,0.042816509050704825,652,"Seriously, this may be the moment to forget about that allergy."
9073,5214,5,23,111,139,1.2374100719424461,0.042816509050704825,652,It's disconcerting how quickly that ambush predator adapted to our presence.
9472,5214,7,19,113,139,1.2374100719424461,0.04518608498641714,652,"Drat, I didn't save room for dessert!"
8814,5214,5,23,111,139,1.2374100719424461,0.042816509050704825,652,I heard it was surrounded by diabetic sharks
7385,5214,5,23,111,139,1.2374100719424461,0.042816509050704825,652,"Remember, we have to wait ninety minutes before we swim to our next meal"
6968,5214,6,21,112,139,1.2374100719424461,0.044017245050598064,652,This is my 27th deserted island gig... you'd think these cartoons would get better than this...
6807,5214,4,25,110,139,1.2374100719424461,0.04158111389481739,652,Do you think it’s sugar free?
1255,5214,10,13,116,139,1.2374100719424461,0.04852396851109407,652,...and then he pulled us out of The Paris Agreement...
5729,5214,6,21,112,139,1.2374100719424461,0.044017245050598064,652,It sucks to have a gluten allergy.
4977,5214,3,27,109,139,1.2374100719424461,0.04030787290565533,652,"Oh, double “s”?"
4078,5214,3,27,109,139,1.2374100719424461,0.04030787290565533,652,"Sure, but our grass is greener."
2566,5214,6,21,112,139,1.2374100719424461,0.044017245050598064,652,Its actually a submerged part of the Big Rock Candy Mountain chain.
967,5214,6,21,112,139,1.2374100719424461,0.044017245050598064,652,You go ahead. I didn't bring my fat pants.
746,5214,4,25,110,139,1.2374100719424461,0.04158111389481739,652,I can't even look at refined sugar without it going straight to my waistline
604,5214,6,21,112,139,1.2374100719424461,0.044017245050598064,652,It's obvious that you do not know the difference between dessert and desert!
5739,5214,5,23,111,139,1.2374100719424461,0.042816509050704825,652,I’ll bet none of it is gluten free.
280,5232,4,20,94,118,1.2372881355932204,0.04611200470995581,652,No chocolate?...I think I’ll pass.
8590,5233,6,25,125,156,1.2371794871794872,0.04078649800021505,652,You're just dehydrated.
8464,5233,6,25,125,156,1.2371794871794872,0.04078649800021505,652,"Now that we’ve finished off Broccoli Island, whaddya say we go polish off Candy Cane Island?"
7423,5233,6,25,125,156,1.2371794871794872,0.04078649800021505,652,Now I understand why our friends find your veganism insufferable
7355,5233,3,31,122,156,1.2371794871794872,0.037621795030343366,652,‘Lately I’ve begun to reconsider my hardline stance on selling out.’
6204,5233,6,25,125,156,1.2371794871794872,0.04078649800021505,652,This must mean the Good Ship Lollipop will be here soon.
4514,5233,3,31,122,156,1.2371794871794872,0.037621795030343366,652,In know it's a mirage but I'm going to swim for it anyway.
4307,5233,4,29,123,156,1.2371794871794872,0.038705457589905345,652,Thank Heavens I’m on a low carb diet.
3072,5233,7,23,126,156,1.2371794871794872,0.041788173028505786,652,Ever since I started this fast I just don't even want sugar anymore.
906,5233,7,23,126,156,1.2371794871794872,0.041788173028505786,652,Do they have mirages in the ocean?
4755,5233,6,25,125,156,1.2371794871794872,0.04078649800021505,652,You think it’s real?
1466,5243,8,16,111,135,1.237037037037037,0.04726623535557376,652,"Dang...why couldn't we have ended up on a ""dessert"" island?"
1740,5243,6,20,109,135,1.237037037037037,0.04486624973921271,652,"If my wife finds out, she'll kill me"
3481,5243,8,16,111,135,1.237037037037037,0.04726623535557376,652,"I said two 'S's, Randy, now we're stuck on the desert isle."
4760,5243,3,26,106,135,1.237037037037037,0.04100372430793054,652,I wonder if Katy Perry is over there
6494,5243,5,22,108,135,1.237037037037037,0.04361676336166934,652,We must first eat our vegetables.
6676,5243,6,20,109,135,1.237037037037037,0.04486624973921271,652,"If only we had ""Chutes and Ladders""."
7980,5243,7,18,110,135,1.237037037037037,0.04608186937587219,652,It's a totally dessertic island.
8213,5250,6,24,122,152,1.236842105263158,0.0414709098441645,652,Why did we have to sign up for the low-carb cruise?
7657,5250,5,17,92,114,1.236842105263158,0.04874234413978753,652,"I’m not saying you don’t have nice buns, I’m just saying that the ones over there look gorgeous."
7537,5250,6,24,122,152,1.236842105263158,0.0414709098441645,652,"I would, but I gave up sweets for lent!"
6285,5250,5,26,121,152,1.236842105263158,0.04040665771332917,652,What happened to the cigarette trees?
7482,5250,10,16,126,152,1.236842105263158,0.04547955437628567,652,Not sure why you thought THIS was the best island to open a dental office.
3473,5250,4,28,120,152,1.236842105263158,0.03931360593765812,652,I'm waiting for a Groupon deal.
281,5250,3,30,119,152,1.236842105263158,0.038189281691081746,652,"If you have to swim off the calories, they don't taste as good"
5857,5250,5,26,121,152,1.236842105263158,0.04040665771332917,652,...and all we got was mushrooms.
2266,5250,6,24,122,152,1.236842105263158,0.0414709098441645,652,The grass is always greener when it's made of mint frosting.
1154,5250,4,28,120,152,1.236842105263158,0.03931360593765812,652,Good thing we both went Paleo.
7399,5260,5,30,134,169,1.2366863905325445,0.03778365266808646,652,It's just as well. I'm avoiding carbs.
1569,5261,4,23,104,131,1.2366412213740459,0.04311976666223454,652,"You see desserts. They're deli sandwiches to me. 
Let's just agree to disagree."
2254,5261,6,19,106,131,1.2366412213740459,0.045762363369893325,652,Maybe I'll start eating carbs again.
2964,5261,5,21,105,131,1.2366412213740459,0.04446070275087714,652,As I don't have any teeth left - I say let's go for it!
5253,5261,5,21,105,131,1.2366412213740459,0.04446070275087714,652,It's not a mirage -- mirages can only happen in a desert
6517,5261,2,27,102,131,1.2366412213740459,0.040304275862654476,652,"It’s a type of mirage known as “Fata Morgana,” and it triggers an irresistible urge to play board games."
7111,5261,8,15,108,131,1.2366412213740459,0.04826047580982554,652,"Man, I should have paid better attention in spelling class"
7875,5261,5,21,105,131,1.2366412213740459,0.04446070275087714,652,"Oh, look! It's the birds and the bees
And the cigarette trees
with lemonade springs
and the bluebird sings ... 
It's the Big Rock Candy Mountain."
4245,5268,8,28,150,186,1.2365591397849462,0.03796302742929333,652,Can you even imagine being out here and needing a dentist?
6466,5269,7,21,120,148,1.2364864864864864,0.043264352955627354,652,"I know it looks tempting, but I once saw a headline that read: Sugar Kills!"
2348,5269,7,21,120,148,1.2364864864864864,0.043264352955627354,652,"It was called the good ship
Loppypop   But it went off course"
5813,5269,6,23,119,148,1.2364864864864864,0.04218857159601243,652,It's just a mirage ... Trump Island ain't that sweet!
1211,5269,4,27,117,148,1.2364864864864864,0.03995019707832988,652,"You decide, which is worse, swimming with sharks or tooth decay."
2166,5269,3,29,116,148,1.2364864864864864,0.038782593817847745,652,Wish we didn’t start Weight Watchers yesterday.
4392,5269,4,27,117,148,1.2364864864864864,0.03995019707832988,652,Which one has the double 'S' again?
189,5269,8,19,121,148,1.2364864864864864,0.044314025996588666,652,Sspelling countss.
60,5276,4,31,130,165,1.2363636363636363,0.037366079264409956,652,"Well, I'm sick of coconuts too but think of the tooth decay!"
1287,5276,7,25,133,165,1.2363636363636363,0.0402237910895572,652,"I love you, sugar."
2139,5276,7,25,133,165,1.2363636363636363,0.0402237910895572,652,Would you rather be on that dessert-ed island?
3787,5276,8,23,134,165,1.2363636363636363,0.04113226470331693,652,"I was my junior high spelling champion,” you said. “I say there’s only one s in dessert,” you said."
5773,5276,6,27,132,165,1.2363636363636363,0.03929431943180782,652,and they all died from obesity
3093,5281,7,16,104,127,1.236220472440945,0.048029139742349944,652,No kidding! I’m on the paleo diet too.
7432,5281,6,18,103,127,1.236220472440945,0.046709890681067734,652,What a lousy time to be diabetic.
6936,5281,2,26,99,127,1.236220472440945,0.04101068616380095,652,I told them my favorite dessert was coconut Mounds.
1394,5281,5,20,102,127,1.236220472440945,0.045352282307337274,652,No. I'm keto
1891,5281,5,20,102,127,1.236220472440945,0.045352282307337274,652,"Best not, I think our cannibal neighbor just set another trap."
6573,5281,3,24,100,127,1.236220472440945,0.04250718476420963,652,The real issue is the 90% of it you don't see.
6485,5287,5,24,115,144,1.2361111111111112,0.04179596617581002,652,"OK, today I get to crack wise about being marooned on a DESSERT island. Your turn to look out for the Good Ship Lollipop."
9303,5287,6,22,116,144,1.2361111111111112,0.04294214579750938,652,"To be honest,I would have wished for a Russ & Daughters"
8880,5287,8,18,118,144,1.2361111111111112,0.0451472931629876,652,Fake News?
7354,5287,5,24,115,144,1.2361111111111112,0.04179596617581002,652,The sprinkles are always sweeter on the other side.
9907,5287,4,26,114,144,1.2361111111111112,0.040617455501845,652,"Candy, candy everywhere, and not a piece to eat!"
5762,5287,8,18,118,144,1.2361111111111112,0.0451472931629876,652,"I don't know if it's worth it, I'm more a savoury type of guy."""
4820,5287,6,22,116,144,1.2361111111111112,0.04294214579750938,652,Want to play Candyland?
4613,5287,9,16,119,144,1.2361111111111112,0.046210422818557334,652,I say we go today. There could be a wall around it tomorrow.
2892,5287,6,22,116,144,1.2361111111111112,0.04294214579750938,652,"No Bob, I have not forgotten how you feel about puns.”"
1289,5287,3,28,113,144,1.2361111111111112,0.039403712950929655,652,I think we are not on our sweet spot
862,5287,6,22,116,144,1.2361111111111112,0.04294214579750938,652,"Yeah, but can you imagine the view from there?"
5450,5287,6,22,116,144,1.2361111111111112,0.04294214579750938,652,"It was a new bakery that, tragically, last Christmas, forgot the maxim ""location, location, location."""
3095,5299,6,26,129,161,1.236024844720497,0.03991015526199483,652,You go ahead. I'm trying to cut back on sugar.
5039,5299,8,22,131,161,1.236024844720497,0.041810285769677824,652,"IT DOESN'T MATTER, I AM ON A NO SUGER DIET."
7394,5301,8,13,102,123,1.2357723577235773,0.050429715240745826,652,This is my third time at Fyre Fest.
2796,5301,6,17,100,123,1.2357723577235773,0.04771368919516814,652,"Is it my imagination, or do you also see a steak and lobster dinner?"
4387,5301,7,15,101,123,1.2357723577235773,0.04909048948562143,652,"I would, but I'm on a no-swim diet."
7199,5304,5,23,112,140,1.2357142857142858,0.04254338730354498,652,"Like Voltaire said, ""Illusion is the first of all pleasures"""
9239,5304,8,17,115,140,1.2357142857142858,0.04602460833093375,652,"It’s okay, you go. I can’t do carbs."
9034,5304,4,25,111,140,1.2357142857142858,0.041317851835987615,652,I told you that coconut had gone bad...
8857,5304,4,25,111,140,1.2357142857142858,0.041317851835987615,652,"I'm not that worried about the piranhas, but my cholesterol would go through the roof."
9677,5304,6,21,113,140,1.2357142857142858,0.04373459415815174,652,It would be worth the swim if I wasn't trying to watch my figure.
7082,5304,4,25,111,140,1.2357142857142858,0.041317851835987615,652,Looks much sweeter over there.
8526,5304,7,19,114,140,1.2357142857142858,0.044894205072559736,652,"I would swim over, but before I do, are you seeing what I'm seeing, or am I just hallucinating."
6721,5304,8,17,115,140,1.2357142857142858,0.04602460833093375,652,"We still need fresh water, though."
4577,5304,4,25,111,140,1.2357142857142858,0.041317851835987615,652,"I guess we've got dessert covered.
Now we just need some fish for our entree."
4293,5304,4,25,111,140,1.2357142857142858,0.041317851835987615,652,"sweetie,you remembered"
3242,5304,5,23,112,140,1.2357142857142858,0.04254338730354498,652,"yeah, but I don't do gluten"
1773,5304,7,19,114,140,1.2357142857142858,0.044894205072559736,652,"Damn my computer spell check.  I know I typed ""dessert island""  on the Expedia website."
6835,5304,5,23,112,140,1.2357142857142858,0.04254338730354498,652,"It’s for the best, diabetes is a killer."
8974,5317,4,29,124,157,1.2356687898089171,0.0384877957123121,652,"Nah, you go ahead. I'm strictly paleo."
7205,5317,6,25,126,157,1.2356687898089171,0.04055402635311177,652,I'm starting to regret taking the gluten-free option.
4698,5317,6,25,126,157,1.2356687898089171,0.04055402635311177,652,They survived the wreck of the Good Ship Lollipop!
4660,5317,7,23,127,157,1.2356687898089171,0.04154862658111567,652,They're out of salt water taffy until low tide!
586,5317,8,21,128,157,1.2356687898089171,0.04251996811034903,652,Sure it's tempting ... until high tide.
363,5317,5,27,125,157,1.2356687898089171,0.03953441204976719,652,"We really picked the wrong time to start the keto diet, didn't we?"
307,5317,5,27,125,157,1.2356687898089171,0.03953441204976719,652,"You go ahead, I'm gluten free."
2453,5317,7,23,127,157,1.2356687898089171,0.04154862658111567,652,You have to learn to see past the spam to the deeper hallucinations.
7684,5325,6,20,110,136,1.2352941176470589,0.04456922123197992,652,Lovely antennas on that one!
9243,5325,5,26,122,153,1.2352941176470589,0.04017152966801222,652,"Yeah, I know how to swim but I'm on a diet"
8895,5325,5,22,109,136,1.2352941176470589,0.04332993214109077,652,I wonder if those cupcakes are gluten-free.
8779,5325,4,24,108,136,1.2352941176470589,0.04205413841083768,652,But I thought I said dessert island.
8762,5325,7,22,124,153,1.2352941176470589,0.04225814027946561,652,We are so lucky to have such a great view of the mirage!
8758,5325,7,26,137,170,1.2352941176470589,0.03939511105824237,652,Think the sharks are gone?
7797,5325,6,20,110,136,1.2352941176470589,0.04456922123197992,652,I really wish that genie hadn't been such a stickler for spelling.
6891,5325,4,24,108,136,1.2352941176470589,0.04205413841083768,652,I still think we made the right choice enrolling on Diet Island.
159,5325,4,24,108,136,1.2352941176470589,0.04205413841083768,652,You think Uber Eats delivers out here...?
6180,5325,5,22,109,136,1.2352941176470589,0.04332993214109077,652,"Sure, but once you finish with desssert, you’re left on a desert island with no shade.  Just look at our beautiful palm tree."
5411,5325,7,14,98,119,1.2352941176470589,0.05021798707662224,652,"Relax. The ""Good Ship Lollipop"" ferry should be arriving at any minute."
3946,5325,5,22,109,136,1.2352941176470589,0.04332993214109077,652,"No, thanks. I’ll stay here. I can’t eat sweets on an empty stomach."
3756,5325,2,28,106,136,1.2352941176470589,0.03937874596442371,652,I call dibs on the strawberry. Your turn.
3568,5325,6,20,110,136,1.2352941176470589,0.04456922123197992,652,"It may look like the Good Ship Lollipop to you, but it looks like one helluva huge angler fish to me!"
2018,5325,6,24,123,153,1.2352941176470589,0.04122803788532132,652,Nice.  Let’s do the women’s beach volleyball one again.
1005,5325,7,22,124,153,1.2352941176470589,0.04225814027946561,652,"Go for it, man. I'm on a low-carb diet."
6587,5325,7,18,111,136,1.2352941176470589,0.04577497070560295,652,"If you think its hat is in poor taste, wait until you can see its handbag."
9963,5342,4,31,131,166,1.2349397590361446,0.03716758442224853,652,Think there's a milk island out there somewhere?
2608,5342,3,33,130,166,1.2349397590361446,0.03617195020533435,652,I heard that's where the good ship Lolipop washed ashore.
6423,5342,5,29,132,166,1.2349397590361446,0.03813723484880302,652,"Yeah, they’re baked fresh everyday."
7748,5345,7,21,121,149,1.2348993288590604,0.043002307111602654,652,"Listen Bob, I understand that YOU can’t swim, but this suicide pact seems a little unfair"
10012,5345,8,19,122,149,1.2348993288590604,0.04404421799155704,652,I am getting sick of that commercial.
9560,5345,5,25,119,149,1.2348993288590604,0.04083881699787816,652,"Enough, desert, one 's' or two, homonym, homophone, homograph...can't we discuss something more important?"
9461,5345,5,25,119,149,1.2348993288590604,0.04083881699787816,652,"Gluten, fats, sugar. I'll stick with the coconut thanks."
8118,5345,4,27,118,149,1.2348993288590604,0.03971289780687098,652,That's amore!
8088,5345,5,25,119,149,1.2348993288590604,0.04083881699787816,652,"Yes, I like coconuts, but that desserted island just looks better..."
5599,5345,12,11,126,149,1.2348993288590604,0.047986164930702846,652,So sweet! I’ve never seen someone sugarcoat a situation so well...
6500,5345,4,27,118,149,1.2348993288590604,0.03971289780687098,652,"I just keep thinking, ""I could have grabbed my toothbrush""."
5563,5345,5,25,119,149,1.2348993288590604,0.04083881699787816,652,I really feel so much better after our annual sugar detox vacay.
2904,5345,8,19,122,149,1.2348993288590604,0.04404421799155704,652,"The witch said it was okay to swim over there, Hansel."
1752,5345,6,23,120,149,1.2348993288590604,0.04193451675354549,652,I won't tell my nutritionist if you don't.
1501,5345,6,23,120,149,1.2348993288590604,0.04193451675354549,652,"Finally, it's cheat day!"
961,5345,5,25,119,149,1.2348993288590604,0.04083881699787816,652,The calories we’d burn avoiding the sharks would make the desserts worthwhile.
489,5345,5,25,119,149,1.2348993288590604,0.04083881699787816,652,Sometimes things are just sweeter on the other side
5585,5345,4,27,118,149,1.2348993288590604,0.03971289780687098,652,Do you think it’s sugarless?
2599,5360,7,17,108,132,1.2348484848484849,0.04670479649701895,652,"I said dessert island, not desert island."
7953,5360,5,21,106,132,1.2348484848484849,0.044158998786431834,652,"Ignore it Tom,this is what the 'Brexit' campaign promised and look where we ended up!"
7434,5360,4,23,105,132,1.2348484848484849,0.042829391226308085,652,Damn the luck. I’m on a low carb diet.
1546,5360,6,19,107,132,1.2348484848484849,0.045449726014839965,652,"For the hundredth time, Forrest, ours is the one with one 's.'"
1140,5360,3,25,104,132,1.2348484848484849,0.041457162611691405,652,"Just like all small communities, the building department hasn't given final approvals for a full set of Arches"
5418,5360,3,25,104,132,1.2348484848484849,0.041457162611691405,652,"Dude, you forgot the second S"
3405,5366,6,30,143,179,1.23463687150838,0.03722249502459677,652,What are the odds they’re gluten free.
7994,5367,6,26,130,162,1.2345679012345678,0.039689781138555175,652,The Good Ship Lollipop crew couldn't swim.
4366,5367,6,26,130,162,1.2345679012345678,0.039689781138555175,652,"I would, but I’m on the desert island cleanse."
8594,5367,6,26,130,162,1.2345679012345678,0.039689781138555175,652,All yours - I’m going carb-free this month.
8916,5370,6,22,117,145,1.2344827586206897,0.04267604187525741,652,Too bad the Good Ship Lollypop didn't stop on our island.
9995,5370,2,30,113,145,1.2344827586206897,0.03792232571568649,652,"Fred, the singular thing that has kept my sanity is that one day this tree will bear fruit and then the cake people will be jealous."
8027,5370,6,22,117,145,1.2344827586206897,0.04267604187525741,652,"Well we finished the first 3 courses on this side, how do we get across to the dessert tray?"
1784,5370,4,26,115,145,1.2344827586206897,0.04036921684789872,652,Did you think Shirley Temple simply made it all up?
3718,5370,3,28,114,145,1.2344827586206897,0.039164885143450165,652,"Crappy time to be on a Paleo diet, eh?"
2621,5370,5,24,116,145,1.2344827586206897,0.04153864597607507,652,"Bali Hai no, Sugar High yes!"
7504,5370,4,26,115,145,1.2344827586206897,0.04036921684789872,652,"Dude, have you ever played Candyland?"
207,5377,6,18,104,128,1.234375,0.04638026319434138,652,That is Baits Island.
2506,5377,7,16,105,128,1.234375,0.04768815691594056,652,"I've thought about it, too, but I'm on the paleo diet."
2869,5377,2,26,100,128,1.234375,0.04073085844570931,652,"Yeah, I don’t like sweets either."
4826,5377,5,20,103,128,1.234375,0.04503440149389559,652,"Back in civilization we would say “ no” to all those carbs, but here, there’s no one to judge us."
7871,5377,7,16,105,128,1.234375,0.04768815691594056,652,Do you also regret not learning to swim?
7886,5377,5,20,103,128,1.234375,0.04503440149389559,652,At least we've been able to keep Disney from buying this island!
8767,5377,3,24,101,128,1.234375,0.04221414840770096,652,My doctors told me to avoid sugar.
9312,5384,6,25,127,158,1.2341772151898733,0.040324133704382245,652,"Just your luck, the Good  Shop Lollipop dropped us on 
the wrong island."
7462,5384,7,23,128,158,1.2341772151898733,0.04131175878720662,652,"Sorry, I have a strict rule. No candy canes until the day after Thanksgiving."
1178,5384,7,23,128,158,1.2341772151898733,0.04131175878720662,652,They call it the Island of Misfit Desserts.
1843,5384,6,25,127,158,1.2341772151898733,0.040324133704382245,652,Forget it.  You’ll ruin your appetite
4022,5384,5,27,126,158,1.2341772151898733,0.039311704413894956,652,How do they do it? That's the third time this week it's floated past us.
8297,5389,8,17,116,141,1.2340425531914894,0.045727595122175314,652,"Let's head on over, and don't say it will just make us fat"
8942,5389,3,27,111,141,1.2340425531914894,0.03980486581674406,652,What do you suggest we wash it down with?
9723,5389,5,23,113,141,1.2340425531914894,0.042273651224804754,652,"Well, at least we have each other"
8806,5389,5,23,113,141,1.2340425531914894,0.042273651224804754,652,We chose the salad first.
8429,5389,6,21,114,141,1.2340425531914894,0.04345547963686692,652,Do you think it's an hallucination?
6072,5389,4,25,112,141,1.2340425531914894,0.041057818564589114,652,Nobody’s going. No toothpaste.
2293,5389,6,21,114,141,1.2340425531914894,0.04345547963686692,652,You go for it . I’m on Atkins.
3455,5389,5,23,113,141,1.2340425531914894,0.042273651224804754,652,"Come on, Hansel. You can swim that far."
3034,5389,3,27,111,141,1.2340425531914894,0.03980486581674406,652,"It's tempting, but I am on a low carb diet."
2565,5389,4,25,112,141,1.2340425531914894,0.041057818564589114,652,You go. I'm trying to cut back on sugar.
42,5389,7,19,115,141,1.2340425531914894,0.044606006692640324,652,This gives new meaning to being stranded on a deserted island!
4502,5389,7,19,115,141,1.2340425531914894,0.044606006692640324,652,diabetes island fucking blows
593,5401,4,32,135,171,1.2339181286549707,0.03645981377388806,652,I guess Mom was right about signing up for swimming lessons back in the day.
7870,5402,6,17,101,124,1.2338709677419355,0.047365516232269395,652,"Let's stowaway on the Good Ship Lollipop, you said."
8393,5402,4,21,99,124,1.2338709677419355,0.044511026059015704,652,The mirages keep getting better and better.
6866,5404,9,18,127,154,1.2337662337662338,0.043984749184063504,652,Thanks but I’m having a colonoscopy tomorrow
8595,5404,4,28,122,154,1.2337662337662338,0.03886188327483504,652,I don't want to be ungrateful and I'm glad we're finally safe BUT to think we missed Candyland by just one island!
7282,5404,8,20,126,154,1.2337662337662338,0.04300901908857444,652,GrubHub promised delivery an hour ago.
5907,5404,5,26,123,154,1.2337662337662338,0.039939058695599196,652,We have to lay off the fermented coconut milk!
1650,5404,5,26,123,154,1.2337662337662338,0.039939058695599196,652,You can't escape it - there's sugar in very thing!
1765,5404,3,30,121,154,1.2337662337662338,0.03775398699267786,652,Could this be a dirty trick by the sharks
5801,5404,8,20,126,154,1.2337662337662338,0.04300901908857444,652,It's a shame I gave up sweets.
526,5404,5,26,123,154,1.2337662337662338,0.039939058695599196,652,I really just want another coconut.
466,5404,9,18,127,154,1.2337662337662338,0.043984749184063504,652,Is that the Fyre Festival?
2181,5413,6,20,111,137,1.2335766423357664,0.044276025527601244,652,It's a trick.  The closest dentist is five islands away.
5752,5413,6,20,111,137,1.2335766423357664,0.044276025527601244,652,Actually I'm diabetic.
7536,5413,6,20,111,137,1.2335766423357664,0.044276025527601244,652,Are the rules the same as they are in Candyland?
7642,5413,4,24,109,137,1.2335766423357664,0.04178135975060226,652,So what’s for dessert?
9089,5417,3,33,131,167,1.2335329341317365,0.03598221167952577,652,"It's amazing how auto-correct can really ruin your vacation...""_or_""Honey, I thought you said we were going to vacation on the desserted island.""_or_""Wow honey, that island right over there really puts the extra 's' in desserted island."
7857,5417,6,27,134,167,1.2335329341317365,0.03887356631476411,652,"My bad, I forgot the second ""S""  in dessert."
7807,5419,5,25,120,150,1.2333333333333334,0.04059586016811276,652,At least we don’t have to worry about dessert...
6905,5419,3,29,118,150,1.2333333333333334,0.03832822648601176,652,Don't fall for it. All that sugar isn't good for you.
6613,5419,2,31,117,150,1.2333333333333334,0.0371425293558481,652,"Did it say ""dessert"" island?"
6572,5419,3,29,118,150,1.2333333333333334,0.03832822648601176,652,I'm not sure...I read somewhere that angler fish are getting more creative.
6418,5419,5,25,120,150,1.2333333333333334,0.04059586016811276,652,"It looks inviting, but not much shade under a candy cane."
5400,5419,7,21,122,150,1.2333333333333334,0.04274335948442652,652,The app says that it's arriving now.
4224,5419,4,27,119,150,1.2333333333333334,0.039478328284971595,652,I wish I hadn't sworn off processed foods.
6501,5419,7,21,122,150,1.2333333333333334,0.04274335948442652,652,"Do you want to go over there?"" ""No, I heard the cookies have raisins."
2999,5419,9,17,124,150,1.2333333333333334,0.0447880084089577,652,"But more importantly, where has the rum gone?"
2989,5419,5,25,120,150,1.2333333333333334,0.04059586016811276,652,You go. My doctor told me to lay off sweets.
2902,5419,7,21,122,150,1.2333333333333334,0.04274335948442652,652,It's the first stop for the Good Ship Lollipop.
417,5419,3,29,118,150,1.2333333333333334,0.03832822648601176,652,"Yeah, it's too bad we gave up carbs."
312,5419,6,23,121,150,1.2333333333333334,0.041683441813290076,652,"Best left alone as a mirage, I say."
205,5419,2,31,117,150,1.2333333333333334,0.0371425293558481,652,Dessert island might be a nice change from desert island.
3572,5419,8,19,123,150,1.2333333333333334,0.043777622578526236,652,Damn. I never could get the correct spelling right.
5940,5434,4,30,129,163,1.2331288343558282,0.037503871038797335,652,"The captain dumped us, but he's sending us Christmas treats."
9084,5435,4,23,106,133,1.2330827067669172,0.04254280683002801,652,"Let me guess, Candy Land, again"
6862,5435,5,21,107,133,1.2330827067669172,0.043861276537850824,652,‘what do you think the chances are of one of those being gluten free?’
5661,5435,4,23,106,133,1.2330827067669172,0.04254280683002801,652,Just our luck we’re hypoglycemic
5630,5435,2,27,104,133,1.2330827067669172,0.03977496800591531,652,Candy Land is less magical in real life.
2629,5435,4,23,106,133,1.2330827067669172,0.04254280683002801,652,It's nice but for first class only!
620,5435,6,19,108,133,1.2330827067669172,0.045141253262205396,652,"It's probably just a mirage."""
4221,5435,3,25,105,133,1.2330827067669172,0.04118214718083957,652,I told the travel agent it was spelled with two S’s.
6194,5442,7,20,119,146,1.2328767123287672,0.043512626795434106,652,"It's not a diet, it's a lifestyle change."
7965,5442,8,18,120,146,1.2328767123287672,0.04458499749835465,652,"True,""the big rock candy mountain"" never mentioned ""no global warming""."
7733,5442,4,26,116,146,1.2328767123287672,0.0401239175152433,652,"Yeah, it really was a bad time to start that 30-day no sugar diet."
8793,5442,7,20,119,146,1.2328767123287672,0.043512626795434106,652,We are better off on the carb free island.
7201,5442,3,28,115,146,1.2328767123287672,0.03892885106807658,652,"Go ahead, please! I'm trying to cut back on mirages."
6896,5442,6,22,118,146,1.2328767123287672,0.04241315101886642,652,"The fabled Cocoamo, that's where we want to go."
6820,5442,6,22,118,146,1.2328767123287672,0.04241315101886642,652,Some moron must have designed the spellcheck feature on your GPS.
6107,5442,5,24,117,146,1.2328767123287672,0.04128440465913986,652,"Before we swim there, let's flip a coin, heads it's real, tails it's a mirage."
907,5442,6,22,118,146,1.2328767123287672,0.04241315101886642,652,Giving up sugar and gluten is turning out to be a bad decision.
3967,5442,6,22,118,146,1.2328767123287672,0.04241315101886642,652,"Don't worry, the water is treated with fluoride."
3640,5442,5,24,117,146,1.2328767123287672,0.04128440465913986,652,Looks like the good ship lollipop has been there.
3418,5442,3,28,115,146,1.2328767123287672,0.03892885106807658,652,I'm rethinking my real estate purchase on Paleo Island.
1829,5442,7,20,119,146,1.2328767123287672,0.043512626795434106,652,"There goes another Candyland Cruise, next will be the Chutes and Ladders one."
445,5442,6,22,118,146,1.2328767123287672,0.04241315101886642,652,It's a mirage. They're not really gluten-free.
104,5442,2,30,114,146,1.2328767123287672,0.0376959166779497,652,It's a mirage or they're smarter than we think!
4534,5442,7,20,119,146,1.2328767123287672,0.043512626795434106,652,But then what would we have to look it?
6964,5458,7,23,129,159,1.2327044025157232,0.041077526119455005,652,Genies. They'll get ya every time.
6510,5458,8,21,130,159,1.2327044025157232,0.042035397559610596,652,I'm holding out for the good ship lollipop.
5734,5458,5,27,127,159,1.2327044025157232,0.03909143333640367,652,and I thought we had the sweet life
4111,5458,7,23,129,159,1.2327044025157232,0.041077526119455005,652,"Don't even try. We're on the desert isle trope, so that has to be a mirage trope."
4287,5458,8,21,130,159,1.2327044025157232,0.042035397559610596,652,"Trust me, we'll live longer on this Keto Island."
1985,5458,4,29,126,159,1.2327044025157232,0.0380595410428776,652,"Sure we could go there, but it is all carbs."
4602,5458,6,25,128,159,1.2327044025157232,0.04009677862615026,652,"That one extra ""s"" really makes such a difference."
5805,5465,6,28,138,172,1.2325581395348837,0.03810130334461048,652,I would... but I'm doing low carbs.
9524,5465,5,20,104,129,1.2325581395348837,0.044720855655869474,652,This is the pay off climate change skeptics promised!
6382,5465,5,20,104,129,1.2325581395348837,0.044720855655869474,652,"If it *really* is a mirage, then why has the frosting started to melt?"
5296,5465,7,16,106,129,1.2325581395348837,0.04735190590259928,652,I warned you one more candy gram and you’re off the island
1455,5465,7,26,139,172,1.2325581395348837,0.03898344228723751,652,I prefer our high fiber diet.
4767,5465,3,24,102,129,1.2325581395348837,0.04192501483097662,652,That's the Good Ship Lollipop's port of call.
2865,5465,3,24,102,129,1.2325581395348837,0.04192501483097662,652,"No, I can't. Gotta fit into my tux this weekend."
2521,5465,7,26,139,172,1.2325581395348837,0.03898344228723751,652,Diet be damned!
4839,5465,2,26,101,129,1.2325581395348837,0.040454701056488566,652,It'll just ruin your teeth.
7459,5474,5,23,114,142,1.232394366197183,0.04200724017029981,652,"It looks good now, but all of that will go straight to your thighs."
9985,5474,7,19,116,142,1.232394366197183,0.04432142222965484,652,Any more insulin shots left?
8671,5474,4,25,113,142,1.232394366197183,0.04080095716840726,652,You insisted we go to the all-natural island.
8471,5474,4,25,113,142,1.232394366197183,0.04080095716840726,652,This is the last time we sail on the Good Ship Lollipop.
7575,5474,4,25,113,142,1.232394366197183,0.04080095716840726,652,This is how I stick to a low carb diet.
7298,5474,5,23,114,142,1.232394366197183,0.04200724017029981,652,Candy cane? I say candy can't.
9170,5474,4,25,113,142,1.232394366197183,0.04080095716840726,652,Too bad our health insurance doesn't cover dental.
5165,5474,5,23,114,142,1.232394366197183,0.04200724017029981,652,This was the wrong week to give up sugar.
4865,5474,6,21,115,142,1.232394366197183,0.043179837280752885,652,You just had to book the gluten-free one.
4770,5474,5,23,114,142,1.232394366197183,0.04200724017029981,652,Before global warming it was a mountain top.
3153,5474,4,25,113,142,1.232394366197183,0.04080095716840726,652,It might be a giant octopus who thought we'd said 'macarooned on a dessert island.'
2271,5474,5,23,114,142,1.232394366197183,0.04200724017029981,652,"I know it looks good, but it will go straight to your hips."
255,5474,3,27,112,142,1.232394366197183,0.03955790673166564,652,Yesterday it was a Big Mac supersized meal.
5662,5474,6,21,115,142,1.232394366197183,0.043179837280752885,652,Forget it. You're on a diet.
9334,5488,8,20,127,155,1.232258064516129,0.042757247614920904,652,"Ok, we’ll go but if it’s a mirage again can we just focus on the signal fire?"
7474,5488,8,20,127,155,1.232258064516129,0.042757247614920904,652,"You go ahead, I’m on a diet this week"
5880,5488,6,24,125,155,1.232258064516129,0.040750556591056655,652,"I call ""dibs."""
5360,5488,3,30,122,155,1.232258064516129,0.03753992968556,652,Now the president is bound to find us.
9566,5488,6,24,125,155,1.232258064516129,0.040750556591056655,652,"When our ship comes in, you think they'd let us off there?"
3701,5488,8,20,127,155,1.232258064516129,0.042757247614920904,652,That one was settled by the Good Ship Lollipop!
3172,5488,3,30,122,155,1.232258064516129,0.03753992968556,652,I don't do sugar
1423,5488,5,26,124,155,1.232258064516129,0.03970920147673001,652,"Sure, Candyland® would be nice, but I'd rather see a Battleship® over there."
4884,5488,5,26,124,155,1.232258064516129,0.03970920147673001,652,"Well, at least we won't get fat."
9320,5497,4,21,100,125,1.232,0.04419312455647955,652,"I'd swim over there with you, but it's almost bikini season..."
5303,5497,5,19,101,125,1.232,0.04562964514577153,652,What diet?
9508,5497,7,15,103,125,1.232,0.04837488017822953,652,I can hear Burl Ives singing The Big Rock Candy Mountain.
1118,5497,5,19,101,125,1.232,0.04562964514577153,652,We're in trouble. There goes the Big Rock Candy Mountain.
896,5497,3,23,99,125,1.232,0.04270831300812524,652,Fortunately I'm on a low carb diet
1207,5497,5,19,101,125,1.232,0.04562964514577153,652,"If you ever get another chance, be specific that the wish is about this island."
477,5503,4,24,110,138,1.2318840579710144,0.04151201181565335,652,Are you absolutely sure you're still diabetic?
1915,5503,6,20,112,138,1.2318840579710144,0.04398659080420913,652,"Damn, I picked the wrong island."
2799,5503,4,24,110,138,1.2318840579710144,0.04151201181565335,652,We could try sending our message in a strudel.
4444,5503,1,30,107,138,1.2318840579710144,0.03749516710980172,652,"I dunno, I always thought of it as a mountain."
5946,5503,4,24,110,138,1.2318840579710144,0.04151201181565335,652,Definitely one of my favorite mirages.
8559,5503,4,24,110,138,1.2318840579710144,0.04151201181565335,652,Think of all the carbs you will burn swimming there.
7608,5509,5,25,121,151,1.2317880794701987,0.04035571262730383,652,"I'm wondering if that might be the ""Good Ship Lollypop?"""
8708,5509,8,19,124,151,1.2317880794701987,0.04351418393936839,652,Is it gluten-free?
8239,5509,7,21,123,151,1.2317880794701987,0.04248745677442501,652,"It sure looks nice, but you know, the grass is always greener..."
7052,5509,7,21,123,151,1.2317880794701987,0.04248745677442501,652,I'm holding out for peaches and cream.
9023,5509,5,25,121,151,1.2317880794701987,0.04035571262730383,652,You can get home delivery for online orders
2900,5509,5,25,121,151,1.2317880794701987,0.04035571262730383,652,"Trust me, nothing's worse than eating empty calories."
2785,5509,4,27,120,151,1.2317880794701987,0.03924644341729551,652,"I’m positive I left the bread crumbs leading to it, but the tide must have come in."
107,5509,4,27,120,151,1.2317880794701987,0.03924644341729551,652,"It must be real. If it was a dream, then that would be a *jelly* donut!"
4187,5509,6,23,122,151,1.2317880794701987,0.04143529609412827,652,Life is full of temptations!
4371,5518,10,18,136,164,1.2317073170731707,0.04289881487631261,652,"They do look tempting, but what about the five second rule?"
2441,5519,3,22,96,121,1.2314049586776858,0.043535759309308836,652,"Yeah, but it has no shade and we might get a sugar burn."
1848,5520,4,23,107,134,1.2313432835820894,0.04225994221774406,652,"They're from ""The Bad Ship Lollipop."""
6269,5520,7,17,110,134,1.2313432835820894,0.04607130634298544,652,I was wondering why the flight was so empty. I hate spellcheck.
7555,5520,5,21,108,134,1.2313432835820894,0.043567459954432904,652,Do you think the cupcake is a trap?
7724,5520,4,23,107,134,1.2313432835820894,0.04225994221774406,652,"If you squint, doesn’t that island kinda look like a spaceship?"
9395,5524,3,28,116,147,1.2312925170068028,0.03869556407217128,652,"Ahoy Matey! Well, maybe it's the good submarine Lollipop"
8717,5524,4,26,117,147,1.2312925170068028,0.0398815074812759,652,How about winner takes all?
6979,5524,3,28,116,147,1.2312925170068028,0.03869556407217128,652,"Have I entered the other side, or do you see it too?"
6972,5524,2,30,115,147,1.2312925170068028,0.03747210587554373,652,You take it.  I'm on the coconut water diet.
6474,5524,3,28,116,147,1.2312925170068028,0.03869556407217128,652,"You know, I'm full.  Do you want desert?"
5820,5524,7,20,120,147,1.2312925170068028,0.04324463572890544,652,I’m looking forward to our cheat meal.
7581,5524,6,22,119,147,1.2312925170068028,0.042153416933982606,652,What do you think?  Gluten free?
4490,5524,5,24,118,147,1.2312925170068028,0.04103318899494187,652,I told you another S can make all the difference.
4126,5524,3,28,116,147,1.2312925170068028,0.03869556407217128,652,"If we only had a raft that would be so sweet!
Sorry,​ wrong choice of words."
3564,5524,4,26,117,147,1.2312925170068028,0.0398815074812759,652,Jokes on them. This one isn't deserted either.
2429,5524,6,22,119,147,1.2312925170068028,0.042153416933982606,652,That’s Temptation Island. I went for something more tropical.
52,5524,6,22,119,147,1.2312925170068028,0.042153416933982606,652,"Who says life is fair, where is that written?"
5235,5524,8,18,121,147,1.2312925170068028,0.044308988698020156,652,Any chance they're sugar and gluten-free?
7401,5537,9,19,132,160,1.23125,0.042727264173751923,652,"Dude, there are two esses in ""dessert"". Never rely on spellcheck."
5981,5537,5,27,128,160,1.23125,0.038873560358790825,652,"I go off the diet now, I'll never get to my target weight."
5040,5537,9,19,132,160,1.23125,0.042727264173751923,652,But I haven't had dinner yet
6824,5537,7,23,130,160,1.23125,0.04084588595404767,652,It’s too bad you’re on that no sugar diet.
3780,5537,8,21,131,160,1.23125,0.04179716200380508,652,I don’t won’t the spoil my dinner of salt water and hope.
904,5537,3,31,126,160,1.23125,0.03679566537740604,652,You're sure about this paleo diet?
4916,5537,6,25,129,160,1.23125,0.039871920535256525,652,"Thus the phrase,jumping the shark."
5458,5544,6,24,126,156,1.2307692307692308,0.04051585669853265,652,"Huh, so that’s what they meant by Desseted Island."
9954,5544,8,17,118,143,1.2307692307692308,0.04514475191275534,652,If you were on on a desserted island what would you wish for?
8583,5544,4,25,114,143,1.2307692307692308,0.04054721199177677,652,"We seemed to have skipped the Entree, Surf & Turf mirage."
8485,5544,4,28,124,156,1.2307692307692308,0.038420159709954986,652,"Careful, Jarvis.  These krakens are diabolically cunning."
8242,5544,4,25,114,143,1.2307692307692308,0.04054721199177677,652,The island always looks sweeter on the other side of the lagoon.
8105,5544,4,25,114,143,1.2307692307692308,0.04054721199177677,652,"Finally, the good ship lollipop."
8017,5544,5,23,115,143,1.2307692307692308,0.041744094870360064,652,Looks like the Good Ship lost it’s cargo.
9999,5544,6,21,116,143,1.2307692307692308,0.04290760437014815,652,This reminds me of a funny autocorrect story.
6156,5544,6,27,136,169,1.2307692307692308,0.038461538461538464,652,The main course must be around here somewhere.
5865,5544,5,23,115,143,1.2307692307692308,0.041744094870360064,652,Keto-schmeto .. I say we swim for it !
4814,5544,7,19,117,143,1.2307692307692308,0.04404038565935466,652,"So, I know we both SWORE off gluten for New Years, I know that, but I feel like an exception can be made, right?"
7425,5544,5,23,115,143,1.2307692307692308,0.041744094870360064,652,"I like your Candy Land mirage, but its kind of useless without  Shoots and Ladders."
4203,5544,5,26,125,156,1.2307692307692308,0.039481915582672035,652,"Yea, but swimming back
would be even harder."
180,5544,3,21,93,117,1.2307692307692308,0.04441155916843276,652,Even if there aren’t any sharks it would be really unhealthy.”
289,5544,6,24,126,156,1.2307692307692308,0.04051585669853265,652,"No, I'm good. I'm trying to watch my carbs."
883,5544,7,22,127,156,1.2307692307692308,0.04152406085578367,652,Just an Ile Flotante... It'll pass
1519,5544,4,25,114,143,1.2307692307692308,0.04054721199177677,652,Global warming at the North Pole...
1958,5544,8,14,108,130,1.2307692307692308,0.04827181725294577,652,We should have brought some money.
4612,5544,4,25,114,143,1.2307692307692308,0.04054721199177677,652,"Thank goodness, there aren't any Oreos or I'd chance the swim."
2676,5544,6,21,116,143,1.2307692307692308,0.04290760437014815,652,You can't be over 20 on Sugar Mountain
2853,5544,6,18,106,130,1.2307692307692308,0.045734529320285634,652,"I don't know for sure, but I'm gonna guess we're somewhere near the Calory Islands"
3340,5544,3,27,113,143,1.2307692307692308,0.03931390776896328,652,"``Please, just for me. Let me hear it one more time. `All islands are a like.' Did I get that right, Magellan?''"
4014,5544,1,34,121,156,1.2307692307692308,0.035042398809471804,652,I would go but I am on that paleo diet.
2298,5544,7,22,127,156,1.2307692307692308,0.04152406085578367,652,It's your mirage - you tell ME if they're gluten-free
7153,5568,6,23,123,152,1.230263157894737,0.04119003001210647,652,"You know, I've heard just about every version of ""The Big Rock Candy Mountain"", and none of them mentions climate change."
6959,5568,7,21,124,152,1.230263157894737,0.04223454685608581,652,I bet it's all gluten-free.
6178,5568,6,23,123,152,1.230263157894737,0.04119003001210647,652,"I see a couple of sweet gals,with candy cane tops and a delicious bottom."
3106,5568,6,23,123,152,1.230263157894737,0.04119003001210647,652,The Island is sweeter on the other side!
2663,5568,5,25,122,152,1.230263157894737,0.04011832744092849,652,No reason why we both need to stay on the Paleo Diet.
3847,5568,5,25,122,152,1.230263157894737,0.04011832744092849,652,"Spend enough time on a desert island, and you begin to start hallucinating another ‘s’"
9435,5574,2,28,109,139,1.2302158273381294,0.0386355583194444,652,"Maybe for you, but personally, since we’ve been here, I’ve been sugar, caffeine, gluten, lactose free and have never been thinner"
9220,5574,6,20,113,139,1.2302158273381294,0.04370084695834211,652,I think we picked the wrong things to give up for Lent.
8915,5574,3,26,110,139,1.2302158273381294,0.03996211682594532,652,Not South Beach.
7856,5574,5,22,112,139,1.2302158273381294,0.04249117096905104,652,Did you ever read the story about Hansel and Gretel?
7257,5574,4,24,111,139,1.2302158273381294,0.041246032485147154,652,"If you could only bring one board game to a dinner party, what would it be?"
7050,5574,3,26,110,139,1.2302158273381294,0.03996211682594532,652,"You go ahead, I'm cutting back on sugar this month."
3978,5574,7,18,114,139,1.2302158273381294,0.04487792819896826,652,Do you think the island has gluten-free options?
2746,5574,3,26,110,139,1.2302158273381294,0.03996211682594532,652,That's what you get for booking through a discount site
1937,5574,2,28,109,139,1.2302158273381294,0.0386355583194444,652,You go. I’m on a low-carb diet.
1922,5574,4,24,111,139,1.2302158273381294,0.041246032485147154,652,Have you reached ketosis yet?
771,5574,6,20,113,139,1.2302158273381294,0.04370084695834211,652,"I would swim over, but I just ate lunch."
418,5574,4,24,111,139,1.2302158273381294,0.041246032485147154,652,if only we had some milk
3324,5574,5,22,112,139,1.2302158273381294,0.04249117096905104,652,I think I’ve entered the hallucination phase of the Whole 30.
996,5574,6,20,113,139,1.2302158273381294,0.04370084695834211,652,Soooo . . . Where ya wanna go?
7755,5588,5,19,102,126,1.2301587301587302,0.045303489353958636,652,Stop singing “ Big Rock Candy Mountain” it’s an ISLAND!”
2049,5589,7,23,131,161,1.2298136645962734,0.040616796548675164,652,"Did you order the ""Trip Insurance""?"
3470,5589,8,21,132,161,1.2298136645962734,0.04156156774508471,652,"Look, that's the mysterious island of diabetes..."
8690,5589,5,27,129,161,1.2298136645962734,0.03865804778789121,652,I'm sticking to my New Year's Resolution.
4447,5592,4,26,118,148,1.2297297297297298,0.03964193778960474,652,I think the hunger is really getting to me.
9935,5592,8,18,122,148,1.2297297297297298,0.04403632460984717,652,Mom says we can swim over after we eat all our vegetables.
7876,5592,6,22,120,148,1.2297297297297298,0.041896784583418355,652,Is that the platform for the 2020 Democratic candidates ?
7649,5592,8,18,122,148,1.2297297297297298,0.04403632460984717,652,"Dessert Island is probably overrated anyway, Steve."
5887,5592,6,22,120,148,1.2297297297297298,0.041896784583418355,652,I heard the inhabitants are signing an anti-immigration law.
3805,5592,4,26,118,148,1.2297297297297298,0.03964193778960474,652,I definitely prefer the dessert view to the garden view!
2780,5592,4,26,118,148,1.2297297297297298,0.03964193778960474,652,"They are castaways from the good ship ""Lollipop."""
820,5592,3,28,117,148,1.2297297297297298,0.03846497846558161,652,That’s Fyre Island. Instagram models will be there too.
3388,5592,4,26,118,148,1.2297297297297298,0.03964193778960474,652,Want to go get baked?
2387,5592,5,24,119,148,1.2297297297297298,0.040784946917608304,652,"I don’t care if it’s a mirage, I’m swimming for it."
1909,5592,4,26,118,148,1.2297297297297298,0.03964193778960474,652,"No way, not with my blood glucose levels!"
8951,5603,7,17,111,135,1.2296296296296296,0.045760861733997134,652,They just opened a new Starbucks
6658,5603,5,21,109,135,1.2296296296296296,0.043277474829418086,652,"You go ahead, I’d rather be bikini ready in a few days."
6153,5603,5,21,109,135,1.2296296296296296,0.043277474829418086,652,There's no wall. Let's swim for it.
6626,5603,3,25,107,135,1.2296296296296296,0.040642627727348404,652,I don't think I'll stay for the fireworks.
1157,5603,9,13,113,135,1.2296296296296296,0.04811624575613822,652,"It's not a mirage.  It's Nelly, the Lock Ness monster in her Mardi Gras gear."
622,5603,4,23,108,135,1.2296296296296296,0.041980727817623326,652,"Sure it looks good, Harry, but do you really want an increased risk of heart disease?"
530,5603,6,19,110,135,1.2296296296296296,0.044536481081518545,652,"None of it is Paleo, bro."
5293,5603,7,17,111,135,1.2296296296296296,0.045760861733997134,652,Darling! You remembered my birthday!
6243,5603,2,27,106,135,1.2296296296296296,0.039258946357108034,652,"On the bright side, I’m on a low carb diet."
1825,5612,5,18,99,122,1.2295081967213115,0.046247751562393156,652,"I know that desserted island looks tempting, but the gummy bears will kill you."
2045,5612,5,18,99,122,1.2295081967213115,0.046247751562393156,652,"Naw, man.  Way too many carbs."
6700,5614,6,24,127,157,1.2292993630573248,0.04028379184927872,652,"Location, location: we're sitting on a dental tourism gold mine!"
9852,5614,5,26,126,157,1.2292993630573248,0.039257159454396444,652,Would you rather dive for Danish or bob for babka?
9631,5614,4,28,125,157,1.2292993630573248,0.038202948199056584,652,"I finally reached ketosis, and now this."
9269,5614,4,28,125,157,1.2292993630573248,0.038202948199056584,652,No. It's called an empty calories isle.
8005,5614,7,22,128,157,1.2292993630573248,0.04128490284697449,652,"The sharks are betting we'll risk it.

Patricia Halbert
South Salem, New York"
6138,5614,4,28,125,157,1.2292993630573248,0.038202948199056584,652,"Nah, I’m trying to stay gluten free."
5344,5614,4,28,125,157,1.2292993630573248,0.038202948199056584,652,And to think I gave up sweets for Lent!
3717,5614,8,20,129,157,1.2292993630573248,0.0422623061416699,652,It's just your serotonin talking... lick me. You'll get over it.
3287,5614,5,26,126,157,1.2292993630573248,0.039257159454396444,652,The shuttle runs how often?
1407,5614,7,22,128,157,1.2292993630573248,0.04128490284697449,652,Alright dang it! You can have the candy cane with more stripes. But I get BOTH the cupcakes!
6161,5614,5,26,126,157,1.2292993630573248,0.039257159454396444,652,I hear they got $3B in tax breaks to build it there.
9932,5625,4,25,115,144,1.2291666666666667,0.040296528604337835,652,I told you you should've packed your insulin in case we got deserted.
7588,5625,3,27,114,144,1.2291666666666667,0.03907281817881992,652,Your father easily made the swim.  Diabetes took him.
7211,5625,4,25,115,144,1.2291666666666667,0.040296528604337835,652,Looks like I picked the wrong week to start the Keto Diet
5577,5625,5,23,116,144,1.2291666666666667,0.04148415739394154,652,So that's the proverbial Candy Land
5439,5625,5,23,116,144,1.2291666666666667,0.04148415739394154,652,But is it vegan?
5038,5625,4,25,115,144,1.2291666666666667,0.040296528604337835,652,"Dude, you gotta leave those empty carbs and refined sugar to some other castaways."
4185,5625,2,29,113,144,1.2291666666666667,0.03780952291830754,652,The network didn't approve my idea for a  kid's version of Survivor but maybe we could use it for something else.
3587,5625,8,17,119,144,1.2291666666666667,0.04485878516032959,652,It's nice to have dreams...
1983,5625,6,21,117,144,1.2291666666666667,0.04263871963146187,652,Trumpland.
1168,5625,3,27,114,144,1.2291666666666667,0.03907281817881992,652,Someday the oceans will be filled with the their plastic wrappings.
635,5625,6,21,117,144,1.2291666666666667,0.04263871963146187,652,I wonder if they have anything that's gluten free?
4440,5625,6,21,117,144,1.2291666666666667,0.04263871963146187,652,Looks like the big rock candy mountain is really an island
8311,5637,2,26,103,131,1.2290076335877862,0.03991312570796216,652,"I just started a juice cleanse, too"
9918,5637,2,26,103,131,1.2290076335877862,0.03991312570796216,652,I swore I put in Candy Land into Google Maps.
8303,5637,4,22,105,131,1.2290076335877862,0.04275438255865931,652,I would but I am trying out the paleo diet.
1152,5637,5,20,106,131,1.2290076335877862,0.04410642855716718,652,"No thanks, I’m on a diet."
3976,5637,5,20,106,131,1.2290076335877862,0.04410642855716718,652,Now...aren´t you glad you got away from all that?
2870,5637,5,20,106,131,1.2290076335877862,0.04410642855716718,652,"I will wait for the coconut, it has natural sugar."
4619,5637,2,26,103,131,1.2290076335877862,0.03991312570796216,652,"I must confess, being on Paleo is taking some of the sting out of this...."
5337,5644,2,34,130,166,1.2289156626506024,0.034868555564977435,652,"Just as well, dear. None of those things are on your diet."
7121,5645,6,15,97,118,1.228813559322034,0.048758328646135496,652,Glad we escaped from diabetes island
9130,5646,8,19,126,153,1.2287581699346406,0.042996559916056644,652,"I don't think so, I'm on a diet."
8938,5646,6,23,124,153,1.2287581699346406,0.04094759505275054,652,Now I know how it feels to be on the other side of the wall.
8746,5646,5,25,123,153,1.2287581699346406,0.03988365866615721,652,Are you nuts?  That strawberry is not even organic.
6504,5646,7,21,125,153,1.2287581699346406,0.041984578747553784,652,I told you when we crashed here that if we found a palm tree and grew beards we’d be making jokes in no time. See? A “desserted” island! Get it?
6463,5646,6,23,124,153,1.2287581699346406,0.04094759505275054,652,I guess we will just have to wait for the Good Ship Lollipop to refuel.
6405,5646,7,21,125,153,1.2287581699346406,0.041984578747553784,652,Diabetes seems worth risking right about now.
5627,5646,7,21,125,153,1.2287581699346406,0.041984578747553784,652,Wow! ... That extra “s” isn’t a typo!
112,5646,3,29,121,153,1.2287581699346406,0.03766573515262286,652,Well the good news is it's bad for your teeth.
9721,5654,4,24,112,140,1.2285714285714286,0.04098336105214201,652,"You should go,I'm on this paleo diet right now."
9541,5654,5,22,113,140,1.2285714285714286,0.042218607343789044,652,I'd rather swim to Savory Island.
8484,5654,4,24,112,140,1.2285714285714286,0.04098336105214201,652,Now we wait for the good ship Lollipop to sail by . . .
7691,5654,7,18,115,140,1.2285714285714286,0.04458655236600666,652,You know that stuff isn't good for you.
5670,5654,3,26,111,140,1.2285714285714286,0.03970970863921596,652,"It's such a 20th century mirage, don't you think?"
7119,5654,5,22,113,140,1.2285714285714286,0.042218607343789044,652,"We're lucky, that's all that's left of the wreck of the Good Ship Lollypop."
4890,5654,3,26,111,140,1.2285714285714286,0.03970970863921596,652,The only thing it’s missing is sunshine and lollipops.
3871,5654,5,22,113,140,1.2285714285714286,0.042218607343789044,652,We could sure use those kinds of preservatives.
3509,5654,5,22,113,140,1.2285714285714286,0.042218607343789044,652,Let’s ask them for the full menu.
866,5654,5,22,113,140,1.2285714285714286,0.042218607343789044,652,This is best hallucination I've had since listening to the President's SOTU speeches.
5093,5654,5,22,113,140,1.2285714285714286,0.042218607343789044,652,Yeah. Or it could be just a bloated whale carcass.
8016,5665,7,23,132,162,1.228395061728395,0.04039021702110284,652,And to think I used to make fun of Grammar Nazis.
694,5665,6,25,131,162,1.228395061728395,0.03942953708719213,652,Too bad we're diabetic.
5448,5665,6,25,131,162,1.228395061728395,0.03942953708719213,652,Carbs
7407,5665,8,21,133,162,1.228395061728395,0.04132857204299843,652,"We should've clarified to the genie that we wanted to be on a ""desSert island""!"
5815,5669,4,21,102,127,1.2283464566929134,0.04357045729792666,652,"Charlie Bucket, this is where our Wonka dream ends."
9052,5669,4,21,102,127,1.2283464566929134,0.04357045729792666,652,"Funny thing, but last time I was stranded--in that avalanche?--it was Big Rock Candy mountain."
6380,5669,5,19,103,127,1.2283464566929134,0.04498187552896535,652,The sharks made it all last night.
2217,5669,6,17,104,127,1.2283464566929134,0.046350334443844225,652,I say we wait until the holidays
7828,5669,6,17,104,127,1.2283464566929134,0.046350334443844225,652,"Too bad, I've sworn off sugar!"
9348,5674,9,24,151,184,1.2282608695652173,0.03869340972303834,652,"I think it’s a case of 
The grass being greener...."
4909,5675,4,26,119,149,1.2281879194630871,0.039405160524470954,652,If only we weren’t on a low carb diet.
5283,5675,8,18,123,149,1.2281879194630871,0.04376694600069947,652,Ooh! Lets order in tonight.
4405,5675,4,26,119,149,1.2281879194630871,0.039405160524470954,652,Really makes me wish I'd learned to swim. And that I wasn't diabetic.
8349,5675,3,28,118,149,1.2281879194630871,0.0382370494990411,652,"I have to say, that cupcake on the left sure looks good!"
7604,5675,6,22,121,149,1.2281879194630871,0.041643200154331726,652,"Really, the good ship lollipop?? I guess the Coast guard is a bit short of search and rescue vessels."
3482,5675,5,24,120,149,1.2281879194630871,0.04053962749614911,652,"Every time I try to get there, Plumpy shows up!"
6788,5675,3,28,118,149,1.2281879194630871,0.0382370494990411,652,Sso Closse
1879,5675,5,24,120,149,1.2281879194630871,0.04053962749614911,652,Watch our taxes go up now that they're regentrified.
1222,5675,1,32,116,149,1.2281879194630871,0.035786624753638197,652,Probably not gluten-free.
343,5675,5,24,120,149,1.2281879194630871,0.04053962749614911,652,"Unless there's milk, I won't go there."""
24,5675,4,26,119,149,1.2281879194630871,0.039405160524470954,652,It looks like a party island to me!
29,5675,7,20,122,149,1.2281879194630871,0.042718272912899216,652,I’ll take an “s”. I think I want to solve it.
26,5675,5,24,120,149,1.2281879194630871,0.04053962749614911,652,"Ugh, I think there's two ess's in dessert man."
1928,5675,5,24,120,149,1.2281879194630871,0.04053962749614911,652,I want to go there.
1852,5689,5,29,137,171,1.2280701754385965,0.03714310185958428,652,"Yeah, the swim would be a good workout, but I'm trying to watch my carbs."
8074,5689,5,16,93,114,1.2280701754385965,0.04831437140849907,652,You get it?
8501,5691,7,17,112,136,1.2279411764705883,0.045454509046622495,652,I'd be over there if I wasn't on a diet.
8193,5691,4,23,109,136,1.2279411764705883,0.04170509569643224,652,"To be honest ,I'd rather die of hunger than diabetes"
4281,5691,4,23,109,136,1.2279411764705883,0.04170509569643224,652,You're hallucinating.  It's really a McDonald's.
1621,5691,8,15,113,136,1.2279411764705883,0.04663737615414406,652,Do you think there are any vegan options?
716,5691,4,23,109,136,1.2279411764705883,0.04170509569643224,652,"Surprisingly, none of the previous guests mentioned weʻd have this sweet view."
557,5691,5,21,110,136,1.2279411764705883,0.042991248748113955,652,"No way, I saw the Fyre Festival documentary."
3889,5691,4,23,109,136,1.2279411764705883,0.04170509569643224,652,"I would swim, but my stomach is still upset from this island."
1576,5698,5,26,127,158,1.2278481012658229,0.03903489238214848,652,"I would have stayed over there, but it was all a Mirage."
2002,5698,7,22,129,158,1.2278481012658229,0.04104843643127968,652,We should probably get over there before the ice sheets melt
4661,5698,6,24,128,158,1.2278481012658229,0.04005431909756252,652,"Ok, so say you do make it... but then you find out everything was made without real sugar..."
7678,5698,6,24,128,158,1.2278481012658229,0.04005431909756252,652,"Look on the bright side, at least your diabetes is in check."
7187,5702,5,18,100,123,1.2276422764227641,0.0459081480870937,652,"I know the extra S is for ""sugar,"" but did they have to be so showy about it?"
9206,5702,4,20,99,123,1.2276422764227641,0.04443284865346495,652,I think I just figured out why that weed we smoked was called Sativa Wonka…
7304,5704,3,27,115,145,1.2275862068965517,0.03883458829086472,652,"My bet's on Marge, she knows how to get your attention."
10018,5704,6,21,118,145,1.2275862068965517,0.042373123198084506,652,"Yeah, but do you know what that would do to our teeth without tooth brushes?"
7815,5704,5,23,117,145,1.2275862068965517,0.041227371113703344,652,I’d go with you but I’m on a diet.
6381,5704,6,21,118,145,1.2275862068965517,0.042373123198084506,652,Now that we swam over here I can stick to my diet.
3767,5704,4,25,116,145,1.2275862068965517,0.040048853770538725,652,Thank God I’m still doing Keto...
4906,5704,3,27,115,145,1.2275862068965517,0.03883458829086472,652,"Your theme park mirages are beginning to wear me down, bro."
4305,5704,5,23,117,145,1.2275862068965517,0.041227371113703344,652,"Who knew that one day we'd be able to swim from Palm Beach, FL to Sugar Land, TX."
2215,5704,7,19,119,145,1.2275862068965517,0.04348869979860371,652,Oh crap! We're both diabetics?
120,5704,6,21,118,145,1.2275862068965517,0.042373123198084506,652,My dentist is going to be so mad at me.
5653,5704,3,27,115,145,1.2275862068965517,0.03883458829086472,652,"We can't desert our diet, can we Bob?"
6340,5714,9,20,138,167,1.2275449101796407,0.04132975350897556,652,"To be honest, Frank, I really don't think you need all those carbs."
7060,5714,7,24,136,167,1.2275449101796407,0.03954565451888787,652,But what if she's not home?
9372,5714,4,30,133,167,1.2275449101796407,0.036707277080288515,652,In your dreams
6334,5717,6,18,108,132,1.2272727272727273,0.045106229628472036,652,"No way am I swimming over there, not after what went down in that gingerbread house. I'm sugar free now"
6440,5717,5,25,124,154,1.2272727272727273,0.0396516613277557,652,Please stop humming 'Big Rock Candy Mountain.'
7467,5717,7,21,126,154,1.2272727272727273,0.04173750258099142,652,"I’d go, but I keep hearing my Mother say “empty calories”."
7497,5717,6,18,108,132,1.2272727272727273,0.045106229628472036,652,"Just think of it as a mirage, since it has such a bad glycemic index."
7582,5717,5,20,107,132,1.2272727272727273,0.04380538243518159,652,"Soon as the Good Ship Lollypop arrives, we're outa here!"
8584,5717,7,21,126,154,1.2272727272727273,0.04173750258099142,652,I always knew being a spelling bee champion would hurt me in the end.
8096,5717,6,23,125,154,1.2272727272727273,0.04070794374412261,652,But it's not my cheat day.
8200,5717,5,25,124,154,1.2272727272727273,0.0396516613277557,652,After what we did I somehow thought ‘just desserts’ would be worse than ‘just a coconut tree.’
9133,5717,4,22,106,132,1.2272727272727273,0.042464704276476285,652,I’m on a no-sugar diet this week.
9282,5717,5,25,124,154,1.2272727272727273,0.0396516613277557,652,Hell of a week to start keto
6051,5717,6,18,108,132,1.2272727272727273,0.045106229628472036,652,"We were one ""S"" away from making this deserted island a whole lot sweeter."
7984,5717,5,20,107,132,1.2272727272727273,0.04380538243518159,652,"Sorry,I meant dessert ..."
5832,5717,5,20,107,132,1.2272727272727273,0.04380538243518159,652,That desserted island looks sweet.
1458,5717,4,27,123,154,1.2272727272727273,0.03856645962786087,652,I'm trying to cut down on carbs anyway.
4769,5717,3,24,105,132,1.2272727272727273,0.04108029562070666,652,"Go ahead, I'm more of a salt person."
1158,5717,5,25,124,154,1.2272727272727273,0.0396516613277557,652,I'm not eating carbs right now.
1167,5717,5,25,124,154,1.2272727272727273,0.0396516613277557,652,"Just because you see it, doesn’t mean it’s real."
569,5717,7,21,126,154,1.2272727272727273,0.04173750258099142,652,"Well, I picked the wrong week to give up gluten"
2425,5717,8,19,127,154,1.2272727272727273,0.04274226900296567,652,"Your ""ex"" live's there? What was the name of her lawyer?"
2714,5717,7,21,126,154,1.2272727272727273,0.04173750258099142,652,"My kingdom for an ""s."""
5204,5717,6,18,108,132,1.2272727272727273,0.045106229628472036,652,My nutritionist would say that it's a bad idea
3880,5717,3,24,105,132,1.2272727272727273,0.04108029562070666,652,"Yeah, I'm not much of a sweet tooth, myself. Let's wait for the next one..."
3982,5717,5,25,124,154,1.2272727272727273,0.0396516613277557,652,"You know, when you said you wanted to blow all of our survival money on hallucinogenic mushrooms, I doubted you, I did. But you were right. This shit is dope."
4592,5717,5,25,124,154,1.2272727272727273,0.0396516613277557,652,"In hindsight, I really should have taken those swimming lessons"
4630,5717,5,20,107,132,1.2272727272727273,0.04380538243518159,652,Just my luck that I'm a diabetic
4644,5717,7,16,109,132,1.2272727272727273,0.0463705981447337,652,You go ahead. I'm fructose intolerant.
3277,5717,6,23,125,154,1.2272727272727273,0.04070794374412261,652,I was told I could only bring ONE thing...
2192,5744,2,33,128,163,1.2269938650306749,0.0351370796696929,652,Fantasy Island--it looks better than it is.
3945,5744,6,25,132,163,1.2269938650306749,0.039211934610142204,652,I thought they said this one had no CARS...
9166,5746,5,22,114,141,1.2269503546099292,0.04194944891243331,652,It's because we didn't fall for their organic vegan all-you-can-eat bar
8367,5746,5,22,114,141,1.2269503546099292,0.04194944891243331,652,"No, I'm not going over there! Have you ever tried swimming through high-fructose corn syrup?"
7359,5746,3,26,112,141,1.2269503546099292,0.03946038543741578,652,"It’s tempting, but you have to remember there are good carbs and bad carbs. Those are definitely bad."
8879,5746,4,24,113,141,1.2269503546099292,0.040723938187055705,652,I was thinking about going off keto.
1059,5746,4,24,113,141,1.2269503546099292,0.040723938187055705,652,"It's the Big Rock Candy Mountain, thanks to global warming."
625,5746,6,20,115,141,1.2269503546099292,0.04314015978934907,652,"Besides a homonym, it's a port for The Good Ship Lollypop"
4329,5746,4,24,113,141,1.2269503546099292,0.040723938187055705,652,Remember - that’s for cheat days only
3282,5746,5,22,114,141,1.2269503546099292,0.04194944891243331,652,"You go...Im afraid of carbs"""
3590,5754,6,15,98,119,1.226890756302521,0.048385079394151514,652,I can't decide if it's a mirage or marangue.
4161,5754,1,25,93,119,1.226890756302521,0.04036045888604452,652,I hate sweets on an empty stomach
5720,5754,2,23,94,119,1.226890756302521,0.04208796139977964,652,It’s as if my endocrinologist booked my travel.
6796,5757,5,29,138,172,1.2267441860465116,0.03695032187535087,652,”You go ahead. I went KETO the day before our ship sank!
4021,5758,3,28,119,150,1.2266666666666666,0.03801173334297594,652,I’d say let’s go for a swim but I’m still on that low carb diet!
9007,5758,7,20,123,150,1.2266666666666666,0.04245978928573964,652,"I knew a guy who collected candy canes, they were all in mint condition."
7501,5758,5,24,121,150,1.2266666666666666,0.040297180905907795,652,Do you spell desert island with one ‘s’ or two?
5904,5758,5,24,121,150,1.2266666666666666,0.040297180905907795,652,"Don't, it's an evolutionary trick"
5390,5758,3,28,119,150,1.2266666666666666,0.03801173334297594,652,I don't believe all of life is an illusion.
4151,5758,7,20,123,150,1.2266666666666666,0.04245978928573964,652,How many Weight Watchers points do you think those are?
4101,5758,6,22,122,150,1.2266666666666666,0.0413926110263225,652,The rules of candyland seem arbitrary.
3722,5758,3,28,119,150,1.2266666666666666,0.03801173334297594,652,"Sorry, I'm on a paleo diet..."
3275,5758,5,24,121,150,1.2266666666666666,0.040297180905907795,652,"Nope, I'm not going. It is an obvious trap!"
2487,5758,4,26,120,150,1.2266666666666666,0.039171128785758576,652,I can't have gluten ....
1662,5758,4,26,120,150,1.2266666666666666,0.039171128785758576,652,I bet their cartoon contest draws better captions.
1063,5758,8,18,124,150,1.2266666666666666,0.043500794990464095,652,"Yeh, but I gave up carbs for Lent."
969,5758,9,16,125,150,1.2266666666666666,0.044517464251856945,652,"Hey Gretel, what's the witch on that island doing now?"
715,5758,6,22,122,150,1.2266666666666666,0.0413926110263225,652,Does that count as processed sugar?
157,5758,4,26,120,150,1.2266666666666666,0.039171128785758576,652,The island is always sweeter on the other side.
3727,5758,6,22,122,150,1.2266666666666666,0.0413926110263225,652,You go ahead. I’m watching my cholesterol.
9228,5774,3,23,102,128,1.2265625,0.04181953482362248,652,We definitely got shipwrecked on the wrong Island
9171,5774,3,23,102,128,1.2265625,0.04181953482362248,652,"You wished for Candy island, not Candy land.
You idiot."
6535,5774,4,21,103,128,1.2265625,0.04326551731953711,652,"Deserted island.  Desserted island.
Deserted island.  Desserted island.
They sound so darn similar.
Yet, they are Megalodon infested waters apart."
5302,5774,5,19,104,128,1.2265625,0.04466471185388032,652,I need Champagne with dessert.
4946,5774,3,23,102,128,1.2265625,0.04181953482362248,652,If only there would be a  hamburger there I’d swim.
6123,5774,7,15,106,128,1.2265625,0.047339195991441825,652,That's what Columbus thought too
2641,5774,6,17,105,128,1.2265625,0.046021386127029565,652,"I think it's one of those billionaires' islands - Richard Branson, Larry Ellison, Milton Bradley. Not sure which."
2583,5774,7,15,106,128,1.2265625,0.047339195991441825,652,I don’t think those pot rations worked. Agree?
799,5774,5,19,104,128,1.2265625,0.04466471185388032,652,"Nah, I gotta watch my carbs."
436,5774,3,23,102,128,1.2265625,0.04181953482362248,652,It seems to me our chances of survival would be better on that desert island
67,5774,5,19,104,128,1.2265625,0.04466471185388032,652,I think we have a good chance of winning Castaway Confectioner.
2815,5774,6,17,105,128,1.2265625,0.046021386127029565,652,That stuff's not good for you.
9329,5786,9,18,132,159,1.2264150943396226,0.04272067404565706,652,"If you ask me, The Good Ship Lollipop was built by the lowest bidder."
7596,5786,5,26,128,159,1.2264150943396226,0.03881507448550428,652,"Fabulous dessert buffets or not, remind me never to take The Good Ship Lollipot again."
6262,5786,5,26,128,159,1.2264150943396226,0.03881507448550428,652,That must be Dessert Island
5509,5786,7,22,130,159,1.2264150943396226,0.040814617468687135,652,I must have left out an ess in our dessert request?
2690,5786,6,24,129,159,1.2264150943396226,0.039827396390113845,652,"Oh, not me. I don't eat sugar. But you go ahead."
411,5786,5,26,128,159,1.2264150943396226,0.03881507448550428,652,It's a trap.
4640,5786,4,28,127,159,1.2264150943396226,0.037775633832078014,652,"Yeah, but we'd be fat and thirsty."
6498,5793,3,25,109,137,1.2262773722627738,0.04011669957234548,652,"...and they've been hunting you for 30 years, Hansel?"
9625,5793,5,21,111,137,1.2262773722627738,0.042708711037555025,652,So this is what dieting is like!
8292,5793,4,23,110,137,1.2262773722627738,0.0414329795155212,652,Did I mention that I was diabetic?
7175,5793,4,23,110,137,1.2262773722627738,0.0414329795155212,652,We can burn off the extra calories on the swim back.
5870,5793,5,21,111,137,1.2262773722627738,0.042708711037555025,652,I would. But I’m off sugar.
1764,5793,3,25,109,137,1.2262773722627738,0.04011669957234548,652,Well I've cut out carbs and I've never looked better!
5257,5793,3,25,109,137,1.2262773722627738,0.04011669957234548,652,"Go on without me, I  prefer ice cream."
3286,5793,4,23,110,137,1.2262773722627738,0.0414329795155212,652,Getting there'll be a piece of cake.
44,5793,2,27,108,137,1.2262773722627738,0.03875573993129339,652,Life over there must be difficult too. It's not all candy canes and gumdrops.
1049,5793,6,19,112,137,1.2262773722627738,0.043947425470044876,652,Life's a beach.
5812,5793,6,19,112,137,1.2262773722627738,0.043947425470044876,652,"I want to get there too, but the water is infested with gummy worms."
397,5804,8,22,138,168,1.2261904761904763,0.040228869181528494,652,Forget it Jake.  It's gluten-town.
1052,5804,4,30,134,168,1.2261904761904763,0.03651325674197914,652,The grass is always greener on the other side.
695,5806,5,16,94,115,1.2260869565217392,0.04793344859607266,652,"We could swim there, but I don't think we could swim back."
9910,5807,6,21,119,146,1.226027397260274,0.04211075657243671,652,I’m starting to regret slaughtering the dairy cow.
9893,5807,4,25,117,146,1.226027397260274,0.039804135419876915,652,"What do you think, mirage or real!"
8379,5807,3,27,116,146,1.226027397260274,0.03859916948891957,652,I told you this would be an easy diet to keep
8117,5807,7,19,120,146,1.226027397260274,0.043217926030671365,652,That's for the passengers on the Good Ship Lollipop deck.
6823,5807,5,23,118,146,1.226027397260274,0.0409736806720297,652,We knew Miami and New York were emperilled - but the Big Rock Candy Mountain?
6816,5807,5,23,118,146,1.226027397260274,0.0409736806720297,652,But do they have palm sugar?
5396,5807,5,23,118,146,1.226027397260274,0.0409736806720297,652,"We could've landed on a dessert island. 
But No! You insisted on this desert island."
5490,5807,6,21,119,146,1.226027397260274,0.04211075657243671,652,When the brochure said actual size they really meant actual size.
5335,5807,3,27,116,146,1.226027397260274,0.03859916948891957,652,Too bad we're on a low-carb diet. . .
3997,5807,6,21,119,146,1.226027397260274,0.04211075657243671,652,"Ya, as I dentist i'm torn"
3777,5807,5,23,118,146,1.226027397260274,0.0409736806720297,652,I just knew Chutes and Ladders didn't sound right
637,5807,5,23,118,146,1.226027397260274,0.0409736806720297,652,If only the boat hit the Jawbreaker a 100 yards earlier.
6023,5807,7,19,120,146,1.226027397260274,0.043217926030671365,652,I’d rather die than eat refined sugar.
5574,5820,6,23,126,155,1.2258064516129032,0.040471029630601875,652,If only the Good Ship Lollipop had gotten one island closer
8449,5820,5,25,125,155,1.2258064516129032,0.039422291394586396,652,Candy canes in July? This mirage needs to try a little harder.
3779,5820,7,21,127,155,1.2258064516129032,0.041493269573780626,652,"""It IS cheaper, sure. But if that travel agent hadn't missed the second ""S"" , we'd be holidaying over there instead of here on Desert Island."""
1048,5820,5,25,125,155,1.2258064516129032,0.039422291394586396,652,"The way I figure it, at this rate of climate change, those goodies will be ours within five years!"
2274,5820,8,19,128,155,1.2258064516129032,0.0424909237424159,652,"Just a thought, but what do you think of Wayne Thiebaud's paintings?"
50,5820,5,25,125,155,1.2258064516129032,0.039422291394586396,652,"By my count this is day one hundred three, Bob.  Any chance you could let this one go by without the pun?"
3088,5820,4,27,124,155,1.2258064516129032,0.038344880730526554,652,"Darn, we've must have missed the entree pop-up."
5262,5827,5,27,132,164,1.225609756097561,0.038025306701429465,652,"Yeah, my cousins Hansel and Gretel ran a travel agency, but they were always a bit eccentric."
6537,5828,2,26,105,133,1.2255639097744362,0.03938543227376263,652,I guess I’d take my toothbrush.
6444,5828,7,16,110,133,1.2255639097744362,0.04605234096280959,652,It's too bad we're gluten-free.
8653,5828,8,14,111,133,1.2255639097744362,0.047273029040961784,652,"See,this is a ""deserted"" island and that is an island of ""desserts."""
4725,5828,4,22,107,133,1.2255639097744362,0.04217884076757722,652,I'll bet the cupcakes it's not our imagination.
3907,5828,5,20,108,133,1.2255639097744362,0.043508341442180715,652,Let's call it Christmas Island.
3747,5828,5,20,108,133,1.2255639097744362,0.043508341442180715,652,"Ok, you got me, I ‘m not really ciliac."
6181,5828,2,26,105,133,1.2255639097744362,0.03938543227376263,652,"No, you can’t have dessert until you finish your vegetables."
7163,5835,6,20,116,142,1.2253521126760563,0.04286508442438123,652,It's the island of misfit snacks.
8944,5835,5,22,115,142,1.2253521126760563,0.041683633980763767,652,"So this is what a carb-free diet feels like."""
8696,5835,4,24,114,142,1.2253521126760563,0.040467705902055257,652,I’m really supposed to avoid sweets.
8607,5835,7,18,117,142,1.2253521126760563,0.044014833676572905,652,"Compared to that place this 
place doesn’t seem so
Sweet anymore"
8102,5835,5,22,115,142,1.2253521126760563,0.041683633980763767,652,I understand they only take online orders.
7243,5835,3,26,113,142,1.2253521126760563,0.0392140931312735,652,Aren't you grateful we can maintain our plant-based diet to the very end?
7236,5835,5,22,115,142,1.2253521126760563,0.041683633980763767,652,One more S and we’d be eating cupcakes right now.
6508,5835,5,22,115,142,1.2253521126760563,0.041683633980763767,652,"I see candy canes, cake and pies.... I think we have been here too long!"
840,5835,4,24,114,142,1.2253521126760563,0.040467705902055257,652,We have to find the dentist island first.
5364,5835,5,22,115,142,1.2253521126760563,0.041683633980763767,652,"See, that’s how the obesity epidemic started back home!"
3798,5835,5,22,115,142,1.2253521126760563,0.041683633980763767,652,It's hard to find vegan options on the dessert cart these days
3755,5835,6,20,116,142,1.2253521126760563,0.04286508442438123,652,Yep. The palm trees are always sweeter on the other island.
3723,5835,4,24,114,142,1.2253521126760563,0.040467705902055257,652,Damn shame we are doing keto.
3605,5835,6,20,116,142,1.2253521126760563,0.04286508442438123,652,That’s the last time that I correct your spelling!
2385,5835,6,20,116,142,1.2253521126760563,0.04286508442438123,652,"Yeah, I gave it up. But the sharks are still doing keto."
879,5835,6,20,116,142,1.2253521126760563,0.04286508442438123,652,Figures...I’m a diabetic
5995,5835,5,22,115,142,1.2253521126760563,0.041683633980763767,652,dessert island has a different spelling
3834,5852,7,27,148,182,1.2252747252747254,0.03727226246012079,652,I hope it’s the good ship Lollipop!
7464,5852,5,31,146,182,1.2252747252747254,0.03560612325297367,652,"Actually, I'm on the keto diet so I'll wait for the cheese island to come by. You go ahead, though."
2709,5854,4,17,90,111,1.2252252252252251,0.04734504824060214,652,We're just a letter away from turning our desert island into dessert.
8196,5855,5,24,122,151,1.2251655629139073,0.04005755840075498,652,I'd swim over there but I'm watching my weight.
6397,5855,6,22,123,151,1.2251655629139073,0.04114496574042136,652,I picked the wrong week to quit insulin.
6292,5855,5,24,122,151,1.2251655629139073,0.04005755840075498,652,What are the chances there's a dentist on that island?
5451,5855,3,28,120,151,1.2251655629139073,0.037788987066720806,652,BMI over 30 guaranteed!
2389,5855,7,20,124,151,1.2251655629139073,0.042204365017507364,652,Gotta watch those carbs...
548,5855,5,24,122,151,1.2251655629139073,0.04005755840075498,652,...and that's where diabetics go to die.
375,5855,7,20,124,151,1.2251655629139073,0.042204365017507364,652,If it weren't for my low blood sugar I'd swim right over there.
6239,5855,6,22,123,151,1.2251655629139073,0.04114496574042136,652,"Yes, I remember a game called Candyland. Why do you ask?"
540,5863,6,24,130,160,1.225,0.03960298254443843,652,It's OK for a mirage but it could be great with a little beefing up.
1079,5863,8,20,132,160,1.225,0.04154069006188523,652,I’m slipping into a diabetic coma just staring at it.
1608,5863,6,24,130,160,1.225,0.03960298254443843,652,I'm reconsidering our selection of a no-carb marooning.
3344,5863,6,15,99,120,1.225,0.04801741630812266,652,A cold glass of milk sounds so good.
6291,5863,4,28,128,160,1.225,0.03756545649945677,652,If you could bring one thing to the deserted island...
6767,5863,5,26,129,160,1.225,0.03859766669390569,652,"I told you to book premium economy, but 'Oh No'..."
8346,5863,5,26,129,160,1.225,0.03859766669390569,652,"I know it looks tempting, but if you go to Carb Island you'll never make it back to our Paleo paradise."
8227,5870,6,17,106,129,1.2248062015503876,0.04569700047500619,652,"You go, I'm watching my weight."
8412,5870,3,23,103,129,1.2248062015503876,0.04153123835607915,652,"I'm telling you, this is the only way to go clean Paleo."
1907,5870,4,21,104,129,1.2248062015503876,0.042964727281773966,652,""" I say it's bait, and the hell with it!"""
3177,5870,5,19,105,129,1.2248062015503876,0.0443519088811853,652,They say you should wait an hour before going back in the water after eating.
782,5870,5,19,105,129,1.2248062015503876,0.0443519088811853,652,That's my cheat island.
680,5875,3,25,110,138,1.2246376811594204,0.03985867865935063,652,Poor timing on my no sugar diet.
9624,5875,4,23,111,138,1.2246376811594204,0.04116431448799274,652,"Johan, I can’t believe you made me wear Capri pants."
7299,5875,5,21,112,138,1.2246376811594204,0.0424297927176573,652,"I’m used to it. Before I got stranded here, I lived in Long Island City."
5463,5875,4,23,111,138,1.2246376811594204,0.04116431448799274,652,"For want of an ""s""...."
9509,5875,7,17,114,138,1.2246376811594204,0.04485376634862847,652,I'm not in the mood for sweets or a conversation.
1824,5875,5,21,112,138,1.2246376811594204,0.0424297927176573,652,I can gain weight just by looking at it.
1602,5875,2,27,109,138,1.2246376811594204,0.03850880083399608,652,I'm not going. I'm Paleo you know.
992,5875,6,19,113,138,1.2246376811594204,0.043658605484604755,652,Global warming sure did a number on Big Rock Candy Mountain
2219,5875,7,17,114,138,1.2246376811594204,0.04485376634862847,652,It's been stalking us for 3 years. I think it's time to extend an invitation to meet for coffee.
7383,5875,8,15,115,138,1.2246376811594204,0.04601789737107022,652,I think we got the wrong suite.
7643,5885,3,27,117,147,1.2244897959183674,0.03836651418626481,652,If you were stranded over there you'd have diabetes already.
9640,5885,4,25,118,147,1.2244897959183674,0.039562322617869794,652,Our mirage doesn’t know how to spell.
9076,5885,4,25,118,147,1.2244897959183674,0.039562322617869794,652,"No, I don't see a banana split boat there."
9025,5885,5,23,119,147,1.2244897959183674,0.04072303194797712,652,The cupcakes are always greener on the other side.
8295,5885,6,21,120,147,1.2244897959183674,0.04185156258912585,652,"Go ahead, I'm on the Paleo Diet."
8131,5885,6,21,120,147,1.2244897959183674,0.04185156258912585,652,There was nothing Paleo to eat on that island. It was a nightmare!
7347,5885,2,29,116,147,1.2244897959183674,0.03713221580634942,652,What do you want for dinner?
6731,5885,4,25,118,147,1.2244897959183674,0.039562322617869794,652,Sometimes I catch you looking at strangers the way you used to look at me.
5177,5885,5,23,119,147,1.2244897959183674,0.04072303194797712,652,carbo island...no one ever makes it out alive
4492,5885,3,27,117,147,1.2244897959183674,0.03836651418626481,652,"I would but I'm just not that big on sweets"""
1846,5885,5,23,119,147,1.2244897959183674,0.04072303194797712,652,Everything seems enticing on the next shore
1003,5885,6,21,120,147,1.2244897959183674,0.04185156258912585,652,"Good thing we started that diet, huh?"
6926,5885,4,25,118,147,1.2244897959183674,0.039562322617869794,652,It would just cause another crash.
9817,5898,5,25,126,156,1.2243589743589745,0.03919550575669872,652,"Nah, you go. I’m trying to watch my weight."
7463,5898,5,25,126,156,1.2243589743589745,0.03919550575669872,652,Trump's boarder wall looks odd from here.
3862,5898,8,19,129,156,1.2243589743589745,0.04224247423316703,652,But do you think there's a gluten-free option?
3374,5898,4,27,125,156,1.2243589743589745,0.03812577455717602,652,"Bob you go, I'm lactose intolerant."
5818,5898,4,27,125,156,1.2243589743589745,0.03812577455717602,652,One of the reported side effects of my anti-depressant are vivid hallucinations.
2373,5903,7,23,135,165,1.2242424242424241,0.039725141349637984,652,The last one to float by wasn’t vegan or gluten free either
5281,5903,7,23,135,165,1.2242424242424241,0.039725141349637984,652,But it was my New Year's resolution to cut back on sweets and we've made it two months.
4994,5905,4,20,101,125,1.224,0.04379424030475889,652,I feel a little silly insisting on the correct spelling...
5611,5905,5,18,102,125,1.224,0.045243427610377675,652,At least we don't have bugs on our island.
8996,5907,4,22,108,134,1.2238805970149254,0.04189671940002948,652,"Ah, what I wouldn’t do to be stranded with you on a dessert island!"
4984,5907,5,20,109,134,1.2238805970149254,0.043215228185430825,652,"You go ahead, I’m on this Paleo kick."
5797,5907,3,24,107,134,1.2238805970149254,0.040535345636256256,652,"On the bright side, I don't feel as bad about not packing the flouride."
2210,5907,5,20,109,134,1.2238805970149254,0.043215228185430825,652,"You're still gluten-free, right?"
1537,5907,4,22,108,134,1.2238805970149254,0.04189671940002948,652,Maybe I shouldn’t have been high when I put Big Rock Candy Mountain into googlemaps.
3312,5907,4,22,108,134,1.2238805970149254,0.04189671940002948,652,"I really wished that we'd all live in a Jello submarine, but all we got was this desserted island."
8542,5913,6,20,117,143,1.2237762237762237,0.04259343576391054,652,"Next time, Sugar Island will be our destination."
7329,5913,3,26,114,143,1.2237762237762237,0.03897077881510412,652,Well this is a dilemma. Do I stick with my new years diet plan?
7075,5913,6,20,117,143,1.2237762237762237,0.04259343576391054,652,"I know I promised I wouldn't kill you in your sleep and eat you, but this island just appeared out of nowhere fifteen minutes ago and you haven't shut up about gluten."
7028,5913,5,22,116,143,1.2237762237762237,0.04142110227812435,652,"I always thought that a desert island would be paradise, but that dessert island looks a whole lot better!"
6290,5913,4,24,115,143,1.2237762237762237,0.04021460751636528,652,Thank god I have a sweet tooth
5996,5913,5,22,116,143,1.2237762237762237,0.04142110227812435,652,We have to stay here. I'm prediabetic.
4912,5913,3,26,114,143,1.2237762237762237,0.03897077881510412,652,"Sorry man, I'm on the paleo diet."
4375,5913,3,26,114,143,1.2237762237762237,0.03897077881510412,652,I get the kids every other weekend.
2405,5913,5,22,116,143,1.2237762237762237,0.04142110227812435,652,What if it's not a mirage?
1892,5913,6,20,117,143,1.2237762237762237,0.04259343576391054,652,I don't intend to regain the weight I lost.
821,5913,4,24,115,143,1.2237762237762237,0.04021460751636528,652,I told you the Fyre Festival was over there.
640,5913,4,24,115,143,1.2237762237762237,0.04021460751636528,652,Candyland is a lot more different than I imagined.
4728,5913,6,20,117,143,1.2237762237762237,0.04259343576391054,652,I still prefer the yellow submarine.
9396,5926,4,26,122,152,1.2236842105263157,0.03871111921947651,652,"Yeh, sure, and the grass is greener, too."
7505,5926,5,24,123,152,1.2236842105263157,0.03982071228601015,652,"Week 3 - Keto, otherwise I'd swim for it."
8780,5926,6,22,124,152,1.2236842105263157,0.04090021396894979,652,That’s Temptation Island!
5183,5926,6,22,124,152,1.2236842105263157,0.04090021396894979,652,It's almost enough to make a person believe in global warming.
4601,5926,3,28,121,152,1.2236842105263157,0.03756876861814674,652,"Not just the grass is greener, but even the treats seem bigger on the other side!!"
5811,5926,9,16,127,152,1.2236842105263157,0.04398002535160598,652,"I know you said I should stop talking, but I’m sure it’s two S’s and not one."
893,5932,8,20,133,161,1.2236024844720497,0.04130551532464778,652,It's tempting...but I'm going to wait for the Good Ship Lollipop.
3657,5932,3,30,128,161,1.2236024844720497,0.036303537547610114,652,Isn’t it great we are on an island where we don’t have to consume all that sugar?
5227,5932,7,22,132,161,1.2236024844720497,0.04035474996430925,652,I think it is one of the Trans-fatlantic Islands.
5990,5932,8,20,133,161,1.2236024844720497,0.04130551532464778,652,I am going to swim for it. My diabetes be damned!
1164,5936,6,26,138,170,1.223529411764706,0.03800904977375565,652,What would Atkins do?
2216,5937,4,19,98,121,1.2231404958677685,0.04467144104934325,652,"Eh, I don’t have much of a sweet tooth, you take this one."
1043,5937,7,13,101,121,1.2231404958677685,0.04907912780317939,652,And I say it was a dolphin fin.
1442,5937,4,19,98,121,1.2231404958677685,0.04467144104934325,652,"No thanks, I just started the Atkins Diet"
860,5940,6,17,107,130,1.2230769230769232,0.04537708517216677,652,Now I want to stream the music  from South Pacific.
4910,5940,3,23,104,130,1.2230769230769232,0.04124679509478872,652,"Not reading anything, never being elected to office, not revealing our tax returns, not paying bills, hasn't worked for us.....maybe it's his diet."
4924,5940,3,23,104,130,1.2230769230769232,0.04124679509478872,652,We are only one  's' away
5833,5940,2,25,103,130,1.2230769230769232,0.039774835275769825,652,"Two s’s man, TWO s’s"
9799,5944,6,19,114,139,1.223021582733813,0.04337349518088946,652,...Waiting for the good ship Lollipop?
9001,5944,5,21,113,139,1.223021582733813,0.04215442645382961,652,"So, all we need is an ""s"" and we could be dessert island?"
8087,5944,5,21,113,139,1.223021582733813,0.04215442645382961,652,"Thank god we didn't land there, it's so non-keto!"
8262,5944,5,21,113,139,1.223021582733813,0.04215442645382961,652,"No, it's just another of those Russian temptation optical collusions!"
7405,5944,4,23,112,139,1.223021582733813,0.04089903733703297,652,Now we just wait for the tourists to arrive.
8408,5944,6,19,114,139,1.223021582733813,0.04337349518088946,652,"This ""deserted island"" themed restaurant is a little extreme."
4785,5944,5,21,113,139,1.223021582733813,0.04215442645382961,652,You been hitting the coconut water again?
3327,5944,6,19,114,139,1.223021582733813,0.04337349518088946,652,"Looks tempting, but I'm trying to avoid carbs."
1319,5944,2,27,110,139,1.223021582733813,0.03826489809192483,652,...just waiting for my good ship lollipop to come in....
974,5944,4,23,112,139,1.223021582733813,0.04089903733703297,652,"Am I a man dreaming he's a candy cane, or a candy cane dreaming he's a man?"
454,5944,4,23,112,139,1.223021582733813,0.04089903733703297,652,How long a swim do you think it is to Cheeseburger Island?
7239,5944,5,21,113,139,1.223021582733813,0.04215442645382961,652,My mirages are getting stranger and stranger.
9646,5956,6,21,121,148,1.222972972972973,0.041595485379180015,652,I’m not sure if it’s worth the weight.
7626,5956,4,25,119,148,1.222972972972973,0.039323365537744966,652,Seems like another Disney franchise is opening
6387,5956,5,23,120,148,1.222972972972973,0.04047537202512589,652,Don’t fret. The calories would kill us
6235,5956,8,17,123,148,1.222972972972973,0.04374976263528806,652,Ever thought of going to America?
3786,5956,6,21,121,148,1.222972972972973,0.041595485379180015,652,It's too bad I'm full of coconuts right now.
3166,5956,6,21,121,148,1.222972972972973,0.041595485379180015,652,I just think it’s important that you know - I will never dessert you.
1806,5956,3,27,118,148,1.222972972972973,0.03813657580142551,652,"Gretel! Yes, Hansel. Can you swim?"
1785,5956,11,11,126,148,1.222972972972973,0.046795595099493624,652,I couldn't take all the sermonizing from the Oompla Loompas.
5803,5956,7,19,122,148,1.222972972972973,0.042686216361804814,652,"Darn, I really thought for once I could stick to my Paleo diet."
5145,5965,8,19,130,157,1.2229299363057324,0.0419968716653878,652,I would go... but I was taught only to eat dessert after a meal.
4652,5965,2,31,124,157,1.2229299363057324,0.03569007320965327,652,"You know, I had a dream like this once."
6980,5965,6,23,128,157,1.2229299363057324,0.040005232095600175,652,Ahhh...Fattening Island.
1335,5965,4,27,126,157,1.2229299363057324,0.037909101286717733,652,"What will they think of next to torture us, man?"
150,5965,6,23,128,157,1.2229299363057324,0.040005232095600175,652,My nemesis: the White Sugar Whale.
1378,5965,6,23,128,157,1.2229299363057324,0.040005232095600175,652,Sure we could...if we wanted to get diabetes.
8518,5971,8,23,144,175,1.2228571428571429,0.03899752483770018,652,"Did I ever tell you about the time I slept with my dentist?""
""Yes, you have Roger...yes you sure have."
5342,5972,4,24,116,144,1.2222222222222223,0.03996458762248061,652,"Look, I know it looks appealing but we both know; with rewards come consequences."
5619,5972,5,24,124,153,1.2222222222222223,0.03958659589207586,652,"Tempting, but I've gone Paleo."
5928,5972,5,26,131,162,1.2222222222222223,0.03816992907943363,652,Just our luck.
6005,5972,4,20,102,126,1.2222222222222223,0.04348163471305125,652,"You go ahead, I’m trying to keep up with this diet."
6246,5972,5,24,124,153,1.2222222222222223,0.03958659589207586,652,"Yeah, I’m pretty sure I could make it but what’s the point I’m fully paleo."
6593,5972,5,22,117,144,1.2222222222222223,0.04116179491907547,652,You go ahead....I’m on a low glycemic diet
7221,5972,3,22,101,126,1.2222222222222223,0.0419960525565808,652,I’m holding out for a hamburger.
7273,5972,4,24,116,144,1.2222222222222223,0.03996458762248061,652,"I travel the world and the seven seas.
Everyone’s looking for something."
7708,5972,3,26,115,144,1.2222222222222223,0.03873039073789255,652,... but where are the toppings?
7737,5972,4,26,123,153,1.2222222222222223,0.03848505245308902,652,I prefer coconut to refined sugar.
8277,5972,6,20,118,144,1.2222222222222223,0.0423251516014429,652,"I hear they filmed ""Diabetic Survivor"" there."
8563,5972,7,18,119,144,1.2222222222222223,0.043457376303801656,652,Do you think they have vegan options too?
8899,5972,5,20,110,135,1.2222222222222223,0.042925967182569774,652,"The way I figure, the calories I’d take in 
would be neutralized by the swim there and back."
8979,5972,5,22,117,144,1.2222222222222223,0.04116179491907547,652,We could fish for protein.
9056,5972,4,24,116,144,1.2222222222222223,0.03996458762248061,652,Delusion or deliverance? Mirage or miracle? I never could spell to save my life.
9289,5972,8,22,141,171,1.2222222222222223,0.039586595892075846,652,And just when I started my all protein diet.
7371,5972,5,26,131,162,1.2222222222222223,0.03816992907943363,652,Go right ahead...I'm off sugar this week.
5265,5972,2,26,107,135,1.2222222222222223,0.03887111652652168,652,"I can swim but I""m on a diet"
4928,5972,2,26,107,135,1.2222222222222223,0.03887111652652168,652,"You know the saying: ""If you eat it, they will come."""
4091,5972,4,28,130,162,1.2222222222222223,0.037151880838356854,652,Do you know how to swim in chocolate syrup?
200,5972,6,20,118,144,1.2222222222222223,0.0423251516014429,652,"Once I gave up sugar, I just stopped craving it."
492,5972,7,14,105,126,1.2222222222222223,0.04766135686561603,652,"Once again, others get Christmas and I have Yom Kippur."
1646,5972,6,18,111,135,1.2222222222222223,0.04419498815558842,652,Guess Charlie and his chocolates didn’t survive global warming.
1988,5972,6,24,132,162,1.2222222222222223,0.039161520936124516,652,Just my luck..I’m on a low carb diet.
2973,5972,5,26,131,162,1.2222222222222223,0.03816992907943363,652,"""How did we land here?!?!"""
3026,5972,4,28,130,162,1.2222222222222223,0.037151880838356854,652,"Global warming sure has hurt the chocolate factory, hasn't it Charlie?"
3179,5972,6,18,111,135,1.2222222222222223,0.04419498815558842,652,That’s a sweet island over there.
3248,5972,2,30,121,153,1.2222222222222223,0.03618149579973173,652,Shoot! Some guys have all the luck.
3644,5972,7,18,119,144,1.2222222222222223,0.043457376303801656,652,Don't even think about it.  You know you're diabetic.
3680,5972,8,16,120,144,1.2222222222222223,0.04456084214122663,652,"If it's my last meal, I want dessert first!"
3795,5972,3,28,122,153,1.2222222222222223,0.0373510368037021,652,I'm not in the mood for sweets.
3799,5972,4,22,109,135,1.2222222222222223,0.04161826929421157,652,"I'd swim over, but I'm keto.  Help yourself."
3855,5972,3,26,115,144,1.2222222222222223,0.03873039073789255,652,You go ahead. I'm off the carbs.
4042,5972,6,18,111,135,1.2222222222222223,0.04419498815558842,652,Reality doth take time to sink in.
4067,5972,4,26,123,153,1.2222222222222223,0.03848505245308902,652,"You go ahead, I gave up sweets years ago."
17,5972,7,20,126,153,1.2222222222222223,0.04170248431848545,652,It's one of the sweetest spots in the Carbo-bean.
5205,5972,5,22,117,144,1.2222222222222223,0.04116179491907547,652,Medical marijuana? Who needs it when you can have hallucinations like this!
9208,6009,4,31,141,176,1.2215909090909092,0.03529005716335241,652,The view is so sweet.
3092,6009,7,25,144,176,1.2215909090909092,0.037949879175010234,652,I hear it's an island inhabited entirely by one of Peter Pan's seven year old lost boys.
1823,6011,4,27,127,158,1.2215189873417722,0.03769482190708304,652,We'll be hungry but at least we'll have good teeth.
2745,6011,3,29,126,158,1.2215189873417722,0.036609752027612255,652,We can afford it because the agent sweetened the deal.
8089,6011,5,25,128,158,1.2215189873417722,0.03874951939947326,652,Too bad the water between us is infested with carbs.
8983,6011,7,21,130,158,1.2215189873417722,0.04077715737832947,652,I told you we should have used Wonka Cruise Lines
9991,6015,7,19,123,149,1.221476510067114,0.04242516440739853,652,A little seagull told me it has added preservatives
8862,6015,5,23,121,149,1.221476510067114,0.04023064916031539,652,Why did you have to choose the gluten free option?
9155,6015,2,29,118,149,1.221476510067114,0.03669360935038649,652,Now might be a good time to try that palm tree diet that everyone is raving about?
5821,6015,5,23,121,149,1.221476510067114,0.04023064916031539,652,You don't need the carbs.
3123,6015,4,25,120,149,1.221476510067114,0.039087215432839176,652,"I'm so happy with my ketogenic diet of coconut oil, palm leaves, and some fish. And you?"
5949,6015,4,25,120,149,1.221476510067114,0.039087215432839176,652,...I don't know. Imagine what that will do to our teeth.
1389,6021,6,19,115,140,1.2214285714285715,0.043092025076168945,652,Is that the good ship Lollipop?
3594,6021,4,23,113,140,1.2214285714285715,0.04063708625538447,652,That's Bloomberg's island.  The taxes are ridiculous.
5294,6021,5,21,114,140,1.2214285714285715,0.04188254651100343,652,And I am on a sugar free diet.
6082,6021,6,19,115,140,1.2214285714285715,0.043092025076168945,652,You get to bring one thing. Last guy had a real sweet tooth.
6205,6021,4,23,113,140,1.2214285714285715,0.04063708625538447,652,I’ll never be able to swim off the calories.
8776,6021,5,21,114,140,1.2214285714285715,0.04188254651100343,652,"I’m gluten intolerant, but you should go; you definitely need some fattening up....."
8337,6027,4,21,106,131,1.2213740458015268,0.042375272174035514,652,"I could use a vacation"""
4119,6027,5,19,107,131,1.2213740458015268,0.043739038671647655,652,"Can you do burgers, shakes and fries, too!?"
3030,6027,6,17,108,131,1.2213740458015268,0.04506155030639969,652,"I don't care if it is a mirage, I'm going for it."
4627,6027,4,21,106,131,1.2213740458015268,0.042375272174035514,652,Let's desert this island and go for a dessert!
3546,6031,5,17,100,122,1.221311475409836,0.04584378067145163,652,I am waiting for a gluten-free mirage
4926,6032,9,20,143,172,1.2209302325581395,0.040231147027811096,652,"Dude,that's sweet."
7030,6032,4,30,138,172,1.2209302325581395,0.03575678832266111,652,My dentist would kill me.
388,6034,6,24,133,163,1.2208588957055215,0.038944394975012134,652,It’ s  the  big rock candy island.
3593,6034,6,24,133,163,1.2208588957055215,0.038944394975012134,652,Do you think it's organic?
4051,6034,4,28,131,163,1.2208588957055215,0.036948412359557335,652,The downside is....where would we find a dentist?
5251,6034,5,26,132,163,1.2208588957055215,0.03795952499611685,652,Still on the sugar free diet?
8661,6034,5,26,132,163,1.2208588957055215,0.03795952499611685,652,"I know it is just a mirage, but it sure looks sweet!"
9654,6039,6,22,126,154,1.2207792207792207,0.040419195140106126,652,"Don’t worry, I’m certain the Good Ship Lollipop docks here."
8718,6039,5,24,125,154,1.2207792207792207,0.039355163548769105,652,Do you think we should find out if it is a mirage?
7769,6039,5,24,125,154,1.2207792207792207,0.039355163548769105,652,"Ya gotta expect Shirley Temple to come around the bend singing, ""Good Ship Lollipop."""
7470,6039,6,22,126,154,1.2207792207792207,0.040419195140106126,652,"I would, but I can't swim for an hour after my lunchtime starvation."
6585,6039,2,30,122,154,1.2207792207792207,0.03597473536357872,652,I hope the other side covers gluten free!
3246,6039,4,26,124,154,1.2207792207792207,0.03826155328951963,652,"You go, I’ll stay. I’m on a sugar free diet."
3232,6039,6,22,126,154,1.2207792207792207,0.040419195140106126,652,"And of course, I get stranded on NON Candyland Island."
2047,6039,6,22,126,154,1.2207792207792207,0.040419195140106126,652,I loved that board game.
2017,6039,5,24,125,154,1.2207792207792207,0.039355163548769105,652,Well looks like we will be going through pain and gain.
589,6039,4,26,124,154,1.2207792207792207,0.03826155328951963,652,Remember when the North Pole was colder?
5275,6039,4,26,124,154,1.2207792207792207,0.03826155328951963,652,"If we stay here long enough, we might get some coconuts."
6295,6039,5,24,125,154,1.2207792207792207,0.039355163548769105,652,And you said the good ship lollipop was unsinkable !
9827,6051,5,22,118,145,1.2206896551724138,0.04090565436614768,652,Now I really wish I'd learned how to swim.
100,6051,4,24,117,145,1.2206896551724138,0.039717592053266644,652,"No, they probably aren't made with organic ingredients."
1062,6051,1,30,114,145,1.2206896551724138,0.035918390786206296,652,I’m staying away from sugar these days.
1294,6051,4,24,117,145,1.2206896551724138,0.039717592053266644,652,"You're not a dentist, are you?"
5640,6051,5,22,118,145,1.2206896551724138,0.04090565436614768,652,"Global warming, man."
5872,6051,4,24,117,145,1.2206896551724138,0.039717592053266644,652,Nah. I’m on the Zero-sugar diet.
6502,6051,5,22,118,145,1.2206896551724138,0.04090565436614768,652,I love sweets but they would just make me thirsty.
9047,6051,4,24,117,145,1.2206896551724138,0.039717592053266644,652,"I'm not impressed, it's too much Magnolia Bakery/Dunkin Donuts, not enough Dominique Ansel."
9186,6051,3,26,116,145,1.2206896551724138,0.03849287827503528,652,Why didn't we land over there?
6711,6060,5,20,111,136,1.2205882352941178,0.04264048480620878,652,You want to go for a swim?
9594,6060,7,16,113,136,1.2205882352941178,0.0451228973832111,652,I don't know. They say that sugar is bad for you.
4195,6060,6,18,112,136,1.2205882352941178,0.043899241523996296,652,It’s our donut trap for rescue by cop!
6657,6060,3,24,109,136,1.2205882352941178,0.040004325025692476,652,I'd swim over with you but I'm watching my carbs.
2770,6060,4,22,110,136,1.2205882352941178,0.04134342127394495,652,I never had any desire to go to candyland before now.
1244,6060,3,24,109,136,1.2205882352941178,0.040004325025692476,652,Do you think they might be poisonous?
2059,6060,5,20,111,136,1.2205882352941178,0.04264048480620878,652,What is it that the sand is always sweeter on the other side?
3915,6060,5,20,111,136,1.2205882352941178,0.04264048480620878,652,"I don’t regret our passion for dessert and the pursuit of our dreams, but in hindsight I wish we had been better spellers."
2738,6060,2,26,108,136,1.2205882352941178,0.03861882389311729,652,"I still say it's a secret entrance to a missile silo, and they have extra food in there."
4470,6069,4,20,103,127,1.220472440944882,0.043173374153718636,652,This makes that Marshmallow Test seem like childs' play.
7086,6069,6,16,105,127,1.220472440944882,0.04597726600965679,652,I told you it was spelled dessert
8875,6069,5,18,104,127,1.220472440944882,0.04459736105163467,652,In the desert you only can see salty snacks mirages
5623,6072,5,16,97,118,1.2203389830508475,0.04682532355183029,652,"This way, I don't have to worry about self-control."
7521,6072,2,35,140,177,1.2203389830508475,0.03323372684961967,652,It's called the Robinson Crusoe Diet
6339,6072,3,20,95,118,1.2203389830508475,0.043622033680757795,652,You know what? I'm content.
1567,6075,4,27,128,159,1.220125786163522,0.03748289819642971,652,"If the sharks don’t get you first, the cigarette trees will."
3090,6075,3,29,127,159,1.220125786163522,0.03640544136944237,652,Have you seen Moby Dick's new hat?
6319,6075,5,25,129,159,1.220125786163522,0.038530236867996566,652,Seen any sharks?
7446,6075,4,27,128,159,1.220125786163522,0.03748289819642971,652,You can go on over - I'm trying to lay off the carbs.
9772,6079,4,25,121,150,1.22,0.038853824609694415,652,"You see freedom.
I see diabetes!"
5305,6079,8,17,125,150,1.22,0.04321529267808789,652,I prefer to see the glass half full of candy.
6734,6079,3,27,120,150,1.22,0.03768466834387587,652,"I agree these resorts are amazing, but Seafood Buffet Island sounds better right now."
5816,6079,4,25,121,150,1.22,0.038853824609694415,652,"After ruling out a mirage, I figured it had to be the last remnant of  The Good Ship Lollipop."
4343,6079,6,21,123,150,1.22,0.041092464078305725,652,Tempting..but there’s something fishie about it!
3309,6079,6,21,123,150,1.22,0.041092464078305725,652,I knew we shouldn't have picked the gluten free option.
2895,6079,5,23,122,150,1.22,0.03998881275324226,652,I guess it's somebody's version of Paradise Island
2021,6079,4,25,121,150,1.22,0.038853824609694415,652,Home Sweet Home.
4218,6079,5,23,122,150,1.22,0.03998881275324226,652,"Well, at least over here we won't drop dead from a sugar comma!"
6628,6088,4,34,153,191,1.219895287958115,0.03351560257597705,652,If only I wasn't on Atkins.
9866,6089,2,27,112,141,1.2198581560283688,0.03778598961656247,652,I'm kicking myself for not starting that sugar-free diet next week
8271,6089,3,25,113,141,1.2198581560283688,0.03910368440309283,652,It's a reminder to cancel the Dentist appointment.
7512,6089,5,21,115,141,1.2198581560283688,0.04161408870904326,652,That island’s got good taste.
8078,6089,3,25,113,141,1.2198581560283688,0.03910368440309283,652,"Since I've started the Keto Diet, I've been having this recurring dream."
924,6089,6,19,116,141,1.2198581560283688,0.04281412736092889,652,I guess I picked the wrong day to go gluten free.
330,6089,4,23,114,141,1.2198581560283688,0.04037840086593826,652,"So then at the end of Life of Pi"". . . . ."
1481,6089,6,19,116,141,1.2198581560283688,0.04281412736092889,652,"Yes, but are they vegan?"
6940,6096,4,21,107,132,1.2196969696969697,0.04208644972494561,652,Why do I always have to be the one who worries about YOUR sugar?
2029,6096,7,15,110,132,1.2196969696969697,0.046024455602018496,652,I distinctly remember telling you to check out the West Side.
3145,6096,5,19,108,132,1.2196969696969697,0.0434388037525702,652,I blame this on your public education.
4457,6096,4,21,107,132,1.2196969696969697,0.04208644972494561,652,"At last, The Candyman arrives."
5891,6096,4,21,107,132,1.2196969696969697,0.04208644972494561,652,It’s a trick - they’re all gluten-free and made with Splenda.
6460,6096,1,27,104,132,1.2196969696969697,0.03773974016124882,652,"""I know it looks like a candy shop, but it's actually an alien spaceship."""
8868,6096,5,19,108,132,1.2196969696969697,0.0434388037525702,652,Don't bother... I hear it's all gluten free.
5487,6103,5,28,140,173,1.2196531791907514,0.036504947758810545,652,"Potato, potahto, tomato, tomahto.  No argument there, but when it comes to desert, dessert, I have to disagree, the difference is about 2000 calories a day!!"
8042,6104,9,18,137,164,1.2195121951219512,0.04152630099206839,652,I said you can bring three things Larry.
9815,6104,3,21,99,123,1.2195121951219512,0.042475362108238664,652,How do you feel about our decluttering?
1561,6104,7,22,135,164,1.2195121951219512,0.039683753299170024,652,"Yes, I did play Candy Land as a kid."
7270,6107,8,18,129,155,1.2193548387096773,0.04221651827079907,652,I thought the map said Deserted Island.
34,6107,5,24,126,155,1.2193548387096773,0.03912637056033424,652,"To be honest, lately I’ve been considering giving up the Paleo Diet.”"
1616,6107,8,18,129,155,1.2193548387096773,0.04221651827079907,652,"This sure beats being on Hutch Island with all those rabbits, George!"
1932,6107,4,26,125,155,1.2193548387096773,0.03804057955214688,652,"Thanks, but I'm on a diet."
3120,6107,3,28,124,155,1.2193548387096773,0.03692287247901823,652,The grass on the other side always seems to be sweeter.
4670,6107,5,24,126,155,1.2193548387096773,0.03912637056033424,652,"My ""Dessert Island"" album would be Sammy Davis Jr's ""Candyman""."
5486,6107,7,20,128,155,1.2193548387096773,0.041212221905004565,652,Don’t worry: the mirages are calorie free.
6133,6107,4,26,125,155,1.2193548387096773,0.03804057955214688,652,Have you ever heard of the Candy Land sea monster?
8423,6107,5,24,126,155,1.2193548387096773,0.03912637056033424,652,I'm watching my sweets.
9321,6107,5,24,126,155,1.2193548387096773,0.03912637056033424,652,I’d suggest we swim over but I just started a Keto diet.
9005,6117,6,20,120,146,1.2191780821917808,0.04179843515470749,652,That was a narrow escape.
9041,6117,2,28,116,146,1.2191780821917808,0.03700291794202241,652,"I would, but I’m off sugar this month."
9377,6117,5,22,119,146,1.2191780821917808,0.04065262439366893,652,But is it worth the calories?
8804,6117,3,26,117,146,1.2191780821917808,0.03825819190073683,652,You stay here. I’ll make sure it’s safe to eat.
9242,6117,6,20,120,146,1.2191780821917808,0.04179843515470749,652,"Wow, that's better than the ""Goodship Lollipop."""
6680,6117,6,20,120,146,1.2191780821917808,0.04179843515470749,652,"And to think, I just started my cleanse!"
8752,6117,4,24,118,146,1.2191780821917808,0.03947356784993175,652,We must be near Key West.
4523,6117,6,20,120,146,1.2191780821917808,0.04179843515470749,652,"Green New Deal Island. You can't actually get there, but it's lovely to look at, right?"
4291,6117,2,28,116,146,1.2191780821917808,0.03700291794202241,652,"""Rescued? Why? We're living the sweet life!"""
3714,6117,5,22,119,146,1.2191780821917808,0.04065262439366893,652,That's the sugar tax haven.
3219,6117,6,20,120,146,1.2191780821917808,0.04179843515470749,652,"....but he rolled a five not a six, so here I am. What's your story?"
1439,6117,5,22,119,146,1.2191780821917808,0.04065262439366893,652,"I,m on the Mediterranean diet. Lucky me!"
5664,6117,4,24,118,146,1.2191780821917808,0.03947356784993175,652,Wouldn't that be a sweet place to live?
9088,6130,4,22,111,137,1.218978102189781,0.0410721078190437,652,I think it was the oysters
8030,6130,7,16,114,137,1.218978102189781,0.0448212523426831,652,Have you ever played Candyland?
7763,6130,5,20,112,137,1.218978102189781,0.0423587092302743,652,It must be from the Good Ship Lollipop.
7610,6130,5,20,112,137,1.218978102189781,0.0423587092302743,652,I thought it was supposed to be a Mountain ...
7311,6130,8,14,115,137,1.218978102189781,0.04600311803043627,652,I see your mom landed nearby after the shipwreck.
7287,6130,5,20,112,137,1.218978102189781,0.0423587092302743,652,"Don’t be fooled, you’re just hallucinating."
4708,6130,4,22,111,137,1.218978102189781,0.0410721078190437,652,Did you receive a golden ticket also?
5412,6130,6,18,113,137,1.218978102189781,0.04360736697635734,652,the hell with atkins
2626,6130,6,18,113,137,1.218978102189781,0.04360736697635734,652,Not worth the effort - just empty calaries.
2158,6130,3,24,110,137,1.218978102189781,0.03974387794042468,652,I'm not a sweets person.
1744,6130,6,18,113,137,1.218978102189781,0.04360736697635734,652,"Let's go; there's no cop there. We know that, right?"
5533,6130,4,22,111,137,1.218978102189781,0.0410721078190437,652,My guess is that they are market testing the selections.
4181,6142,5,27,137,169,1.2189349112426036,0.03701463783126026,652,This low carb diet sucks.
3610,6142,7,23,139,169,1.2189349112426036,0.03887117402457423,652,"So what, after eating the pine tree we swim over there for dessert?"
2873,6142,8,21,140,169,1.2189349112426036,0.03976695296579084,652,"This would actually be a pretty sweet setup, 
if not for all the carnivorous Swedish fish."
6058,6145,6,23,131,160,1.21875,0.03932595902783707,652,"If I weren’t diabetic, I’d take the bait."
4939,6145,1,26,101,128,1.21875,0.03832347171449853,652,Look on the bright side. At least our island is low-carb.
7701,6145,3,29,128,160,1.21875,0.03620334234370282,652,"Suddenly I find myself humming ""on the good ship lollipop."""
3454,6145,6,16,106,128,1.21875,0.04564916170716533,652,"Nah, you go ahead, I've read too many articles on sugar shortening the lifespan"
1219,6145,5,18,105,128,1.21875,0.04428108477108411,652,"Desserted Island, Ep. 2: The Tropics of Candy"
2238,6145,4,20,104,128,1.21875,0.042869371029220206,652,"So, I managed to get rid of that wasp."
1221,6145,2,24,102,128,1.21875,0.0398963655025738,652,"I’d swim over there, but I’m cutting carbs."
165,6145,5,18,105,128,1.21875,0.04428108477108411,652,"No, I don’t think any of it is vegan"
2239,6145,6,16,106,128,1.21875,0.04564916170716533,652,It's not always sweeter on the other side.
9415,6154,4,25,122,151,1.218543046357616,0.03862314640183871,652,The thing I like about hallucinations is that they're all low-cal.
9337,6154,4,25,122,151,1.218543046357616,0.03862314640183871,652,If it we're only gluten free I'd be all over that.
7242,6154,4,25,122,151,1.218543046357616,0.03862314640183871,652,"One double blue card and we’re there, or it’s back to peppermint stick forest again"
7488,6154,6,21,124,151,1.218543046357616,0.04084541442413053,652,I guess climate change isn't all bad.
3353,6154,3,27,121,151,1.218543046357616,0.0374626109237906,652,Maybe the Good Ship Lollipop will rescue us and bring us to Candy Land.
2176,6154,5,23,123,151,1.218543046357616,0.03974981331690023,652,Well at least this way I can follow my diet.
1711,6154,7,19,125,151,1.218543046357616,0.04191238600019715,652,Thank God you turned off autocorrect.
3968,6154,7,19,125,151,1.218543046357616,0.04191238600019715,652,Check it out. Another land mine sent to deceive us into thinking that America is great again.
8006,6162,4,18,97,119,1.218487394957983,0.04490833828041443,652,"Dude, that Island is Sweet"
5513,6163,5,21,116,142,1.2183098591549295,0.04134899037949917,652,Nah. I want all my acquaintances to be envious of my weight loss.
6927,6163,6,19,117,142,1.2183098591549295,0.04253973585097774,652,I'm so glad we splurged for the en-sweet
6738,6163,7,17,118,142,1.2183098591549295,0.04369804626225305,652,Hey  Dude! We’re stranded on the wrong desserted island.
8514,6163,4,23,115,142,1.2183098591549295,0.040122922183421145,652,My illusion was milk and honey
6213,6163,6,19,117,142,1.2183098591549295,0.04253973585097774,652,"No thanks, I'm trying to lose weight."
4205,6163,3,25,114,142,1.2183098591549295,0.038858187858800394,652,That’s just the tip of the lobster Newburg
1314,6163,7,17,118,142,1.2183098591549295,0.04369804626225305,652,Ahhhh!  Candyland at last!!!
3048,6163,6,19,117,142,1.2183098591549295,0.04253973585097774,652,"You go, I'll watch the fort"""
2980,6163,6,19,117,142,1.2183098591549295,0.04253973585097774,652,I’ve heard of such a place... it’s called the Isle of Dunkin.
1661,6163,6,19,117,142,1.2183098591549295,0.04253973585097774,652,"Okay, If you were stranded on a dessert island...?"
1101,6163,6,19,117,142,1.2183098591549295,0.04253973585097774,652,But is a sugar high worth the loss of limb?
534,6163,7,17,118,142,1.2183098591549295,0.04369804626225305,652,Reminds me of when I gave up sweets for Lent.
3051,6163,1,29,112,142,1.2183098591549295,0.036196388244350154,652,"Don't worry, the Candyland mirage is common in these parts."
9147,6176,3,30,132,165,1.2181818181818183,0.035522420673284934,652,Intermittent fasting
2975,6176,6,24,135,165,1.2181818181818183,0.038517163193983975,652,What are the odds that we would both be both allergic to gluten?
6088,6176,5,26,134,165,1.2181818181818183,0.037545466177750446,652,I Have dreamt of being stranded on a Dessert Island!
7655,6176,3,30,132,165,1.2181818181818183,0.035522420673284934,652,"Yes, but this island is gluten-free."
7674,6180,5,19,109,133,1.218045112781955,0.043142594039353735,652,I would rather the mirage was of sandwiches.
9617,6180,9,11,113,133,1.218045112781955,0.048134894688317977,652,"Come on, Dave, I swear it's my cheat day."
2961,6180,7,15,111,133,1.218045112781955,0.04570695519885318,652,Isn't that Wayne Thiebaud hiding behind the cake?
4407,6180,6,17,110,133,1.218045112781955,0.044443273810524195,652,"I'm feeling more umami right now, but you go for it."
9656,6184,3,28,125,156,1.2179487179487178,0.0367123617007086,652,"Nah, I just went gluten-free."
6817,6184,4,26,126,156,1.2179487179487178,0.03782208994202261,652,You didn't know which way the currents were going when you jumped..
8312,6184,4,26,126,156,1.2179487179487178,0.03782208994202261,652,"Yeah, the mirage is the South Pacific's version of 'The grass is always greener'."
5549,6184,7,20,129,156,1.2179487179487178,0.04097132467224882,652,"Great, that's just great! My insulin supply went down with the boat."
887,6184,4,26,126,156,1.2179487179487178,0.03782208994202261,652,We can't get there without the Good Ship Lollypop.
2843,6184,7,20,129,156,1.2179487179487178,0.04097132467224882,652,"No thanks, you swim over if you want. I'm cutting down on carbs."
2465,6184,3,28,125,156,1.2179487179487178,0.0367123617007086,652,Can't go there ... I'm on keto.
1896,6184,7,20,129,156,1.2179487179487178,0.04097132467224882,652,"OK, OK, so Fyre Festival II wasn’t my best idea."
4969,6184,4,26,126,156,1.2179487179487178,0.03782208994202261,652,That angler fish keeps getting more and more devious!
5398,6193,3,21,100,124,1.217741935483871,0.042168600982961026,652,Well maybe if you weren’t such a stickler for spelling...
5591,6193,6,15,103,124,1.217741935483871,0.04660023540224536,652,"I'm sorry: the short-term rental site said, ""Seaside privacy near trendy dining. and entertainment."""
9096,6193,2,23,99,124,1.217741935483871,0.0405839939544974,652,Let's dive in!
9262,6196,4,24,119,147,1.217687074829932,0.03923246323085375,652,"I understand how your unhappy childhood experiences arouse suspicions, but considering neither of us can swim, isn't it rather a moot point?"
8513,6196,5,22,120,147,1.217687074829932,0.04040265005263695,652,Watch out for the hook.  It's on there somewhere.
5708,6196,4,24,119,147,1.217687074829932,0.03923246323085375,652,"Can't, I'm on a low sugar diet."
4549,6196,3,26,118,147,1.217687074829932,0.03802628316105504,652,"Of course,I've embraced a gluten-free life."
6588,6196,6,20,121,147,1.217687074829932,0.041539885548607346,652,Do you think they might take a palm tree in trade?
2403,6196,3,26,118,147,1.217687074829932,0.03802628316105504,652,My commitment to that Keto diet is starting to waver.
1527,6196,5,22,120,147,1.217687074829932,0.04040265005263695,652,I'll bet property taxes are through the roof.
874,6196,4,24,119,147,1.217687074829932,0.03923246323085375,652,"The cane is so tempting, but are you able?"
650,6196,5,22,120,147,1.217687074829932,0.04040265005263695,652,"I'm a diabetic, but you go ahead... Enjoy yourself."
3180,6196,3,26,118,147,1.217687074829932,0.03802628316105504,652,The swim will burn off at least that many calories!
6640,6206,3,31,136,170,1.2176470588235293,0.03487686999555318,652,I just read a study that said sweets actually help you live longer.
7267,6206,7,23,140,170,1.2176470588235293,0.03866329833037824,652,I would hate to mess up my Paleo Diet now...
5792,6208,5,20,113,138,1.2173913043478262,0.042080570378038064,652,This reminds me of my last diet.
7618,6208,5,25,131,161,1.2173913043478262,0.03809889486455061,652,I'd rather the coconuts than diabetes.
9585,6208,4,22,112,138,1.2173913043478262,0.040804263019248596,652,We can start the Atkins diet tomorrow.
8889,6208,3,24,111,138,1.2173913043478262,0.039486723816328735,652,Luckily neither of us has a sweet tooth.
9360,6208,7,16,115,138,1.2173913043478262,0.04452356060486409,652,Ahoy good ship lollipop . Room for two more?
9185,6208,3,19,93,115,1.2173913043478262,0.044159423919739836,652,"No,thank you. I'm watching my figure."
9207,6208,7,21,133,161,1.2173913043478262,0.040084975901273426,652,What one thing would you bring if you were stranded on a desserted island?
9399,6208,5,20,113,138,1.2173913043478262,0.042080570378038064,652,That's just PERFECT! I learned I was now a diabetic right before our ship went down...
4346,6208,8,19,134,161,1.2173913043478262,0.0410419912353003,652,"What do you think, some kind of mirage?"
9069,6208,3,24,111,138,1.2173913043478262,0.039486723816328735,652,Too bad you don't eat sweets.
4312,6208,4,22,112,138,1.2173913043478262,0.040804263019248596,652,Wished I'd taken swimming lessons when I had the chance.
7711,6208,3,24,111,138,1.2173913043478262,0.039486723816328735,652,Click your heels and you'll be over there in no time.
3062,6208,3,24,111,138,1.2173913043478262,0.039486723816328735,652,At least our island doesn't have any artificial sweetners
77,6208,7,21,133,161,1.2173913043478262,0.040084975901273426,652,I prefer meat. Delicious. Juicy. Meat
286,6208,3,24,111,138,1.2173913043478262,0.039486723816328735,652,No thanks. I'm on a strict coconut diet.
835,6208,5,25,131,161,1.2173913043478262,0.03809889486455061,652,I wonder if it's gluten-free.
1215,6208,2,26,110,138,1.2173913043478262,0.03812367814036347,652,I feel like we've been waiting forever for this cocoa to cool
233,6208,4,27,130,161,1.2173913043478262,0.03706596873612352,652,It's the land of plenty
2386,6208,7,16,115,138,1.2173913043478262,0.04452356060486409,652,Were more healthy.
2500,6208,3,24,111,138,1.2173913043478262,0.039486723816328735,652,"I complained to the Zoning Board, but they said Disney had already started construction."
2805,6208,5,20,113,138,1.2173913043478262,0.042080570378038064,652,"Close one,I don't think he's seeking protein!"
2991,6208,5,20,113,138,1.2173913043478262,0.042080570378038064,652,It's a diabetics oasis!!
2108,6208,2,26,110,138,1.2173913043478262,0.03812367814036347,652,I think we chose the wrong  ship wreck.
3835,6208,6,23,132,161,1.2173913043478262,0.03910454630158591,652,"Seriously, your diabetic?  How am I just finding that out now?"
482,6232,5,28,142,175,1.217142857142857,0.036129929475352866,652,"No, it's not like pie in the sky. I say we make a try for it."
6722,6233,8,17,127,152,1.2171052631578947,0.04269355812891572,652,If only we could get to Ocasio-Cortez Island.
9114,6233,4,25,123,152,1.2171052631578947,0.03839513514423931,652,what happened to the lollipop?
8159,6233,5,23,124,152,1.2171052631578947,0.03951360244884129,652,Why couldn't we have crashed on that one?
7770,6233,5,23,124,152,1.2171052631578947,0.03951360244884129,652,Parting really is such sweet sorrow.
7483,6233,6,21,125,152,1.2171052631578947,0.04060127035236401,652,"Alas, I see no chocolate bar."
7219,6233,4,25,123,152,1.2171052631578947,0.03839513514423931,652,I'm beginning to regret my sugar cleanse.
4046,6233,7,19,126,152,1.2171052631578947,0.041660551244149774,652,There is only one thing worse than getting stuck here: Diabetes.
3362,6233,6,21,125,152,1.2171052631578947,0.04060127035236401,652,Wouldn’t it be sweet if we could swim?
2712,6233,2,29,121,152,1.2171052631578947,0.03605425982131721,652,"Well, it wouldn't be my idea of Temptation Island, but TV producers go for anything these days."
2050,6233,6,21,125,152,1.2171052631578947,0.04060127035236401,652,Don't take the bait. The last guy that swam over there got eaten by cannibals.
1530,6233,8,17,127,152,1.2171052631578947,0.04269355812891572,652,"And me, off carbs again."
775,6233,4,25,123,152,1.2171052631578947,0.03839513514423931,652,"That' s your idea of a breakfast mirage?"""
531,6233,4,25,123,152,1.2171052631578947,0.03839513514423931,652,If only we were not diabetics.
3394,6233,5,23,124,152,1.2171052631578947,0.03951360244884129,652,Looks like fun but we have coconuts
2005,6247,3,22,104,129,1.2170542635658914,0.04112227746884291,652,"I can't swim--and besides that, I am trying to cut back on carbs."
4647,6247,6,16,107,129,1.2170542635658914,0.04532564171909496,652,I can't. I'm on a whole foods plant-based diet.
6326,6249,4,28,134,166,1.216867469879518,0.036350877732882605,652,"Sugar island. Sugar free island. I don’t know, you’d think Mother Nature could of added a Sweet Low option."
1540,6249,5,26,135,166,1.216867469879518,0.037341741551228755,652,Get it? DESSERT island?
6832,6251,4,23,116,143,1.2167832167832169,0.03987059257715485,652,With beach season right around the corner I’ll wait until the oasis mirage comes around again.
633,6251,3,25,115,143,1.2167832167832169,0.03861568458818178,652,At least we have some greenery to enjoy.
658,6251,6,19,118,143,1.2167832167832169,0.04226878594107649,652,It's too bad we're cutting out sugar.
1122,6251,3,25,115,143,1.2167832167832169,0.03861568458818178,652,Isn't GrubHub amazing!
1984,6251,4,23,116,143,1.2167832167832169,0.03987059257715485,652,You're hallucinating a...what?
2141,6251,5,21,117,143,1.2167832167832169,0.041087190323664265,652,"So, 2 likes?"
2333,6251,4,23,116,143,1.2167832167832169,0.03987059257715485,652,Remember when we were kids? That was our treasure island
3661,6251,4,23,116,143,1.2167832167832169,0.03987059257715485,652,Any errors in spelling are the fault of my Iphone.
4288,6251,6,19,118,143,1.2167832167832169,0.04226878594107649,652,I think you forgot an “S” in the GPS.
7495,6251,5,21,117,143,1.2167832167832169,0.041087190323664265,652,And YOU said I was wasting my time playing Candy Crush
9650,6261,5,24,128,157,1.21656050955414,0.0386765285919154,652,At least we have front-row seats to Survivor: Sweets Island.
8355,6261,7,20,130,157,1.21656050955414,0.040733186698041,652,"If my memory serves me well, the trick is to get Ice Cream Floats via the Gum Drop Mountains pass without getting stuck in the Molasses Swamp."
7838,6261,6,22,129,157,1.21656050955414,0.039718171927335184,652,It’s so unfair we landed on Keto island.”
7989,6261,6,22,129,157,1.21656050955414,0.039718171927335184,652,"Yes I can swim, but my nutritionalist has me on a strict whole foods diet."
1978,6261,4,26,127,157,1.21656050955414,0.03760604401679526,652,"This is one tough level, isn't it?"
1541,6261,3,28,126,157,1.21656050955414,0.03650418098334813,652,I bet that's where they go when they get voted off the island.
2054,6261,5,24,128,157,1.21656050955414,0.0386765285919154,652,"You go ahead, I’m doing no carbs this week."
9335,6268,4,21,109,134,1.2164179104477613,0.04152023612273858,652,Diet be damned. I'm going for it.
8441,6268,5,19,110,134,1.2164179104477613,0.04285033090096287,652,"You are not thinking of deserting me, are you?"
7903,6268,5,19,110,134,1.2164179104477613,0.04285033090096287,652,I love your view
6052,6268,3,23,108,134,1.2164179104477613,0.04014609765660815,652,"We are saved, unless of course they are not gluten-free."
7208,6268,4,21,109,134,1.2164179104477613,0.04152023612273858,652,We’ve got our beach bods.
3381,6268,7,15,112,134,1.2164179104477613,0.04539375022610612,652,The next time WE take the Good Ship Lollipop.
2106,6268,6,17,111,134,1.2164179104477613,0.04414036371572012,652,"I am NOT saying that you're paranoid, but what if it isn't a trap?"
1760,6268,4,21,109,134,1.2164179104477613,0.04152023612273858,652,Candy Land? Truth or dare...
1445,6268,4,21,109,134,1.2164179104477613,0.04152023612273858,652,I'm waiting for door number two.
5912,6268,6,17,111,134,1.2164179104477613,0.04414036371572012,652,They were out of Crispy-Cremes.
9353,6278,8,16,124,148,1.2162162162162162,0.043454164777694045,652,Frickin' autocorrect
1240,6278,5,22,121,148,1.2162162162162162,0.04015567763660926,652,I'd like to add you to my LinkedIn network
1345,6278,5,22,121,148,1.2162162162162162,0.04015567763660926,652,I once wrote a song about this very scene
3992,6278,5,22,121,148,1.2162162162162162,0.04015567763660926,652,"No, I think I'd know if it was an illusion."""
6954,6278,5,22,121,148,1.2162162162162162,0.04015567763660926,652,Evolve!
9266,6278,1,30,117,148,1.2162162162162162,0.03528121019787079,652,All it’s missing is a candy striper to serve it up!
5322,6284,6,23,133,162,1.2160493827160495,0.03888557197968405,652,I think we picked the wrong deserted island
1728,6284,7,21,134,162,1.2160493827160495,0.039859364574572884,652,"Of course it's real,we only took one mushroom."
3273,6284,7,21,134,162,1.2160493827160495,0.039859364574572884,652,I say it's a mirage and I say to Hell with it.
7611,6287,2,23,100,125,1.216,0.04029568135028705,652,And we end up on a desert island!
7796,6287,2,23,100,125,1.216,0.04029568135028705,652,I'm tired of eating dates. Let's swim over and get some real dessert!
8082,6287,5,17,103,125,1.216,0.044842376271529365,652,"I would, but the sugar will be the end of me."
8798,6287,4,19,102,125,1.216,0.0433797931255199,652,Too bad we're on a diet.
5831,6291,3,24,112,139,1.2158273381294964,0.0392328025530814,652,Can I borrow your blood sugar monitor?
47,6291,4,22,113,139,1.2158273381294964,0.04053982252951266,652,I guess we should have read the fine print in that last Brexit deal they offered.
1578,6291,5,20,114,139,1.2158273381294964,0.041805999871785085,652,"'The grass is always higher in calories on the other isle."""
3082,6291,1,28,110,139,1.2158273381294964,0.036478541185996534,652,"Well, there's The Odyssey, Hansel and Gretel, Charlie and the Chocolate Factory, ... ."
3333,6291,2,26,111,139,1.2158273381294964,0.03788071252779913,652,I knew that my diabetes would eventually catch up with me.
8781,6291,4,22,113,139,1.2158273381294964,0.04053982252951266,652,"I know it’s a mirage, but I still would like to swim over there and check it out."
9237,6291,8,14,117,139,1.2158273381294964,0.04539311477466193,652,If I wasn't gluten-free I'd be over there in a minute.
9943,6291,6,18,115,139,1.2158273381294964,0.04303493975637711,652,"Ya, but at least we're living the raw food lifestyle."
6886,6299,5,23,125,153,1.2156862745098038,0.03928013280323685,652,I thought we were on Christmas Island
7589,6299,3,27,123,153,1.2156862745098038,0.03702607471808098,652,My doctor told me to avoid such islands.
6868,6299,6,21,126,153,1.2156862745098038,0.04035998197528621,652,"I always cheated on my diets, so I guess that makes ours the figurative island of just desserts."
9915,6299,5,23,125,153,1.2156862745098038,0.03928013280323685,652,Looks like Moreau has developed a sweet tooth.
8701,6299,5,23,125,153,1.2156862745098038,0.03928013280323685,652,I guess I'm just more of a savory than sweet kinda guy.
6263,6299,8,17,128,153,1.2156862745098038,0.042437327543760756,652,And I always thought the Big Rock Candy Mountain was in Idaho.
6068,6299,5,23,125,153,1.2156862745098038,0.03928013280323685,652,I'd prefer Go Fish.
5320,6299,3,27,123,153,1.2156862745098038,0.03702607471808098,652,There must been a typo in the travel brochure.
2422,6299,8,17,128,153,1.2156862745098038,0.042437327543760756,652,"Sorta ironic that there's no taffy, eh?"
1878,6299,5,23,125,153,1.2156862745098038,0.03928013280323685,652,I hope some have coconut.
758,6299,6,21,126,153,1.2156862745098038,0.04035998197528621,652,"While an excellent illustration of homophones, I'm upset you didn't wish for a boat."
318,6299,5,23,125,153,1.2156862745098038,0.03928013280323685,652,Grubhub?
6304,6311,5,26,136,167,1.215568862275449,0.03714017467354157,652,I am gluten free so those are all yours.
9808,6312,3,22,105,130,1.2153846153846153,0.040838871226503135,652,"Lesson learned, Amelia. If you're planning to circumnavigate the globe, best to start with a few swimming lessons."
6528,6312,5,18,107,130,1.2153846153846153,0.043661591494225584,652,"No, I don't smell anything but I think I hear Burl Ives singing."
7156,6312,4,20,106,130,1.2153846153846153,0.04227379788275202,652,"Candy kills, they said. Nature revitalizes, they said."
344,6312,5,18,107,130,1.2153846153846153,0.043661591494225584,652,Who needs the hollow calories?
6039,6312,4,20,106,130,1.2153846153846153,0.04227379788275202,652,MAKES MY TEETH HURT JUST LOOKING AT IT.
7441,6317,4,23,117,144,1.2152777777777777,0.03962135573486219,652,You're crazy man. After seeing what happened to Harry you still want to try and make it across?
9785,6317,7,17,120,144,1.2152777777777777,0.04314194156089626,652,I wouldn't: I saw an article on the internet about a Bavarian forest witch and her new submarine
9189,6317,6,19,119,144,1.2152777777777777,0.042001214560042084,652,Wanna race?
9070,6317,6,19,119,144,1.2152777777777777,0.042001214560042084,652,I WONDER IF THEY HAVE SUGAR FREE?
8286,6317,2,27,115,144,1.2152777777777777,0.037089104006679675,652,I think Road Scholar undersold it
8009,6317,6,19,119,144,1.2152777777777777,0.042001214560042084,652,"Fool me once, shame on you; fool me twice, shame on you, Gretel."
7855,6317,2,27,115,144,1.2152777777777777,0.037089104006679675,652,"Wouldn't you know, I gave up sugar for Lent."
7281,6317,5,21,118,144,1.2152777777777777,0.040828628771899675,652,You must be seeing a mirage... it's probably just a boat.
6612,6317,4,23,117,144,1.2152777777777777,0.03962135573486219,652,"Figures, I started my Keto diet last week!"
6184,6317,5,21,118,144,1.2152777777777777,0.040828628771899675,652,It's all gluten free.
5621,6317,9,13,122,144,1.2152777777777777,0.04533737217675923,652,"“Now that’s a deserted island!!”
“Shut up mike”."
4981,6317,6,19,119,144,1.2152777777777777,0.042001214560042084,652,I know the sugar rush won't last
2824,6317,6,19,119,144,1.2152777777777777,0.042001214560042084,652,"Well, so much for The Good Ship Lollipop."
2692,6317,3,25,116,144,1.2152777777777777,0.038376121913807286,652,Good.  Now we can play Candyland.
1943,6317,6,19,119,144,1.2152777777777777,0.042001214560042084,652,Why did you write desert? You should have written dessert!
1051,6317,5,21,118,144,1.2152777777777777,0.040828628771899675,652,Not until the end of swimsuit season.
8327,6333,8,18,132,158,1.2151898734177216,0.04148125311979514,652,I told you to check your spelling !
7031,6333,4,26,128,158,1.2151898734177216,0.03739240217015649,652,"Ah, you remembered Christmas again."
3719,6333,7,20,131,158,1.2151898734177216,0.04049776173203979,652,I guess it’s time to take down the Christmas decorations
916,6333,3,28,127,158,1.2151898734177216,0.03629829314129352,652,surely that's  not an optcal illusion?
533,6333,4,26,128,158,1.2151898734177216,0.03739240217015649,652,If only I wasn't doing Keto.
3711,6333,5,24,129,158,1.2151898734177216,0.03845539487689824,652,We are on course. Thar be Dessert Island.
857,6339,4,18,99,121,1.2148760330578512,0.044236111375446724,652,It's CandyLand!  Where are the Ice Cream Floats?
9128,6340,5,19,111,135,1.2148148148148148,0.04256193767901411,652,What a clever way to recycle plastic from the sea.
9409,6340,5,19,111,135,1.2148148148148148,0.04256193767901411,652,"Remember that song, ""Sweet dreams are made of this…""."
9225,6340,4,21,110,135,1.2148148148148148,0.04124269898392608,652,"Not with my diabetes, thanks."
4787,6340,4,21,110,135,1.2148148148148148,0.04124269898392608,652,Just relax and open your heart and all good things will float closer to you.
1890,6340,6,17,112,135,1.2148148148148148,0.04384149699207161,652,"It's tempting, but I have to watch my cholesterol."
772,6340,8,13,114,135,1.2148148148148148,0.046294637891800286,652,Not sure without a tree.
446,6340,4,21,110,135,1.2148148148148148,0.04124269898392608,652,I can't. I'm staying away from palm oil.
3771,6340,5,19,111,135,1.2148148148148148,0.04256193767901411,652,"I made this New Years resolutions, sooo..."
7835,6348,6,20,123,149,1.2147651006711409,0.04103212032487422,652,"Well, now we can finally have dessert before dinner..."
4570,6348,2,28,119,149,1.2147651006711409,0.036343582818513326,652,"If its a mirage, why can we both see it and why have I gained 5 pounds?"
4632,6348,2,28,119,149,1.2147651006711409,0.036343582818513326,652,I always preferred Shoots & Ladders.
4667,6348,5,22,122,149,1.2147651006711409,0.039911654648582935,652,Trump should make a bridge here instead of his wall.
5538,6348,4,24,121,149,1.2147651006711409,0.03875881132362739,652,If we were going to be marooned I would have rathered our view was  the island of misfit toys.
5982,6348,3,26,120,149,1.2147651006711409,0.03757060997180299,652,"The grass is greener, but our view's sweeter."
6534,6348,3,26,120,149,1.2147651006711409,0.03757060997180299,652,I think the cartographer had dyslexia.
9028,6355,6,23,134,163,1.2147239263803682,0.03866899687439083,652,They don't call it Diabetes Island for nothing!
8939,6355,6,23,134,163,1.2147239263803682,0.03866899687439083,652,Looks like climate change finally got the Big Rock Candy Mountain.
708,6355,4,27,132,163,1.2147239263803682,0.03665802224880369,652,"Well, I'll need to be careful.  I have a coconut allergy."
6244,6355,4,27,132,163,1.2147239263803682,0.03665802224880369,652,You don't suppose they offer kale?
5977,6359,3,24,113,140,1.2142857142857142,0.038982055435979795,652,Sweet tooth possibility or hungry shark probability?
6784,6359,6,21,127,154,1.2142857142857142,0.04012150050798342,652,"If that's Fantasy Island, where's the fucking plane?"
7077,6359,5,23,126,154,1.2142857142857142,0.03904935806371853,652,Now that's an island paradise!
6909,6359,6,18,116,140,1.2142857142857142,0.04275424440649402,652,At least our island is GMO free.
7083,6359,2,26,112,140,1.2142857142857142,0.03764074551725821,652,It probably has dairy in it anyway...
9810,6359,6,18,116,140,1.2142857142857142,0.04275424440649402,652,"How did we end up on the island type having only one ""s""?"
8043,6359,6,18,116,140,1.2142857142857142,0.04275424440649402,652,I can't. I just started my keto diet last week.
9552,6359,5,20,115,140,1.2142857142857142,0.04153493098406951,652,Now all we need is Chutes and Ladders!
9851,6359,3,24,113,140,1.2142857142857142,0.038982055435979795,652,Let's name it Candyland.
5629,6359,3,27,124,154,1.2142857142857142,0.03681151300260926,652,I don't eat sweets.
7500,6359,2,23,101,126,1.2142857142857142,0.04001133626209525,652,NOW maybe one of the cruise ships will rescue us.
5397,6359,2,23,101,126,1.2142857142857142,0.04001133626209525,652,"I'd go for it, but I've sworn off simple carbs."
8883,6359,4,22,114,140,1.2142857142857142,0.04027872352660409,652,I'm sorry to be a buzzkill but do you have any idea how painful a root canal is?
5136,6359,7,19,128,154,1.2142857142857142,0.04116572896033456,652,"So what happens if, when we get there, nothing is gluten free?"
276,6359,1,31,122,154,1.2142857142857142,0.03442851454672481,652,I'm not a vegetarian! I'm a dessertarian!
504,6359,5,20,115,140,1.2142857142857142,0.04153493098406951,652,First the “pair o’ dice” incident. Now this.
582,6359,4,28,136,168,1.2142857142857142,0.03596292123756162,652,"Just think, if we'd spelled it with two S's, they'd have dropped us off over there."
1155,6359,4,25,125,154,1.2142857142857142,0.03794693567819258,652,"Maybe that's The Good Ship, Lollipop, coming to our rescue!"
291,6359,2,29,123,154,1.2142857142857142,0.03563993619126802,652,"Oh, to be able to ""buy an 's'"""
3423,6359,4,19,103,126,1.2142857142857142,0.04306826306512387,652,"So, it's NOT desert island, smarty.  You owe me $50."
3843,6359,5,17,104,126,1.2142857142857142,0.04451807959055331,652,"No thanks, I'm still doing Keto."
4737,6359,6,21,127,154,1.2142857142857142,0.04012150050798342,652,Damn!   I wish I hadn’t started Atkins!
4979,6359,5,20,115,140,1.2142857142857142,0.04153493098406951,652,Rethinking that keto diet?
1683,6359,5,17,104,126,1.2142857142857142,0.04451807959055331,652,I’m on keto anyway.
5247,6359,7,16,117,140,1.2142857142857142,0.043939735293797945,652,That drug you gave me is incredible!
1633,6384,7,20,132,159,1.2138364779874213,0.04026500452577324,652,Screw the diet!
2496,6384,5,24,130,159,1.2138364779874213,0.03823673100123131,652,Good thing we're on a diet
6464,6384,6,22,131,159,1.2138364779874213,0.03926396685971161,652,I still have one 'E' coupon I hope to use!
7665,6384,4,26,129,159,1.2138364779874213,0.03718112561180088,652,Pretty but I’m on the keto diet.
7736,6384,4,26,129,159,1.2138364779874213,0.03718112561180088,652,"They said climate change would be bad, but man this is rough."
8348,6384,5,24,130,159,1.2138364779874213,0.03823673100123131,652,"Good news,  the Good Ship Lollipop should be arriving soon."
8422,6390,6,19,120,145,1.2137931034482758,0.04173696012727657,652,"You’re diabetic, dude.”"
5194,6390,3,25,117,145,1.2137931034482758,0.038139448328820824,652,Salted caramel is overhyped anyway.
7734,6390,5,21,119,145,1.2137931034482758,0.04057324734419032,652,We’re on the Keto island
6727,6390,5,21,119,145,1.2137931034482758,0.04057324734419032,652,"It's not a craving, it's boredom."
3005,6390,5,21,119,145,1.2137931034482758,0.04057324734419032,652,I can't go over there... I'm diabetic! All that sugar would kill me!
2295,6390,4,23,118,145,1.2137931034482758,0.039375156627495723,652,Unfortunately I forgot my dessert island playlist.
532,6390,6,19,120,145,1.2137931034482758,0.04173696012727657,652,"I love you, David."
176,6390,6,19,120,145,1.2137931034482758,0.04173696012727657,652,I can't wait for the Sammy Davis Jr. show tonight.
5094,6390,6,19,120,145,1.2137931034482758,0.04173696012727657,652,Bad time to be on the KETO diet Hal.
2311,6399,2,24,105,131,1.213740458015267,0.03908470345758232,652,That's for my Instagram.
6481,6399,6,16,109,131,1.213740458015267,0.044691982421373413,652,"If that's the Candy Cane Forest, where are we?"
9284,6399,6,16,109,131,1.213740458015267,0.044691982421373413,652,I begged you to ask for directions!
469,6402,4,17,96,117,1.2136752136752136,0.04514289430396643,652,"The President heard that the Navy needed new subs, but decided that floating muffins would be better."
2098,6403,7,21,136,164,1.2134146341463414,0.03941556804768705,652,do you think any of that is gluten free?
5474,6403,2,31,131,164,1.2134146341463414,0.03434390060965217,652,I bet it's not gluten-free anyways.
7319,6405,5,22,123,150,1.2133333333333334,0.03967052976883715,652,"It’s not a big rock candy island, but it’ll do."
6155,6405,5,22,123,150,1.2133333333333334,0.03967052976883715,652,"On my cheat day, I'm going to go to town on that thing."
5109,6405,7,18,125,150,1.2133333333333334,0.041865521009132864,652,"I know, but I don't want to get my hair wet"""
5023,6405,5,22,123,150,1.2133333333333334,0.03967052976883715,652,"You said, if you could bring one thing, you'd bring me; I said, if I could bring one thing, it would be Afternoon Tea at the Ritz."
1460,6405,6,20,124,150,1.2133333333333334,0.04078279527880807,652,I keep telling you... The Lollypop was booked.
2817,6405,6,20,124,150,1.2133333333333334,0.04078279527880807,652,"I have the dangest luck!
A few years back I got this close to the Bog Rock Candy Mountain!"
2096,6405,4,24,122,150,1.2133333333333334,0.03852616608912985,652,Looks like we forgot an 's.'
2041,6405,5,22,123,150,1.2133333333333334,0.03967052976883715,652,"The grass is always greener,isn't it?"
8853,6405,6,20,124,150,1.2133333333333334,0.04078279527880807,652,"We lucked out, that would have been impossible to keep to our diets."
3007,6405,1,30,119,150,1.2133333333333334,0.03486845419126424,652,"Now imagine if our deserted island had two s's..."""
7893,6415,5,19,112,136,1.213235294117647,0.04227733962905507,652,"Candy Land used to be bigger, but unfortunately it was not designated for conservation."
6717,6415,2,25,109,136,1.213235294117647,0.038217483701698036,652,"It's either a mirage or the sharks are
suckering us.  Want to go for it?"
9670,6415,6,17,113,136,1.213235294117647,0.043546594677243235,652,All wasted calories -- I'm satisfied with coconuts.
7966,6415,2,25,109,136,1.213235294117647,0.038217483701698036,652,Good Ship Lollipop?
4569,6415,4,21,111,136,1.213235294117647,0.040968780604709626,652,"Great. Thanks Bob. We couldn’t play Chutes and Ladders, could we?"
3274,6415,1,27,108,136,1.213235294117647,0.03676470588235294,652,I've just been dreaming of a passing cruise ship but your Desert Island is much better. Up for a swim?
1177,6415,6,17,113,136,1.213235294117647,0.043546594677243235,652,It’s a Putin trick to lure us into voting for Trump again. Haven’t we lost enough already?
607,6415,3,23,110,136,1.213235294117647,0.03961702313858518,652,"Yeah, but I don't see any of those chocolate cookies you really like."
399,6415,4,21,111,136,1.213235294117647,0.040968780604709626,652,"No, I don't see anything...you're just hallucinating...and a poor speller!"
22,6415,5,19,112,136,1.213235294117647,0.04227733962905507,652,"Oh yeah. That’s Toothache-Diabetes-Make ya fat Island. (Sigh) Gorgeous, isn’t it?"
7651,6425,2,22,98,122,1.2131147540983607,0.04070491887853253,652,There is a gap. And sometimes the inequality is inexplicable.
7731,6425,2,22,98,122,1.2131147540983607,0.04070491887853253,652,"Yeah, but we've got a palm tree. Besides, I'm diabetic."
9686,6425,3,20,99,122,1.2131147540983607,0.04233643133037792,652,"Maybe it is extreme, but real friends don't let their friends fail at Lent."
9068,6428,4,25,126,155,1.2129032258064516,0.0377266609260996,652,"The next time I say ""row right"" remember it's your ""other"" right!"
8119,6428,2,29,124,155,1.2129032258064516,0.035436232637092537,652,I told you that we shouldn't take the Good Ship Lollypop!
8063,6428,4,25,126,155,1.2129032258064516,0.0377266609260996,652,None of it's on my Mediterranean diet.
2808,6428,6,21,128,155,1.2129032258064516,0.0398857782393128,652,"I thought it was spelled with one ""s""."
5740,6428,5,23,127,155,1.2129032258064516,0.03882123291697811,652,"I mean, I guess, if you're into that kind of stuff"
360,6428,5,23,127,155,1.2129032258064516,0.03882123291697811,652,"You can do what you want, but I am sticking with my low carb diet."
5867,6428,4,25,126,155,1.2129032258064516,0.0377266609260996,652,That's where Santa stays
5936,6435,3,24,114,141,1.2127659574468086,0.03873442509926807,652,We didn't get a meal in Economy.
9173,6435,5,20,116,141,1.2127659574468086,0.041267298590509226,652,"Damn, maybe next time"
7712,6435,8,14,119,141,1.2127659574468086,0.044798898432209244,652,"Shhhhh, John. I think it’s playing 'Lucy in the Sky With Diamonds.'"
4331,6435,3,24,114,141,1.2127659574468086,0.03873442509926807,652,Too bad I've given up sweets for Lent.
6877,6435,4,22,115,141,1.2127659574468086,0.040020904666992804,652,Do you think they have gluten free options?
3535,6435,4,22,115,141,1.2127659574468086,0.040020904666992804,652,"Oh great, I’m diabetic."
2107,6435,6,18,117,141,1.2127659574468086,0.04247713567970377,652,"Yeah, but I bet it's all filled with palm oil too."
3597,6435,8,14,119,141,1.2127659574468086,0.044798898432209244,652,I'm trying to give up sugar.
2091,6435,5,20,116,141,1.2127659574468086,0.041267298590509226,652,It's totally normal on day 5 of the Whole30 to see a carbohydrate mirage
1410,6435,5,20,116,141,1.2127659574468086,0.041267298590509226,652,...but I just started the South Beach diet.
8172,6445,6,25,143,174,1.2126436781609196,0.03696521263729962,652,I thought we agreed that you were going to take the sunrise and I was going to sprinkle it with dew.
6634,6446,3,21,103,127,1.2125984251968505,0.041273807875918625,652,Every year it seems to get closer.
6225,6446,3,21,103,127,1.2125984251968505,0.041273807875918625,652,"I would, but I'm off sweets."
8650,6446,4,19,104,127,1.2125984251968505,0.04276109906832521,652,Another sweets shop promotion? Sheesh!
2110,6446,5,17,105,127,1.2125984251968505,0.04419837067680215,652,"Chocolate, chocolate, everywhere, nor not a drop to drink."
1317,6446,1,25,101,127,1.2125984251968505,0.03812556180140144,652,Now that’s a sweet island!
4594,6446,4,19,104,127,1.2125984251968505,0.04276109906832521,652,Wow! Candy land really exists.
37,6452,7,20,133,160,1.2125,0.04003487080662488,652,"Candy, candy everywhere but not a gumdrop to eat."
3616,6452,6,22,132,160,1.2125,0.0390406778668338,652,"You go ahead, I'm going to hang out here.  I'm already down twenty pounds since I started this sugar-free diet."
4054,6452,5,24,131,160,1.2125,0.038020496789240264,652,Its tempting but I didn’t renew my dental plan.
5780,6452,4,26,130,160,1.2125,0.036972176347888575,652,"Nothing’s as sweet as you, Mr. Crusoe."
9230,6452,7,20,133,160,1.2125,0.04003487080662488,652,"I am totally sick of this diet."""
5238,6457,5,21,120,146,1.2123287671232876,0.040320989011895604,652,"Say, you wouldn't happen to be a dentist?"
9944,6457,6,19,121,146,1.2123287671232876,0.04147596251067558,652,Still want to stay glutean free?
9864,6457,5,21,120,146,1.2123287671232876,0.040320989011895604,652,I'm not sure if it is more likely to be a meringue or a mirage.
7862,6457,3,25,118,146,1.2123287671232876,0.0379056134671144,652,"Okay I get it, thats a baker's dozen... so now what ?"
7015,6457,3,25,118,146,1.2123287671232876,0.0379056134671144,652,This is not a good time to be on a sugar-free diet.
6221,6457,4,23,119,146,1.2123287671232876,0.039131941475064144,652,What's the opposite of a mirage?
5025,6457,3,25,118,146,1.2123287671232876,0.0379056134671144,652,I'm going to assume they're made with the stevia plant.
4489,6457,6,19,121,146,1.2123287671232876,0.04147596251067558,652,"Our own ""sweet private island'? This is my last Fyre Festival."
4911,6457,5,21,120,146,1.2123287671232876,0.040320989011895604,652,You go ahead.  I am allergic to sugar
823,6457,5,21,120,146,1.2123287671232876,0.040320989011895604,652,Just my luck I'm on the Atkins Diet.
1227,6457,4,23,119,146,1.2123287671232876,0.039131941475064144,652,First one there gets the strawberry shortcake.
5015,6457,6,19,121,146,1.2123287671232876,0.04147596251067558,652,Do candy canes float?
4908,6457,6,19,121,146,1.2123287671232876,0.04147596251067558,652,My FOMO might not be cured so easily.
2511,6457,5,21,120,146,1.2123287671232876,0.040320989011895604,652,How can we tell if it's gluten-free?
287,6471,4,20,108,132,1.2121212121212122,0.04169425831336409,652,"I figure that the good ship, Lollipop, will find its way over there--and then we'll be rescued."
983,6471,3,22,107,132,1.2121212121212122,0.040283380633923935,652,My doctor said I should stay away from sweets...
3215,6471,4,20,108,132,1.2121212121212122,0.04169425831336409,652,I'm off carbs
5879,6471,4,20,108,132,1.2121212121212122,0.04169425831336409,652,Is it just me or does Cheat Day seem to be getting further and further away?
6529,6471,2,31,132,165,1.2121212121212122,0.03415961705566113,652,I say we hold out for a gluten-free option.
7279,6471,2,24,106,132,1.2121212121212122,0.03882126136917328,652,"Need I remind you again, Carl, that coconut milk is the best hydration there is?"
7661,6471,1,26,105,132,1.2121212121212122,0.03730187546611742,652,"No thanks, I'm on the keto diet."""
1716,6471,3,29,133,165,1.2121212121212122,0.03522483878453961,652,I’m supplying them with all of there palm oil.
9663,6479,6,20,125,151,1.2119205298013245,0.040536437725873835,652,"Otherwise, I'll eat it all in one sitting."
6998,6479,4,24,123,151,1.2119205298013245,0.038296244489538965,652,You Go. I'm watching my carbs.
7511,6479,5,22,124,151,1.2119205298013245,0.0394322528237114,652,"I know it's all we were able to salvage, but we've got to stop playing Candyland."
4017,6479,4,24,123,151,1.2119205298013245,0.038296244489538965,652,Do you think that is a mirage?
2558,6479,5,22,124,151,1.2119205298013245,0.0394322528237114,652,Swim over and tell me if it's real or a mirage
728,6479,7,18,126,151,1.2119205298013245,0.041611332642132466,652,Do you think they used locally sourced sea-salt?
3004,6479,5,22,124,151,1.2119205298013245,0.0394322528237114,652,Playing Candyland as kids didn’t adequately prepare us for this.
9324,6486,7,22,141,170,1.2117647058823529,0.03840560212474741,652,And I thought WE were desserted.
9400,6487,5,19,113,137,1.2116788321167884,0.04199646386377876,652,"Its a great skyline from here, but I am so glad we decided to move to the suburbs."
5961,6487,4,21,112,137,1.2116788321167884,0.0406984123781985,652,This Candyland diet is a tad extreme.
7533,6487,3,23,111,137,1.2116788321167884,0.03935757313593059,652,Just our luck: we’re both diabetic.
1353,6487,2,25,110,137,1.2116788321167884,0.037969413429685094,652,You can gain weight from mirages like that.
197,6487,6,17,114,137,1.2116788321167884,0.0432555798021186,652,"Go for it, but I’m doing that gluten-free thing."
2617,6487,3,23,111,137,1.2116788321167884,0.03935757313593059,652,Have I mentioned I’m diabetic?
5347,6493,5,23,128,156,1.2115384615384615,0.03859571302710641,652,"True, but the gluten ..."
9878,6493,6,21,129,156,1.2115384615384615,0.03965276850371918,652,"This morning, I swam half way there, but then got too tired so I swam back here."
7977,6493,5,23,128,156,1.2115384615384615,0.03859571302710641,652,"Might know, I'm diabetic..."
6815,6493,4,25,127,156,1.2115384615384615,0.03750887999036974,652,If we could be sure it was gluten-free---
5711,6493,5,23,128,156,1.2115384615384615,0.03859571302710641,652,"He would never admit it, but that's what my dentist wants me to eat."
5356,6493,5,23,128,156,1.2115384615384615,0.03859571302710641,652,Day 29 of  The Whole 30.
5153,6493,5,23,128,156,1.2115384615384615,0.03859571302710641,652,I know. But sugar makes you angry.
3557,6493,4,25,127,156,1.2115384615384615,0.03750887999036974,652,5 desserts to bring on a deserted island. Go.
4178,6493,6,21,129,156,1.2115384615384615,0.03965276850371918,652,"Stay strong, Frank. Remember: neither one of us is a dentist..."
4842,6493,6,21,129,156,1.2115384615384615,0.03965276850371918,652,"It's the same,only decadent."
2759,6493,5,23,128,156,1.2115384615384615,0.03859571302710641,652,I know a game we haven’t played in a long time.
2046,6493,4,25,127,156,1.2115384615384615,0.03750887999036974,652,Is this a test of my dieting will-power
1206,6493,4,25,127,156,1.2115384615384615,0.03750887999036974,652,Wave them bye and we'll wait for the entre'  wagon
867,6493,5,23,128,156,1.2115384615384615,0.03859571302710641,652,"Go ahead, but I’ll pass. I doubt it’s gluten free."
70,6507,2,22,99,123,1.2113821138211383,0.04040979034319688,652,It always appears right after we barbecue.
9072,6508,4,22,116,142,1.2112676056338028,0.03976630604598695,652,"Hey, where did the castaways on the other island go?"
6066,6508,5,20,117,142,1.2112676056338028,0.041003039124071584,652,"Sorry, I only do gluten-free islands."
5579,6508,4,22,116,142,1.2112676056338028,0.03976630604598695,652,... and I thought Candy Land was make believe!
5021,6508,5,20,117,142,1.2112676056338028,0.041003039124071584,652,Must be that new dessert island I heard about.
4301,6508,1,28,113,142,1.2112676056338028,0.03580068063517731,652,"I would, but I'm on my second week of keto."
3342,6508,5,20,117,142,1.2112676056338028,0.041003039124071584,652,I guess we'll never find where the Good Ship Lollipop went down.
3329,6508,3,24,115,142,1.2112676056338028,0.038489855490454264,652,"...More like straight to my THIGH-land."""
1529,6508,5,20,117,142,1.2112676056338028,0.041003039124071584,652,Now we'll see if you've really given up sugar!
3460,6516,7,20,134,161,1.2111801242236024,0.039807317252582214,652,"Figures, just when my cholesterol levels are perfect..."
4033,6516,3,28,130,161,1.2111801242236024,0.035694026119738154,652,You did say my company would be sweet enough.
4852,6516,3,28,130,161,1.2111801242236024,0.035694026119738154,652,"Sure, let’s go for it; a diabetic coma is the last thing on my mind."
5715,6516,5,24,132,161,1.2111801242236024,0.037806652903188076,652,It's the flying saucer from carb hell.
6589,6516,6,22,133,161,1.2111801242236024,0.03881987577639751,652,"No thanks, I lost my sweet tooth with the scurvy."
9901,6521,3,21,104,128,1.2109375,0.04098375624962578,652,Goodbye teeth.
6621,6521,2,23,103,128,1.2109375,0.03945423653127441,652,Because of my sweet tooth i’m all washed out.
2088,6521,4,19,105,128,1.2109375,0.04245821207248054,652,"No, we can't, our swimming coach put us on a no carb diet, remember?"
579,6521,5,17,106,128,1.2109375,0.04388315472313635,652,Not me. I didn't pack a toothbrush.
9477,6525,5,21,121,147,1.2108843537414966,0.0400717980606593,652,Are you sure sugar causes cancer?
8861,6525,6,19,122,147,1.2108843537414966,0.041218162985870825,652,"I said, I think we're sitting on the pastie of a submerged giant, not the pastry!"
4565,6525,5,21,121,147,1.2108843537414966,0.0400717980606593,652,"Even if I could swim over, they’re probably not gluten free."
4098,6525,5,21,121,147,1.2108843537414966,0.0400717980606593,652,"Santa has to show up on Christmas Island eventually, right?"
8929,6525,2,27,118,147,1.2108843537414966,0.0364168246757951,652,"When I was a kid, no one believed me when I said that there really was a Candyland"
3522,6525,4,23,120,147,1.2108843537414966,0.038891657713431366,652,It's times like these I regret going gluten-free
3311,6525,5,21,121,147,1.2108843537414966,0.0400717980606593,652,"I can't, I'm on the keto diet."
2726,6525,7,17,123,147,1.2108843537414966,0.04233349643066781,652,Dieting  is tough.
2578,6525,6,19,122,147,1.2108843537414966,0.041218162985870825,652,Well at least Frye festival catered in some food this year...
3902,6525,5,21,121,147,1.2108843537414966,0.0400717980606593,652,Only if you are a dentist.
1165,6535,4,27,135,166,1.2108433734939759,0.03606233798299768,652,Wait. Didn’t you say you were giving up sweets for Lent?
4550,6535,6,23,137,166,1.2108433734939759,0.038033287013555975,652,That can’t be real.  Any self respecting candy cane wouldn’t stick its neck out like that!
4736,6537,5,22,125,152,1.2105263157894737,0.039196774755293144,652,"I don't know, man. Do you think they are Gluten-free?"
9647,6537,6,20,126,152,1.2105263157894737,0.04029299600374564,652,Is that with one or two s's?
9486,6537,5,26,140,171,1.2105263157894737,0.036354829626023814,652,They say that the grass is always higher in high-fructose corn syrup on the other side.
9470,6537,5,22,125,152,1.2105263157894737,0.039196774755293144,652,...and that’s the Recreation Center.
7392,6537,3,22,108,133,1.2105263157894737,0.04001115072838613,652,"I could never spell correctly ""Dessert or Deserted""  Who cares?"
5897,6537,4,20,109,133,1.2105263157894737,0.0414103048668128,652,It's just Blubber playing tricks again.
4721,6537,8,20,143,171,1.2105263157894737,0.039090561340948134,652,It became a dessert island after the wreck of the Good Ship Lollipop washed up
245,6537,5,18,110,133,1.2105263157894737,0.042763705589145634,652,What luck!  A dentist who can’t swim!
3814,6537,6,16,111,133,1.2105263157894737,0.0440755678609802,652,If only I had gone to Harvard
2992,6537,4,20,109,133,1.2105263157894737,0.0414103048668128,652,Wait a minute! How can we both be experiencing the same hallucination?
2946,6537,2,24,107,133,1.2105263157894737,0.03856126315432223,652,No ice cream?
2410,6537,6,16,111,133,1.2105263157894737,0.0440755678609802,652,Think that's keto?
1582,6537,6,16,111,133,1.2105263157894737,0.0440755678609802,652,Man I could go for an Almond Joy right about now.
1502,6537,5,22,125,152,1.2105263157894737,0.039196774755293144,652,Don't go there. There's too much sugar in the average diet.
4419,6537,7,18,127,152,1.2105263157894737,0.041360172904601575,652,I wouldn't eat something sweet if my life depended on it.
8108,6552,4,25,128,157,1.2101910828025477,0.03729355185255694,652,I would but for the gluten.
5726,6552,7,19,131,157,1.2101910828025477,0.0404448632308687,652,This isn't what I meant when I said I was giving up sweets for Lent.
5680,6552,3,27,127,157,1.2101910828025477,0.036182173683338134,652,It's really more of a sometimes place.
8654,6555,3,23,112,138,1.210144927536232,0.03910143069017933,652,I think we misunderstood
8306,6555,3,23,112,138,1.210144927536232,0.03910143069017933,652,"Giving up carbs and sugar is hard, but after a few days, you’ll find you’ll just see them everyplace and everywhere."
8171,6555,7,15,116,138,1.210144927536232,0.04418221331267686,652,"Nah, I’m on paleo."
7539,6555,4,21,113,138,1.210144927536232,0.04043152736189783,652,I'd swim over but Dick Cheney visits there and look what happened to him
9787,6555,5,19,114,138,1.210144927536232,0.04171923929810908,652,"No doubt Sirens disguised as dessert.
I wouldn't touch it."
3876,6555,5,19,114,138,1.210144927536232,0.04171923929810908,652,Playing that game is what got me here.
3041,6555,3,23,112,138,1.210144927536232,0.03910143069017933,652,That’s the Isle of White Sugar.
1970,6555,2,25,111,138,1.210144927536232,0.03772446632123379,652,I'm watching my diet.
2466,6555,4,21,113,138,1.210144927536232,0.04043152736189783,652,I thought Fantasy Island got cancelled.
768,6555,4,21,113,138,1.210144927536232,0.04043152736189783,652,"So, sweet dreams tonight ?"
624,6555,4,21,113,138,1.210144927536232,0.04043152736189783,652,I guess you're newbie in mirages.
612,6555,5,19,114,138,1.210144927536232,0.04171923929810908,652,I'm on the Paleo diet.
412,6555,5,19,114,138,1.210144927536232,0.04171923929810908,652,"Well, they were right, it really isn't greener on the other side. It just really sweet."
2977,6555,2,25,111,138,1.210144927536232,0.03772446632123379,652,It may be a mirage....and those may be sharks....but I'm going' for it anyway!
5085,6569,7,20,135,162,1.2098765432098766,0.03958230146772413,652,Guess all we had was a yellow ticket.
5201,6569,3,28,131,162,1.2098765432098766,0.03549695261674855,652,"You go ahead, I'm still on a coconut jag."
8385,6569,6,22,134,162,1.2098765432098766,0.03860152009157502,652,It’s a mirage. You see yummy desserts. I see a yummy floating breast.
7130,6572,6,18,119,143,1.2097902097902098,0.04193341146460269,652,"Now that's what i call a ""desserted"" island, pluhhh"
5017,6572,6,18,119,143,1.2097902097902098,0.04193341146460269,652,"Yeah, it looks good, but no coffee to go with it? Meh."
8320,6572,4,22,117,143,1.2097902097902098,0.03951486915808532,652,It’s just a come-on.
3178,6572,4,22,117,143,1.2097902097902098,0.03951486915808532,652,You go ahead.  I'm not much of a sweets person.
3515,6572,6,18,119,143,1.2097902097902098,0.04193341146460269,652,I get high just looking at that sugar mirage.
3043,6572,5,20,118,143,1.2097902097902098,0.040742090530802876,652,"I'll swim it, but my cheat day isn't until Saturday."
7909,6578,3,20,101,124,1.2096774193548387,0.04172109251328217,652,Sweet or savory?
457,6579,8,19,140,167,1.2095808383233533,0.039687415213044176,652,No thanks. Nothing is gluten-free.
2756,6579,5,25,137,167,1.2095808383233533,0.03685995558345681,652,"So, do you have a sweet tooth?"
8316,6579,5,25,137,167,1.2095808383233533,0.03685995558345681,652,"Well, there's plenty of fat and sugar. All we need is salt."
10019,6582,3,25,120,148,1.2094594594594594,0.0374462639792873,652,At least we won’t get diabetes.
9079,6582,3,25,120,148,1.2094594594594594,0.0374462639792873,652,...One more 's' and we'd have hit pay dirt...
7245,6582,1,29,118,148,1.2094594594594594,0.034905090736051664,652,"Yeah, I'm not into sweets either, but I wonder if any drinkable water's over there."
6390,6582,2,27,119,148,1.2094594594594594,0.03619798368209525,652,"Mirage or not, we don't need any more cavities."
6009,6582,6,19,123,148,1.2094594594594594,0.04096350419676244,652,LOOK ! another desert island
5192,6582,4,23,121,148,1.2094594594594594,0.038654253962063526,652,"You go, I'll stay here and guard the giant lollipop"
5063,6582,4,23,121,148,1.2094594594594594,0.038654253962063526,652,Supposedly this cures our lack of self control
4920,6582,6,19,123,148,1.2094594594594594,0.04096350419676244,652,"Stranded on a dessert island also means cavities, you know."
1453,6582,6,19,123,148,1.2094594594594594,0.04096350419676244,652,I’ve definitely reached a state of ketosis.
1182,6582,6,19,123,148,1.2094594594594594,0.04096350419676244,652,"Sweet, man..."
5755,6582,4,23,121,148,1.2094594594594594,0.038654253962063526,652,"No, if only one of us sees it, it would be a hallucination. It must be a mirage since both of us are seeing it. Still, it doesn't look like much of a swim."
8167,6593,2,23,104,129,1.2093023255813953,0.039181330657278544,652,But you know you can’t eat just one recommended serving. I’ll wave them off.
8638,6593,4,19,106,129,1.2093023255813953,0.04215951534458739,652,Aw shucks. Shoulda brought the kids.
6172,6593,5,17,107,129,1.2093023255813953,0.043572339449451776,652,"I know, but this whole 'stranded-on-a-desert-island' cliché prevents us from swimming."
3647,6593,3,21,105,129,1.2093023255813953,0.040697674418604654,652,Sweets have never been my thing.
3239,6593,5,26,141,172,1.2093023255813953,0.0361635657957072,652,"John, how did we end up on the wrong deserted island?"
243,6593,3,21,105,129,1.2093023255813953,0.040697674418604654,652,You go. I'm getting ready for swimsuit season.
4322,6593,3,21,105,129,1.2093023255813953,0.040697674418604654,652,Now there's where we need a wall!
7306,6600,5,22,126,153,1.2091503267973855,0.03896404759198868,652,"I miss Steve too, but you can't have sweets on keto"
723,6600,2,28,123,153,1.2091503267973855,0.035499282650981095,652,I wonder if they also have big juicy Kosher hotdogs?
3561,6600,2,28,123,153,1.2091503267973855,0.035499282650981095,652,Too bad I have to watch my blood sugar!
3707,6600,5,22,126,153,1.2091503267973855,0.03896404759198868,652,"No way, man. It’s all carbs and fats..and your toothbrush is where?"
4855,6600,7,18,128,153,1.2091503267973855,0.04111198886896336,652,Pity it's all  turned green.
6020,6600,7,18,128,153,1.2091503267973855,0.04111198886896336,652,So that was the main course. What's for desert?
7716,6600,4,24,125,153,1.2091503267973855,0.03784438786326521,652,"Knowing our luck, those cakes will not be gluten free!"
2876,6607,7,23,147,177,1.2090395480225988,0.037267312982666084,652,Now don't be spoiling your dinner.
6359,6608,4,20,110,134,1.208955223880597,0.04113012824994036,652,"I’m diabetic, swim to the other side and see if you can spot any protein bars."
7685,6608,1,26,107,134,1.208955223880597,0.03681066282959869,652,Ready for a sugar high!
5786,6608,2,24,108,134,1.208955223880597,0.03830464395590235,652,I wonder if the expiration date for the baked goods comes before our own.
9738,6608,3,22,109,134,1.208955223880597,0.03974250368588389,652,"Of all the islands in this ocean, we ended up on one drawn by a good speller!"
8822,6608,3,22,109,134,1.208955223880597,0.03974250368588389,652,Figures I just started my no carb diet!
5583,6608,3,22,109,134,1.208955223880597,0.03974250368588389,652,You go ahead. I'm off carbs.
5146,6608,5,18,111,134,1.208955223880597,0.04247244165915812,652,I wish you wouldn't be such a stickler about spelling.
5462,6608,6,16,112,134,1.208955223880597,0.043773612497995155,652,What if it's a mirage? Our epitaphs would read like a joke.
2810,6608,6,16,112,134,1.208955223880597,0.043773612497995155,652,It's for the best. I forgot my toothbrush.
2677,6608,5,18,111,134,1.208955223880597,0.04247244165915812,652,I told you there was a difference between the islands!
1266,6608,6,16,112,134,1.208955223880597,0.043773612497995155,652,"It was the Big Rock Candy Mountain before the icecaps melted, just like this was Everest."
5760,6608,4,20,110,134,1.208955223880597,0.04113012824994036,652,"It's like GrubHub, but it's called 'SweetFleet."""
75,6620,5,23,130,158,1.2088607594936709,0.03815231641237479,652,"Yes, but that one is an uncharted 'dessert' isle."""
2011,6620,6,21,131,158,1.2088607594936709,0.039194705034142185,652,Who knew mirages could be so punny?
5962,6620,3,27,128,158,1.2088607594936709,0.035977047369997836,652,"Well ..... Just think of all the calories we'll save."""
6763,6620,4,25,129,158,1.2088607594936709,0.037080636355738494,652,"What do you think Wilson?
I don’t know Chuck, it looks kinda fishy!"
7079,6620,4,25,129,158,1.2088607594936709,0.037080636355738494,652,"And that, my son, is the virtue of being vegan."
7801,6620,4,25,129,158,1.2088607594936709,0.037080636355738494,652,"Just my luck, my cardiologist has me on a strict low cholesterol diet."
9881,6626,6,17,116,139,1.20863309352518,0.04268491410043526,652,Being on a no carb diet is getting harder all the time.
8534,6626,5,19,115,139,1.20863309352518,0.04144559659609479,652,Sometimes I'm sorry that i'm on the Atkins diet
5473,6626,6,17,116,139,1.20863309352518,0.04268491410043526,652,"I miss the glaciers, too, but at least we still have part of the Big Rock Candy Mountain."
7368,6626,4,21,114,139,1.20863309352518,0.04016806023012453,652,"I’m actually doing Whole30 right now. But please, don’t let me stop you."
3588,6626,4,21,114,139,1.20863309352518,0.04016806023012453,652,Just our luck....I am off sugar.
3576,6626,5,19,115,139,1.20863309352518,0.04144559659609479,652,"That's why we don't spell ours with two ""S""s"
5098,6626,6,17,116,139,1.20863309352518,0.04268491410043526,652,And I gave up sweets for lent.
1946,6633,2,30,131,163,1.2085889570552146,0.03421243378685645,652,Sugar on our coconuts would be nice.
4867,6633,1,32,130,163,1.2085889570552146,0.03308701049628247,652,They have a more effective branding strategy.
5208,6633,3,28,132,163,1.2085889570552146,0.03530199693585289,652,Phillip stop staring; your blood sugar will spike!”
5432,6633,3,28,132,163,1.2085889570552146,0.03530199693585289,652,"Before you take the plunge, consider your diabetes."
5735,6633,5,24,134,163,1.2085889570552146,0.0373859828242729,652,"Don't forget - they are wrong, we are right."
8615,6638,3,24,117,144,1.2083333333333333,0.03800968060554863,652,Fortunately I’m paleo.
6017,6638,5,15,100,120,1.2083333333333333,0.04567549854280213,652,"I'm not a ""sand is always browner"" kind of guy."
5559,6638,5,15,100,120,1.2083333333333333,0.04567549854280213,652,Seriously?  They  must not know we live in L.A.
710,6638,5,20,119,144,1.2083333333333333,0.04048439222695598,652,"""Never Mind,,, I'm going to take a quick dip,,,,"""
2606,6638,4,22,118,144,1.2083333333333333,0.03926653685851245,652,The Good Ship Lollipop?
858,6638,6,18,120,144,1.2083333333333333,0.041666666666666664,652,They spelled it wrong.
8689,6638,4,22,118,144,1.2083333333333333,0.03926653685851245,652,"It’s a stroke of luck, really.  I’m keto this week."
5138,6638,3,24,117,144,1.2083333333333333,0.03800968060554863,652,Even Hasbro has an island.
8113,6646,7,17,125,149,1.2080536912751678,0.04181095520845027,652,"Darn autocorrect, I said , “I want to book a flight to Dessert 
Island”!"
7818,6646,3,25,121,149,1.2080536912751678,0.03722065406698565,652,Remember what mom said: your eyes are bigger than your stomach.
5339,6646,2,27,120,149,1.2080536912751678,0.0359816948962526,652,"Well, at least we can play Candyland."
9913,6646,4,23,122,149,1.2080536912751678,0.03841967999269932,652,Looks like Candyland. I'm a gamer. I say go for it.
5315,6646,2,27,120,149,1.2080536912751678,0.0359816948962526,652,"Go ahead...go over there and eat all of that.  But, don't come cryin' to me when you need a dentist."
5427,6646,4,23,122,149,1.2080536912751678,0.03841967999269932,652,I totally chose the wrong day to start Keto!
1920,6646,2,27,120,149,1.2080536912751678,0.0359816948962526,652,They’re probably not even vegan.
4296,6646,3,25,121,149,1.2080536912751678,0.03722065406698565,652,I never trust unsolicited gifts.
1628,6646,2,27,120,149,1.2080536912751678,0.0359816948962526,652,Don't you just love Jeff Koonz?
384,6646,3,25,121,149,1.2080536912751678,0.03722065406698565,652,Looks like the candy man REALLY can!!
367,6646,4,23,122,149,1.2080536912751678,0.03841967999269932,652,"I hate to keep saying it, but it's a shame the water's infested with piranhas."
1060,6657,6,14,105,125,1.208,0.045855312423091786,652,"What I wouldn't give for another ""s."""
8261,6658,5,22,127,154,1.2077922077922079,0.03873402441995206,652,You mean the one that’s covered in cheese and avocados?
8251,6658,4,24,126,154,1.2077922077922079,0.03762236316264341,652,I never really liked Candyland.
6895,6658,7,18,129,154,1.2077922077922079,0.04086672880733997,652,Do you know how to swim?
6659,6658,3,26,125,154,1.2077922077922079,0.0364768388449193,652,Dibs on the cupcakes.
6403,6658,3,26,125,154,1.2077922077922079,0.0364768388449193,652,"Roll again, a double six gets us there"
5350,6658,7,18,129,154,1.2077922077922079,0.04086672880733997,652,Don't   be   fooled.  It' another   GOP  tax scam.
4578,6658,7,18,129,154,1.2077922077922079,0.04086672880733997,652,It's probably a manatee.
4466,6658,2,28,124,154,1.2077922077922079,0.035294154392683776,652,A pity we're both diabetic
765,6658,6,20,128,154,1.2077922077922079,0.03981465917961695,652,"Oh look, candy cane trees have sprouted. It must be getting close to the holiday season."
347,6658,4,24,126,154,1.2077922077922079,0.03762236316264341,652,Nothing will grow over there.
333,6658,5,22,127,154,1.2077922077922079,0.03873402441995206,652,"Damn it, and just when I'd gone keto."
4704,6658,4,24,126,154,1.2077922077922079,0.03762236316264341,652,The magic Genie had a lisp and that’s what an extra ‘S’ will get you.
4243,6670,2,23,105,130,1.2076923076923076,0.03891208972839766,652,With my triglycerides being what they are I am glad we didn't end up there!
9035,6670,2,23,105,130,1.2076923076923076,0.03891208972839766,652,"I call that the ""socialist mirage island"". Lots of free stuff but what you don't see is the sharks swimming underneath."
6761,6670,3,21,106,130,1.2076923076923076,0.04041548356023634,652,You enjoy it...I'm on this elimination thing.
2868,6670,3,21,106,130,1.2076923076923076,0.04041548356023634,652,Hell of a place to develop cavities.
1424,6670,5,17,108,130,1.2076923076923076,0.04326583502212179,652,We're on South Beach and it sucks.
1548,6670,4,19,107,130,1.2076923076923076,0.041864924409159,652,"In their defense, they didn't have a lot of island to dessert."
1513,6670,4,19,107,130,1.2076923076923076,0.041864924409159,652,I say let's screw the South Beach diet.
2394,6670,5,17,108,130,1.2076923076923076,0.04326583502212179,652,I thought you said there was a desserted island across the way.
326,6678,6,21,132,159,1.2075471698113207,0.0389695629547607,652,I'm watching my carbs.
980,6678,4,25,130,159,1.2075471698113207,0.03687009418329497,652,"Don't even think about it. Sugar's gonna kill us faster."""
1262,6678,6,21,132,159,1.2075471698113207,0.0389695629547607,652,"You're right, it's two esses because you want seconds."
5071,6678,3,27,129,159,1.2075471698113207,0.035774185513929364,652,"Once upon a time they were called the  Big Rock Candy Mountains.  Now mostly underwater, turned to salt water taffy."
8976,6678,4,25,130,159,1.2075471698113207,0.03687009418329497,652,Not really feeling like desert tonight.
4988,6683,1,26,108,135,1.2074074074074075,0.036569744200040805,652,It's tempting but I'm still trying to drop a few pounds.
5624,6683,2,24,109,135,1.2074074074074075,0.03805134045431201,652,"And we were almost there, until you had to draw Molasses Swamp."
5606,6683,6,16,113,135,1.2074074074074075,0.0434757149271192,652,"On the bright side, the lines at the dessert table are shorter now that the ship sank!"
8503,6683,4,20,111,135,1.2074074074074075,0.040853655275838514,652,"I would go for it, but I can tell they're not vegan."
5016,6683,3,22,110,135,1.2074074074074075,0.03947737111160652,652,They’ll be back when they realize we’ve got the toothpaste.
4671,6683,6,16,113,135,1.2074074074074075,0.0434757149271192,652,"Just remember, you're still counting carbs."
5072,6683,5,18,112,135,1.2074074074074075,0.042185062153688856,652,"Well, Candy, there goes your land."
3728,6683,5,18,112,135,1.2074074074074075,0.042185062153688856,652,Now ask yourself if it’s been worth it.
1757,6683,5,18,112,135,1.2074074074074075,0.042185062153688856,652,It's tempting but I get just enough carbs from our coconut water.
1739,6683,6,16,113,135,1.2074074074074075,0.0434757149271192,652,Betcha a night under the palm that the giraffe on the left finishes his cupcake first.
1093,6683,5,18,112,135,1.2074074074074075,0.042185062153688856,652,They say he’s the Jeff Koons of baking.
884,6683,5,18,112,135,1.2074074074074075,0.042185062153688856,652,It's made of plastic from the Great Pacific Garbage Patch.
4093,6683,4,20,111,135,1.2074074074074075,0.040853655275838514,652,"Nahh!its mostly corn sweeteners, anyway."
503,6696,4,26,134,164,1.2073170731707317,0.03615891918307185,652,Looks like that fake restaurant-display crap from here.
7447,6696,3,28,133,164,1.2073170731707317,0.03510912612698705,652,Have you seen any sharks?
8675,6698,6,17,117,140,1.207142857142857,0.042405118768646284,652,"High in sugar,
high in fat,
let's just stay right
where we're at."
8059,6698,3,23,114,140,1.207142857142857,0.03859882548765667,652,If only this place had a second S.
7955,6698,5,19,116,140,1.207142857142857,0.041175468119551355,652,"It's an easy swim, but I think we should resist."
5234,6698,3,23,114,140,1.207142857142857,0.03859882548765667,652,You go ahead. I’ ve got problems with gluten.
3770,6698,7,15,118,140,1.207142857142857,0.043600103448292474,652,You think they might be gluten-free?
2933,6698,6,17,117,140,1.207142857142857,0.042405118768646284,652,"Enticing, but I'm diabetic."
1691,6698,3,23,114,140,1.207142857142857,0.03859882548765667,652,It's either a mirage or Disney just launched a new cruise ship called Sugar Mountain
2974,6705,8,19,142,169,1.2071005917159763,0.0392553069539259,652,"Candy Crush saga.
Lv. 2."
7635,6706,7,16,122,145,1.206896551724138,0.0425442655708546,652,To think I gave up junk food.
5772,6706,7,16,122,145,1.206896551724138,0.0425442655708546,652,"No,  I doubt that stuff is gluten-free."
5189,6706,4,22,119,145,1.206896551724138,0.03902125332590335,652,Stop!  That's how we ended up here in the first place.
3792,6706,6,18,121,145,1.206896551724138,0.041403249780064086,652,I'd make the swim but beach season is right around the corner
3681,6706,5,20,120,145,1.206896551724138,0.04022988505747127,652,Should we make a swim for it or is it a fat trap?
7934,6706,3,24,118,145,1.206896551724138,0.03777396948311491,652,‘Yes that is Peppermint Bay’
2783,6706,7,16,122,145,1.206896551724138,0.0425442655708546,652,You'll burn off the sugar and carbs swimming there and back.
2478,6706,3,24,118,145,1.206896551724138,0.03777396948311491,652,Disney World was much better!
1885,6706,5,20,120,145,1.206896551724138,0.04022988505747127,652,Life is always sweeter on the other side of the shark infested sea.
1942,6706,4,22,119,145,1.206896551724138,0.03902125332590335,652,"Don't be upset, its the foods that will shorten your life anyhow"
1300,6706,6,18,121,145,1.206896551724138,0.041403249780064086,652,We could easily swim over there but it would be breaking my diet.
1194,6706,5,20,120,145,1.206896551724138,0.04022988505747127,652,"It's a mirage.  Actually, I see Sean Connery, Leonardo DiCaprio and Tom Cruise!"
500,6706,2,26,117,145,1.206896551724138,0.03648406953587099,652,"I'm watching my waistline, but thanks, anyway."
346,6706,6,24,144,174,1.206896551724138,0.036703458268192685,652,I can’t believe I made a spelling mistake on my wish trip form.
81,6706,7,16,122,145,1.206896551724138,0.0425442655708546,652,I'm starting to think we're just a fancy cake decoration.
2214,6706,1,28,116,145,1.206896551724138,0.03514686172740381,652,They cut their tree to compete in the Top Chef  Just Desserts contest.
9606,6722,5,21,124,150,1.2066666666666668,0.03934209131632978,652,Not today. I’m watching my figure.
8959,6722,5,21,124,150,1.2066666666666668,0.03934209131632978,652,And they said being Paleo would pay off...
5423,6722,5,21,124,150,1.2066666666666668,0.03934209131632978,652,I wish I hadn’t given up sugar
4691,6722,4,23,123,150,1.2066666666666668,0.038187886698918753,652,It's times like these I'm glad my parents pushed me through dental school.
634,6722,5,21,124,150,1.2066666666666668,0.03934209131632978,652,The grass always looks greener on the other side.
2886,6722,2,27,121,150,1.2066666666666668,0.0357679154173612,652,It's just a plot to make you give up your diet
940,6722,4,23,123,150,1.2066666666666668,0.038187886698918753,652,"No, I'm on gluten free"
621,6722,3,25,122,150,1.2066666666666668,0.0369976922512267,652,You really are a stickler for this whole no carb no sugar thing.
4217,6722,1,29,120,150,1.2066666666666668,0.03449432293422397,652,"This diet retreat is clearly working.  All those sweets have lost their appeal, but are we expected to swim home?"
4915,6731,3,19,99,121,1.2066115702479339,0.04218115753776808,652,Diabetes is a bitch.
7038,6731,4,17,100,121,1.2066115702479339,0.04378345689935829,652,"Dessert islands—that one extra ""s"" will kill you with carbs."
4001,6731,2,21,98,121,1.2066115702479339,0.04051554028263788,652,Did they misspell desert?
853,6731,4,17,100,121,1.2066115702479339,0.04378345689935829,652,I'm tempted to put sweet treats back in my diet.
9922,6735,7,18,130,155,1.206451612903226,0.040624342158753206,652,Too bad I just started keto.
6662,6735,3,26,126,155,1.206451612903226,0.036265527068911556,652,"I agree it's tempting, but I'm strictly keto."
5687,6735,5,22,128,155,1.206451612903226,0.03850665935534664,652,If only they were gluten free.
5301,6735,3,26,126,155,1.206451612903226,0.036265527068911556,652,At least we don't have to worry about diabetes.
9563,6735,6,20,129,155,1.206451612903226,0.039579666437074466,652,"It's tempting, but remember, sugar is really bad for your health."
2417,6735,7,18,130,155,1.206451612903226,0.040624342158753206,652,I gave it up for Lent.
1822,6735,8,16,131,155,1.206451612903226,0.041642818785389966,652,"If I remembers me small uninhabited islands, that would be Cake Island.  Odd name for an island, I’d say."
824,6735,5,22,128,155,1.206451612903226,0.03850665935534664,652,"You can try to swim for it, but I'm staying on my low carb diet."
3176,6735,5,22,128,155,1.206451612903226,0.03850665935534664,652,"Whatever you say, Willy Wonka, just don’t mention coconut shrimp..."
2349,6744,3,20,103,126,1.2063492063492063,0.04112306010085403,652,I understand that you're diabetic but you couldn't think about me?
6758,6744,5,16,105,126,1.2063492063492063,0.04410299679190414,652,"I could get over the loss of the boat, but to be stranded on the wrong island …"
7047,6744,3,20,103,126,1.2063492063492063,0.04112306010085403,652,"I,d love to swim over there but I,m on a sugar free diet"
7078,6747,4,25,131,160,1.20625,0.03666188683825316,652,"No, I was seeing the cupcake island yesterday."
9351,6747,6,21,133,160,1.20625,0.03874695666685832,652,Let's take  a chance and swim there. Maybe it's not artificially sweetened.
8007,6747,3,27,130,160,1.20625,0.0355735518937823,652,But where will we get our teeth cleaned?
5030,6747,4,25,131,160,1.20625,0.03666188683825316,652,"What'd you expect, a big rock candy mountain?"
9279,6747,4,25,131,160,1.20625,0.03666188683825316,652,Somehow it seemed sweeter in my memory
4198,6747,5,23,132,160,1.20625,0.0377188321497649,652,"Well, one of us is going to have an epic dessert."
3705,6747,6,21,133,160,1.20625,0.03874695666685832,652,"The good ship ""Lollipop"" should be here any day now."
3011,6747,4,25,131,160,1.20625,0.03666188683825316,652,It reminds me of the Good Ship Lollipop.
4427,6747,5,23,132,160,1.20625,0.0377188321497649,652,You’re better off without all those empty calories.
4546,6756,3,21,107,131,1.2061068702290076,0.04013710684745936,652,Sweet dude.
7009,6756,4,19,108,131,1.2061068702290076,0.04157435697855915,652,"Yes, but what would our dentist say"
7157,6756,4,19,108,131,1.2061068702290076,0.04157435697855915,652,"Go figure,you can't swim and I'm on a protein only diet."
9471,6756,3,21,107,131,1.2061068702290076,0.04013710684745936,652,Tom Brady says cake clogs your arteries
9182,6760,4,20,112,136,1.2058823529411764,0.040580814578497756,652,It may look good but all that sugar will kill you.
8524,6760,4,20,112,136,1.2058823529411764,0.040580814578497756,652,Maybe next time we should try Weight Watchers
5445,6760,7,14,115,136,1.2058823529411764,0.04442521690971616,652,So that's Hedonism?
3450,6760,5,18,113,136,1.2058823529411764,0.04190149130673101,652,Sandy Candy Land
3415,6760,3,22,111,136,1.2058823529411764,0.03921568627450981,652,"Well, I had always known about Grandpa’s stories about the mountain, but I thought Big Rock Island was a complete myth."
2602,6760,5,18,113,136,1.2058823529411764,0.04190149130673101,652,My bad... It's supposed to be milk and honey..
2816,6760,4,20,112,136,1.2058823529411764,0.040580814578497756,652,No I've never been to a Trump rally. Why do you ask?
2383,6760,4,20,112,136,1.2058823529411764,0.040580814578497756,652,Last week it was giant bottles of diaper rash cream.
161,6760,5,18,113,136,1.2058823529411764,0.04190149130673101,652,"Go ahead without me, I’m doing keto."
155,6760,2,24,110,136,1.2058823529411764,0.03780129082593793,652,"When we've totally depleted all of Earth's resources, we'll just move to Mars. But for now...race ya to the cupcake!!!"
3017,6760,4,20,112,136,1.2058823529411764,0.040580814578497756,652,"Fake news, I say"
7240,6771,4,21,116,141,1.2056737588652482,0.03965112612632209,652,"That's the English language for you, a real kick in the teeth"
9547,6771,4,21,116,141,1.2056737588652482,0.03965112612632209,652,"So, how's your A1c?"
9510,6771,5,19,117,141,1.2056737588652482,0.04090878787839137,652,"'You've really bought into the ""sugar is not good for you"" thing?'"
8417,6771,2,25,114,141,1.2056737588652482,0.03700780401345189,652,Damn! I gave up carbs for Lent.
5245,6771,7,15,119,141,1.2056737588652482,0.043314699247099214,652,"Yeah, but the carbs."
509,6771,4,21,116,141,1.2056737588652482,0.03965112612632209,652,I'm proud of you for sticking to your cleanse.
2095,6771,3,23,115,141,1.2056737588652482,0.03835224479077833,652,I don't have a sweet tooth after all that coconut.
1241,6771,5,19,117,141,1.2056737588652482,0.04090878787839137,652,"Here's the question. Do you want to be the first one to go, or the second one?"
4603,6771,7,15,119,141,1.2056737588652482,0.043314699247099214,652,Too much salt in the diet can make you see things.
154,6771,3,23,115,141,1.2056737588652482,0.03835224479077833,652,"Don't go there, it'll mess with your head."
31,6771,4,21,116,141,1.2056737588652482,0.03965112612632209,652,Are you still on the low-carb diet?
8126,6782,7,23,150,180,1.2055555555555555,0.036699005733991985,652,"That island over there is called Moderation, and in it, you can have everything."
8901,6783,7,16,123,146,1.2054794520547945,0.04227561927171051,652,This was the wrong week to go gluten-free
7430,6783,6,18,122,146,1.2054794520547945,0.04114309995025971,652,"And now I have another diner, rather than dinner..."
6783,6783,4,22,120,146,1.2054794520547945,0.038778964026104916,652,It must be one of Picasso's unconventional sculptures that make us hallucinate.
6275,6783,3,24,119,146,1.2054794520547945,0.03754110733114273,652,I bet they're all coconut flavored anyway...
4765,6783,7,16,123,146,1.2054794520547945,0.04227561927171051,652,The contest among deserted islands is really heating up
3817,6783,5,20,121,146,1.2054794520547945,0.03997851125576714,652,Do you see food or calories?
3570,6783,6,18,122,146,1.2054794520547945,0.04114309995025971,652,"I thought that extra 'S' would cost more, so I settled for this desert one instead."
1676,6783,3,24,119,146,1.2054794520547945,0.03754110733114273,652,Empty calories are still calories.
1599,6783,4,22,120,146,1.2054794520547945,0.038778964026104916,652,"Since you picked this g*@  d*#@  island, I get to pick the next one."
1464,6783,5,20,121,146,1.2054794520547945,0.03997851125576714,652,Winner take all!
5046,6793,5,21,125,151,1.205298013245033,0.03910463779532971,652,You ever have a root beer float?
6715,6793,4,23,124,151,1.205298013245033,0.03795882606658663,652,It's Diabetes Island!
4687,6793,8,15,128,151,1.205298013245033,0.04235650315306475,652,Looks are deceiving. That’s a Candy Shark!
4381,6793,3,25,123,151,1.205298013245033,0.03677733344878099,652,"Stevenson had his Treasure Island, and I have mine."
1855,6793,0,31,120,151,1.205298013245033,0.03297986648473837,652,Oh definitely! Food can really solve all the problems when it's not one of them.
313,6793,5,21,125,151,1.205298013245033,0.03910463779532971,652,It's the Venus Man Trap clam again.
1163,6793,5,21,125,151,1.205298013245033,0.03910463779532971,652,"Shucks, I'm not doing sugar and starches now."
960,6793,4,23,124,151,1.205298013245033,0.03795882606658663,652,You can't swim on a full stomach—we'd be stranded!
242,6793,4,23,124,151,1.205298013245033,0.03795882606658663,652,"Maybe my parents were right when they said I lacked initiative."""
1440,6793,2,27,122,151,1.205298013245033,0.0355566032524519,652,Do you think it's a trick?
3359,6803,3,26,127,156,1.205128205128205,0.03605660093927812,652,Don't you think its time you laid-off the saltwater?
3505,6803,2,28,126,156,1.205128205128205,0.034890765043999246,652,"Yeah, you can go there, but just don't ever write about it."
3538,6803,6,20,130,156,1.205128205128205,0.03934739418450387,652,Good thing we're 'both diabetic and don't know how to swim.
6089,6803,4,24,128,156,1.205128205128205,0.03718590401258445,652,Don’t think about candy. Think about diabetes.
8053,6803,5,22,129,156,1.205128205128205,0.03828190751741528,652,Maybe if you weren't so fatalistic the good stuff would wash-up here
2769,6808,6,21,134,161,1.204968944099379,0.038526844338140374,652,"I've 'eard of the Isle of Wight, but a bloke could gain a lot of wight on that isle, eh?"
8149,6808,7,19,135,161,1.204968944099379,0.039521607839359145,652,I picked the wrong time to start my Keto program
8888,6810,4,17,101,122,1.2049180327868851,0.043456105251336315,652,They all died with diabetes!
3690,6810,4,17,101,122,1.2049180327868851,0.043456105251336315,652,But where's the milk and honey?
7097,6812,6,22,138,166,1.2048192771084338,0.03775178080966941,652,Our island needs another 's'
4256,6812,4,26,136,166,1.2048192771084338,0.035765321948023274,652,Distance makes the heart grow fonder
1367,6814,2,22,103,127,1.204724409448819,0.039269963946852816,652,I thought you said it would be easy to do the keto diet out here!
1470,6814,4,18,105,127,1.204724409448819,0.042333188189562124,652,I'd swim for it except I'm sugar intolerant.
2701,6814,2,22,103,127,1.204724409448819,0.039269963946852816,652,I think it's an all points bulletin from Weight Watchers.
5497,6814,3,20,104,127,1.204724409448819,0.04083031282442006,652,And I thought Big Rock Candy Mountain was a fantasy.
7949,6814,6,14,107,127,1.204724409448819,0.045189241819249895,652,It's a mirage. Don't you have more interesting fantasies?
9451,6814,4,18,105,127,1.204724409448819,0.042333188189562124,652,"Just one more ""s"" ...."
9288,6820,4,19,109,132,1.2045454545454546,0.04128773288571376,652,Seriously? ....you don't see the candy canes?
8458,6820,5,17,110,132,1.2045454545454546,0.04266541114118065,652,It's nothing but empty calories anyway.
7842,6820,4,19,109,132,1.2045454545454546,0.04128773288571376,652,"Vegan island, I’m weakening"
7713,6820,5,17,110,132,1.2045454545454546,0.04266541114118065,652,"Paul, aren't you glad you're here with me . . . you could be alone on that dessert'd island."
5210,6820,4,19,109,132,1.2045454545454546,0.04128773288571376,652,"Maybe it's just me, but I feel like we might've gone a little overboard with our New Year's resolution to diet..."
3469,6820,1,25,106,132,1.2045454545454546,0.036846921497327996,652,"Repeat after me: It's just one S, like in ""Sahara."""
2576,6820,4,19,109,132,1.2045454545454546,0.04128773288571376,652,"And to think, if it wasn’t for a few sharks, that would all be ours."
387,6820,5,17,110,132,1.2045454545454546,0.04266541114118065,652,It's the ghost ship of Christmas past.
6963,6820,3,21,108,132,1.2045454545454546,0.03986246938961656,652,"I'm gonna kill ya, y'know..."
8662,6829,4,20,113,137,1.2043795620437956,0.0403115365590776,652,I think it wants to mate.  We could use the space.
8783,6829,3,22,112,137,1.2043795620437956,0.03895738405999657,652,"In retrospect, escaping Sweet Island may have been an ill-conceived enterprise."
8682,6829,3,22,112,137,1.2043795620437956,0.03895738405999657,652,"We could swim over, but how would we get it back?"
8183,6829,3,22,112,137,1.2043795620437956,0.03895738405999657,652,I say we swim over and get baked!
7509,6829,2,24,111,137,1.2043795620437956,0.03755443470273916,652,"Even if it is only a mirage, I bet it tastes great!"
7065,6829,5,18,114,137,1.2043795620437956,0.04162165526152972,652,Maybe we should go help them out. I hear they're in a State Of Emergency!
5699,6829,4,20,113,137,1.2043795620437956,0.0403115365590776,652,No. There is no way Shirley Temple’s over there.
4913,6829,6,16,115,137,1.2043795620437956,0.042891775361546876,652,Its called watching your diet.
71,6829,4,20,113,137,1.2043795620437956,0.0403115365590776,652,"No, let's wait for Vegan."
8666,6838,4,21,117,142,1.204225352112676,0.039397536179232404,652,I’m glad we already had dessert...!
8597,6838,2,25,115,142,1.204225352112676,0.03677479592410859,652,"I 'd swim over there, but I'm trying to stick to my diet."
7478,6838,4,21,117,142,1.204225352112676,0.039397536179232404,652,Empty calories and gluten. We've got a coconut.
7071,6838,5,19,118,142,1.204225352112676,0.04064549148258601,652,Did I mention I signed up for swimming lessons?
6906,6838,5,19,118,142,1.204225352112676,0.04064549148258601,652,Life isn’t fair. The Good Ship Lollipop goes down and this is where we wind up?
6152,6838,3,23,116,142,1.204225352112676,0.03810873569310427,652,"We could swim over, but the calories, you know?"
4976,6838,4,21,117,142,1.204225352112676,0.039397536179232404,652,Life sure is better with chocolate.
3071,6838,6,17,119,142,1.204225352112676,0.04185625519236066,652,At least we have a tree to sit under to share this hallucination.
2318,6838,8,13,121,142,1.204225352112676,0.044178346963892966,652,"Of course, I'm concerned. But I really think the swim will offset the A1C spike."
1524,6838,6,17,119,142,1.204225352112676,0.04185625519236066,652,We're thousands of miles from civilization and any other human beings.  Of course it counts as Paleo.
1351,6838,6,17,119,142,1.204225352112676,0.04185625519236066,652,It wasn't there yesterday. And what happened to all the sharks that were swimming around here then?
304,6838,2,25,115,142,1.204225352112676,0.03677479592410859,652,"It's a dessert mirage, not the more common desert mirage...."
8937,6850,4,22,121,147,1.2040816326530612,0.038539615677062114,652,This way we have something to strive for.
6492,6850,1,28,118,147,1.2040816326530612,0.03472373966307478,652,#BetterWithMilk
6215,6850,5,20,122,147,1.2040816326530612,0.039730214404797834,652,"Actually, my kids prefer Chutes and Ladders."
644,6850,5,20,122,147,1.2040816326530612,0.039730214404797834,652,I told you not to sink over here
1914,6850,2,26,119,147,1.2040816326530612,0.036040616758104264,652,That ever elusive number on the glycemic index - it's a fantasy.
1029,6850,7,16,124,147,1.2040816326530612,0.04201030655544317,652,My dentist would be happy about the sharks.
5392,6850,4,22,121,147,1.2040816326530612,0.038539615677062114,652,This keto diet is getting harder and harder
9055,6857,4,23,125,152,1.2039473684210527,0.03773245114514628,652,"Of course it's a risk Herman, but they might be gluten free."
7055,6857,4,23,125,152,1.2039473684210527,0.03773245114514628,652,"Yep Zak, it's the big rock candy island."
6170,6857,9,13,130,152,1.2039473684210527,0.043121105599511614,652,Will you be my Valentine?
4614,6857,4,23,125,152,1.2039473684210527,0.03773245114514628,652,"Go ahead.  Not me, I’m on the paleo diet."
5666,6857,5,21,126,152,1.2039473684210527,0.03886999157655591,652,I've been gluten free for so long that I think I'm seeing things.
3000,6857,6,19,127,152,1.2039473684210527,0.0399751750578056,652,I guess we really fudged up with our choice of island.
2693,6857,5,21,126,152,1.2039473684210527,0.03886999157655591,652,"Mirage, shmirage"
2131,6857,4,23,125,152,1.2039473684210527,0.03773245114514628,652,"Yeah, but there is no milk."
891,6857,7,17,128,152,1.2039473684210527,0.041050615058033896,652,What do you mean you can't swim?
3477,6857,7,17,128,152,1.2039473684210527,0.041050615058033896,652,That’s Insulin.
2711,6867,2,28,127,157,1.2038216560509554,0.03469243023008109,652,"Would love to, but I'm pretty sure it's not gluten-free."
2891,6867,5,22,130,157,1.2038216560509554,0.038059725002335024,652,Then it came to me -- coconut cream!
7564,6869,2,29,131,162,1.2037037037037037,0.03407152349402146,652,We always do this around the Holidays
9281,6869,4,25,133,162,1.2037037037037037,0.03625232662060062,652,"It depends, if the wind blows from that way, it smells like peppermint."
9414,6869,3,27,132,162,1.2037037037037037,0.0351788281400217,652,"It's OK, I just went sugar free."
7249,6869,3,27,132,162,1.2037037037037037,0.0351788281400217,652,Try to be more positive! At least we won’t get cavities over here...
6163,6869,6,21,135,162,1.2037037037037037,0.03830918502930805,652,Let's have sex and see if it's still there.
7209,6869,6,21,135,162,1.2037037037037037,0.03830918502930805,652,It's the Big Rock Candy Island. Wanna swim for it?
6760,6869,4,25,133,162,1.2037037037037037,0.03625232662060062,652,I guess they're sick of seafood.
170,6869,4,25,133,162,1.2037037037037037,0.03625232662060062,652,"They say it's mostly made from palm oil, but it still isn't keto."
7248,6869,1,31,130,162,1.2037037037037037,0.03292700224894654,652,Well at least we won't get cavities.
3811,6878,6,22,139,167,1.2035928143712575,0.03754507874741222,652,I guess when I said “desserted” he heard “deserted”
3825,6878,3,28,136,167,1.2035928143712575,0.03454270310023845,652,Your wife locked the pantry too?
4559,6878,3,28,136,167,1.2035928143712575,0.03454270310023845,652,"Careful buddy, that's the corporate headhunter that persuaded me to jump ship"
7764,6881,7,21,144,172,1.2034883720930232,0.03773377063731811,652,"True, but the coconut always looks sweeter on the other side."
9100,6882,4,16,98,118,1.2033898305084745,0.04432003053970261,652,"Bummer, I was using this "" me time"" to cut out sugar."
842,6883,4,17,102,123,1.2032520325203253,0.04313354160628968,652,Too bad my New Year's Resolution was to cut out sugar.
5877,6883,3,19,101,123,1.2032520325203253,0.04155986513665221,652,"I told you I wanted to go to the desserted island--not desert island!. You see the difference one ""s"" can make?"
8924,6883,4,17,102,123,1.2032520325203253,0.04313354160628968,652,I'm not really a sweets guy.
6828,6886,5,16,107,128,1.203125,0.04347052892296711,652,"No, I haven’t heard a peep."
7805,6887,5,17,111,133,1.2030075187969924,0.04237132356749448,652,I am glad. we are here.  Too many tourists on the other one.
9797,6887,3,21,109,133,1.2030075187969924,0.03959149817518683,652,At least you can burn off the calories swimming there and back.
8676,6887,4,19,110,133,1.2030075187969924,0.04100497401911831,652,You go ahead - I'm cutting out sugar this month.
5710,6887,5,17,111,133,1.2030075187969924,0.04237132356749448,652,Should we reconsider our paleo diet?
5829,6887,6,15,112,133,1.2030075187969924,0.043694967987333036,652,Marooned. What a difference the 'ca' makes.
2773,6887,3,21,109,133,1.2030075187969924,0.03959149817518683,652,i don't care for sweets
836,6887,2,23,108,133,1.2030075187969924,0.038125654895399194,652,Looks like we picked the wrong time to go gluten free
2922,6887,4,19,110,133,1.2030075187969924,0.04100497401911831,652,"I'm really not that into sweets, Jim."
2733,6887,2,23,108,133,1.2030075187969924,0.038125654895399194,652,"Just keep reminding yourself, not going over there
could save your life"
251,6896,5,18,115,138,1.2028985507246377,0.04134548201289941,652,Good thing it's only a mirage cause we're diabetics.
2267,6896,5,18,115,138,1.2028985507246377,0.04134548201289941,652,"With my luck, it's probably not gluten-free."
3146,6896,7,14,117,138,1.2028985507246377,0.04382946415909028,652,I see you confuse them too.
4028,6896,4,20,114,138,1.2028985507246377,0.04004575333393034,652,Good thing I’m diabetic
4060,6896,3,22,113,138,1.2028985507246377,0.038702400924038254,652,You have great hair.
6445,6896,3,22,113,138,1.2028985507246377,0.038702400924038254,652,Don’t judge - Survivor Candy Land is probably compelling TV...
9695,6902,7,15,121,143,1.2027972027972027,0.04275483625036223,652,I told you the minimalism craze would come back to bite us
9462,6902,4,21,118,143,1.2027972027972027,0.03914711808136945,652,This isn't what I meant when I said I wanted to cut out desserts.
3744,6902,4,21,118,143,1.2027972027972027,0.03914711808136945,652,Wish I could swim.
6183,6902,3,23,117,143,1.2027972027972027,0.03786824260296677,652,"Too bad you're gluten-free, huh?"
2952,6902,2,25,116,143,1.2027972027972027,0.03654464039496917,652,"""Give us the palmtree."
1869,6902,4,21,118,143,1.2027972027972027,0.03914711808136945,652,We’re millennials.  The “Land of Milk of Honey” has been downgraded too.
437,6902,5,19,119,143,1.2027972027972027,0.04038551609570216,652,"It's called the Isles of Insulin."""
3253,6902,2,25,116,143,1.2027972027972027,0.03654464039496917,652,It was easier to keep up with the Jones' s back home.
9199,6910,5,20,123,148,1.2027027027027026,0.039484939399337046,652,Grass is always greener on the other side
106,6910,1,28,119,148,1.2027027027027026,0.0345158773021979,652,Shall we dine on the island or float it all back on the donut inner tube?
2658,6910,2,26,120,148,1.2027027027027026,0.03582282023093122,652,It’s a common mistake. Believe it or not I actually like deserts more than desserts.
3845,6910,4,22,122,148,1.2027027027027026,0.038303156214757085,652,Think of the health consequences of being stranded on that treeless confection.
3944,6910,3,24,121,148,1.2027027027027026,0.037083731104823436,652,I already have a cramp and we haven't even started to swim.
4634,6910,3,24,121,148,1.2027027027027026,0.037083731104823436,652,"Well, we're lost boys, aren't we?"
6000,6910,5,20,123,148,1.2027027027027026,0.039484939399337046,652,But I'm diabetic.
6903,6910,3,24,121,148,1.2027027027027026,0.037083731104823436,652,"I'm paleo so I'd never touch it, but it's pretty to look at."
8220,6910,4,22,122,148,1.2027027027027026,0.038303156214757085,652,Maybe we're on two humps of an underwater Bactrian Camel.
8203,6919,3,25,125,153,1.2026143790849673,0.03634424941368324,652,Look at that.  And I always thought it was the land of milk and honey.
7834,6919,2,27,124,153,1.2026143790849673,0.03514121730160341,652,"The grass is always greener with you, Arnold."
9720,6919,2,27,124,153,1.2026143790849673,0.03514121730160341,652,It's called the military-industrial complex.
9401,6919,4,23,126,153,1.2026143790849673,0.03750871601974025,652,We’re just one typo too short.
7527,6919,6,19,128,153,1.2026143790849673,0.039735404886077685,652,And there goes our fantasy island drifting away...
2530,6919,5,21,127,153,1.2026143790849673,0.03863810411310346,652,If you clean up your room you may have some.
4866,6919,4,23,126,153,1.2026143790849673,0.03750871601974025,652,"Just as well neither of us can swim, Harry. Can you imagine what that stuff would do to your teeth"
6945,6919,4,23,126,153,1.2026143790849673,0.03750871601974025,652,"I'm on a gluten free diet, but you go ahead."
2390,6919,5,21,127,153,1.2026143790849673,0.03863810411310346,652,Fyre Festival 2019
1748,6919,2,27,124,153,1.2026143790849673,0.03514121730160341,652,"What you bet, there’s not a single gluten-free  piece?"
1009,6919,7,17,129,153,1.2026143790849673,0.040803207146816664,652,"Well, I am on the Mediterranean diet."
1161,6930,6,20,132,158,1.2025316455696202,0.03889082753360974,652,We should've taken our toddler swimming lessons more seriously.
2062,6930,7,18,133,158,1.2025316455696202,0.0399139339245385,652,"Just our luck, no keto..."
5595,6930,4,24,130,158,1.2025316455696202,0.036759286664489056,652,"I would swim over, but I’m on a diet."
5922,6930,3,26,129,158,1.2025316455696202,0.03564575011131952,652,"I could swim across, but I'm on a low carb diet."
7025,6930,3,26,129,158,1.2025316455696202,0.03564575011131952,652,"Well, it looks good but you know I'm on this diet..."
8352,6930,3,26,129,158,1.2025316455696202,0.03564575011131952,652,No way. I've gone gluten-free.
8550,6930,6,20,132,158,1.2025316455696202,0.03889082753360974,652,"Funny, my last flashback was in 1998, but I don't remember the candy canes."
7851,6937,5,23,135,163,1.2024539877300613,0.03708649082136454,652,I get the periscopes but whats the rest of the junk.
5817,6938,3,28,137,168,1.2023809523809523,0.03435785506753902,652,Have you ever read 'The Big Rock Candy Mountain'?
7667,6938,8,18,142,168,1.2023809523809523,0.03920321673014316,652,"Since I've been on this diet, I no longer crave refined carbs."
2649,6940,5,25,143,173,1.2023121387283238,0.03569781159499867,652,Neverland?
2065,6941,3,20,106,129,1.2015503875968991,0.04025693425938176,652,"You go ahead, I promised my wife I would give up sugar, so I'm going to stay here and die of starvation."
2557,6941,2,22,105,129,1.2015503875968991,0.03872333566412419,652,Welcome to fantasy island for diabetics.
4788,6941,2,22,105,129,1.2015503875968991,0.03872333566412419,652,I always thought the Big Rock Candy Mountain was in Wyoming.
7357,6941,1,24,104,129,1.2015503875968991,0.03712644197803879,652,"Dang, I wish I hadn’t started my diet"
7721,6941,2,22,105,129,1.2015503875968991,0.03872333566412419,652,My mother always said I had to eat my main course before dessert.
8849,6946,2,23,109,134,1.2014925373134329,0.03787038053310844,652,Let's hope the cannibals have a sweet tooth.
8700,6946,1,25,108,134,1.2014925373134329,0.03635855980492614,652,I’d swim over but I’m trying to cut calories.
9580,6946,3,21,110,134,1.2014925373134329,0.03932412201634623,652,At least we don’t have to count calories.
3998,6946,3,21,110,134,1.2014925373134329,0.03932412201634623,652,How many points?
4947,6946,3,21,110,134,1.2014925373134329,0.03932412201634623,652,I call it the Big Rock Candy Atoll!
3402,6946,6,15,113,134,1.2014925373134329,0.043394113935632216,652,So we can't swim. it's a mirage anyway.
2685,6946,2,23,109,134,1.2014925373134329,0.03787038053310844,652,I'm off sugar.
451,6946,2,23,109,134,1.2014925373134329,0.03787038053310844,652,Coconuts and eggs have their place but sometimes you have to eat dessert first.
3406,6946,5,17,112,134,1.2014925373134329,0.042081210458167456,652,I prefer a Big Mac and fries.
6791,6955,4,20,115,139,1.2014388489208634,0.03978339868432061,652,We could always wash it down with our own urine.
9814,6955,5,18,116,139,1.2014388489208634,0.04107290135151053,652,Still waiting for the Good Ship 'Lollipop.'
9297,6955,7,14,118,139,1.2014388489208634,0.043537478734322,652,It's not worth the swim...I forgot my toothbrush...
5835,6955,5,18,116,139,1.2014388489208634,0.04107290135151053,652,Let's paddle over and snitch the candle canes.
3583,6955,5,18,116,139,1.2014388489208634,0.04107290135151053,652,"""Don't even think of humming Big Rock Candy Mountain."""
3056,6955,4,20,115,139,1.2014388489208634,0.03978339868432061,652,Everyone told me I needed a better divorce lawyer...
2844,6955,5,18,116,139,1.2014388489208634,0.04107290135151053,652,Think the owner is as big as his candy?
2022,6955,5,18,116,139,1.2014388489208634,0.04107290135151053,652,You go ahead. I’m Pre-diabetic.
1979,6955,3,22,114,139,1.2014388489208634,0.03845067484869792,652,...and visions of sugarplums floated in our heads.
8433,6964,3,23,118,144,1.2013888888888888,0.03763071121420765,652,"Nah, I started my keto diet last week."
8299,6964,4,21,119,144,1.2013888888888888,0.03889981392773224,652,It’s no big rock candy mountain but it might be a try
7161,6964,4,21,119,144,1.2013888888888888,0.03889981392773224,652,I don’t care that it’s ON the south beach. You still  can’t eat that stuff until phase 11 of the diet.
5925,6964,6,17,121,144,1.2013888888888888,0.041321250197233685,652,Betcha' none of those goodies are vegan!
8570,6964,5,19,120,144,1.2013888888888888,0.040128800389960424,652,Lucky for me you are on the no sugar diet!
3974,6964,3,23,118,144,1.2013888888888888,0.03763071121420765,652,"At this point, I'd be happy if they swam over here and ate me."
2812,6964,4,21,119,144,1.2013888888888888,0.03889981392773224,652,You do know that sugar rots your teeth right?
282,6964,3,23,118,144,1.2013888888888888,0.03763071121420765,652,I'd swim over but I gave up sugar.
4638,6964,4,21,119,144,1.2013888888888888,0.03889981392773224,652,I don't care what the travel brochures say.  It is definitely NOT the land of milk and honey.
9422,6973,4,22,123,149,1.2013422818791946,0.03806953476017015,652,I've come to hate Burl Ives.
9405,6973,4,22,123,149,1.2013422818791946,0.03806953476017015,652,Lots of people eating healthy these days.  It’s called the island of misfit carbs.
8652,6973,5,20,124,149,1.2013422818791946,0.03924263240944736,652,'Remember the one time you skipped swimming lessons?'
6566,6973,2,26,121,149,1.2013422818791946,0.03560758393546793,652,Well that wouldn't have fit our no carb lifestyle anyway.
6388,6973,5,20,124,149,1.2013422818791946,0.03924263240944736,652,"Nah, I’m on a diet."
3715,6973,4,22,123,149,1.2013422818791946,0.03806953476017015,652,If you pick one your FB page will be filled with related ads for eternity.
2449,6973,6,18,125,149,1.2013422818791946,0.04038166564160291,652,"If I weren't a diabetic, I'd be over there in a second!"
1352,6973,4,22,123,149,1.2013422818791946,0.03806953476017015,652,You go.  I can't.  I'm prediabetic.
830,6973,6,18,125,149,1.2013422818791946,0.04038166564160291,652,Save room for desert island.
3020,6973,5,20,124,149,1.2013422818791946,0.03924263240944736,652,"I would, but I've given up sugar for lent."
6814,6983,5,21,128,154,1.2012987012987013,0.038408927942357264,652,Seems to me we landed on Keto Island.
9692,6983,5,21,128,154,1.2012987012987013,0.038408927942357264,652,Sunsets are beautiful in this island
5086,6983,4,23,127,154,1.2012987012987013,0.03728757578413456,652,"Whew! I thought we’d never get off Sugar-Addict island! I’ve heard  coconuts are really good for you, we’re safe now."
938,6983,6,19,129,154,1.2012987012987013,0.03949845798894948,652,Are we on the wrong island?
2427,6983,4,23,127,154,1.2012987012987013,0.03728757578413456,652,I think we landed on the wrong deserted island.
4510,6983,2,27,125,154,1.2012987012987013,0.034937063875064685,652,"Nah, it's probably not gluten-free."
3360,6989,6,20,133,159,1.20125786163522,0.038666443836710765,652,Looks like I picked the wrong week to go gluten-free.
8978,6989,4,24,131,159,1.20125786163522,0.03654956753748931,652,The travel agent said it was only one ‘s’
6611,6991,5,23,136,164,1.201219512195122,0.03688032626507339,652,That's called the Isle of Fructose Death.
8729,6991,3,27,134,164,1.201219512195122,0.03479260075423782,652,I'm not afraid of sharks. I have a gluten allergy.
6137,6993,5,25,144,174,1.2011494252873562,0.03551109883993029,652,Looks like I picked the wrong week to start the Paleo diet
5927,6994,3,23,119,145,1.2,0.03739608847125848,652,"If I made that swim, how many calories do you think MyFitnessPal would give me to play around with?"
5620,6994,3,25,127,155,1.2,0.03592106040535498,652,"""I did not know until just this moment how much of a drag it is being a diabetic."""
5618,6994,5,16,109,130,1.2,0.04285572306476345,652,It's all yours. I'm on a paleo diet.
5199,6994,5,19,121,145,1.2,0.03987528450276242,652,It seems Emperor Wonka has expanded his empire.
5147,6994,3,23,119,145,1.2,0.03739608847125848,652,Sure it’s tempting. But remember- you’re down to your last pair of pants.....and they’re size 32.
4982,6994,2,23,110,135,1.2,0.0376184328457919,652,Their cannibalism options are better there
4740,6994,5,21,129,155,1.2,0.03818241665698899,652,"Even if it is a mirage, let's swim over"""
4758,6994,6,18,126,150,1.2,0.04013400372543907,652,"It's spelled with two ""s"", because you always want more."
4545,6994,6,22,142,170,1.2,0.03693815679992497,652,I wonder if there are gluten-free options?
4518,6994,4,18,108,130,1.2,0.04144095094259825,652,"But it is not really the ""Good Ship Lollipop""!"
4476,6994,5,18,117,140,1.2,0.04080384481007503,652,What a time to start my low carb diet.
4354,6994,4,22,124,150,1.2,0.03783870158723217,652,What about our pledge to go Paleo?
5976,6994,3,22,115,140,1.2,0.03820214529901523,652,I'm on a low-carb diet anyway.
6255,6994,2,25,118,145,1.2,0.03609268613358064,652,"Sure, and we can just walk right on over there, too."
8841,6994,5,16,109,130,1.2,0.04285572306476345,652,I can't believe I gave up sugar last year
7186,6994,5,19,121,145,1.2,0.03987528450276242,652,I bet none of it’s gluten free though.
7573,6994,4,19,112,135,1.2,0.040450749421987744,652,They never asked you If you could take five things to a deserted island what would they be?
7580,6994,1,29,125,155,1.2,0.03350743528714804,652,"Yeah, but they said J-Lo would be on this island."
7676,6994,2,25,118,145,1.2,0.03609268613358064,652,"You crave it now - next thing you know, you‘re covered in whipped cream fighting a sugar shock."
7833,6994,7,16,127,150,1.2,0.041233769093384276,652,Was purposefully sinking the ship really necessary to show me how annoying your diet is?
7921,6994,3,23,119,145,1.2,0.03739608847125848,652,"It’s all yours, I’m all about Keto."
8493,6994,4,22,124,150,1.2,0.03783870158723217,652,"That has to be a mirage, right?"
8863,6994,7,18,135,160,1.2,0.039453818238351854,652,I heard that's where the second annual Fyre Festival is gonna be held.
9267,6994,5,19,121,145,1.2,0.03987528450276242,652,If you do go over there I just want a little bit.
9493,6994,4,23,128,155,1.2,0.03706898651442383,652,"Trust me, I read all about it and this diet will definitely work!"
9550,6994,6,18,126,150,1.2,0.04013400372543907,652,what...ever
9739,6994,5,21,129,155,1.2,0.03818241665698899,652,"Eventually, Lord Licorice crossed over the rainbow bridge."
4277,6994,5,21,129,155,1.2,0.03818241665698899,652,"Great concept for a themed restaurant, but no one could convince him the location was wrong."
6273,6994,1,26,113,140,1.2,0.035409801744848216,652,The gluten-free options have really come a long way.
4244,6994,3,21,111,135,1.2,0.03906027149530451,652,"Dang it, I'm diabetic"
8055,6994,4,24,132,160,1.2,0.03634218921558155,652,"At last, junk food with natural ingredients!"
4058,6994,3,21,111,135,1.2,0.03906027149530451,652,Hell no! I just got my cholesterol and blood sugar under control.
4140,6994,2,25,118,145,1.2,0.03609268613358064,652,"Just our luck, Martians with a sweet tooth, and neither of us can swim."
73,6994,4,20,116,140,1.2,0.03952440800778525,652,My dentist would definitely approve of our situation.
172,6994,3,25,127,155,1.2,0.03592106040535498,652,Really? I see 2021.
187,6994,6,13,106,125,1.2,0.045436946739765185,652,"It's true, Diabetes Island doesn't appear on any maps."
364,6994,3,20,107,130,1.2,0.03997614076733735,652,I thought the brochure promised ‘milk and honey’.
480,6994,4,22,124,150,1.2,0.03783870158723217,652,"What a difference one ""s"" can make when it comes to islands."
678,6994,7,16,127,150,1.2,0.041233769093384276,652,It's a shame we're both diabetic.
709,6994,6,20,134,160,1.2,0.038444601979779267,652,"If I wasn't legally blind, I would say for certain that there's a big island over there covered in sweets and that's where you've been going when you take your little afternoon dips. But I know that's just the starvation talking."
787,6994,5,19,121,145,1.2,0.03987528450276242,652,And here I am a diabetic>
1001,6994,6,17,122,145,1.2,0.041058784136762644,652,"Being ""Gluten Free"" is a lifetime commitment."
1436,6994,2,22,106,130,1.2,0.03845557496999762,652,I think I'd prefer to stay dry.
1580,6994,3,24,123,150,1.2,0.03663716527236559,652,Whatever happened to the Chutes and Ladders island?
1899,6994,4,21,120,145,1.2,0.03865556717425341,652,I'd recommend swimming over there if there was something nutritious to eat
1911,6994,5,19,121,145,1.2,0.03987528450276242,652,"Well, Hansel, what do you think?"
662,6994,2,26,122,150,1.2,0.03539486432495052,652,No shade over there. Think I'll stay put.
1966,6994,4,18,108,130,1.2,0.04144095094259825,652,...talk about childhood wishes...we could even eat the dishes...
2129,6994,6,20,134,160,1.2,0.038444601979779267,652,Dude. It'll be like Harold and Kumar go to White Castle!
2178,6994,4,20,116,140,1.2,0.03952440800778525,652,At least we can stay low-carb.
2263,6994,2,25,118,145,1.2,0.03609268613358064,652,Just be thankful for palm oil.
2484,6994,6,19,130,155,1.2,0.039264285582820475,652,Why would I tell the shark you have a sweet tooth?
2499,6994,5,21,129,155,1.2,0.03818241665698899,652,"""We're saved! Java must be close behind!"
4034,6994,5,21,129,155,1.2,0.03818241665698899,652,We can't swim over there without a passport...Should we apply for asylum?
2518,6994,5,19,121,145,1.2,0.03987528450276242,652,But what if we need to go to the dentist?
1947,6994,4,19,112,135,1.2,0.040450749421987744,652,It seems that gluten free island is not so good.
3018,6994,3,25,127,155,1.2,0.03592106040535498,652,I didn't realize you see other people's deserted islands from your deserted island.
3462,6994,3,23,119,145,1.2,0.03739608847125848,652,It reminds me of that place in Maine that’s spelled like ‘desert’ but pronounced like ‘dessert’.
3512,6994,5,18,117,140,1.2,0.04080384481007503,652,The It’s the good ship lollipop.
3607,6994,4,17,104,125,1.2,0.04250237185032414,652,You had one wish! Did you have to bring me down with you?
3699,6994,2,23,110,135,1.2,0.0376184328457919,652,Willy Wonka's Island.
68,7055,4,26,141,171,1.1988304093567252,0.03481721205539484,652,I’m on Adkins.
6844,7056,2,29,135,166,1.1987951807228916,0.03333685215242745,652,"Looks pretty sweet, if only I weren’t on a diet”"
3571,7056,8,17,141,166,1.1987951807228916,0.039363203784746864,652,I told you we should have learned to swim before moving to our favorite island.
570,7058,5,22,134,161,1.1987577639751552,0.03719584288574697,652,They're all out of Sweethearts for Valentines Day too
4270,7058,4,24,133,161,1.1987577639751552,0.03613711355972386,652,"Yeah, but now I wish I'd made ""Rescue Me"" my top Desert Island Disc instead of ""Big Rock Candy Mountain"""
7223,7058,7,18,136,161,1.1987577639751552,0.039227671752052315,652,"There’s one “s” in dessert, isn’t there?"
7970,7061,2,27,127,156,1.1987179487179487,0.03453564322563603,652,"If it's that pesky Martian salesman again, tell him we already have dental insurance."
1850,7061,3,25,128,156,1.1987179487179487,0.0357130737818409,652,Not much protein there.
2053,7061,6,19,131,156,1.1987179487179487,0.03903283997819771,652,Where is The Good Ship Lollipop when you really need it?!
2472,7061,5,21,130,156,1.1987179487179487,0.03795852487682835,652,I told you not to drink the water here
7650,7061,5,21,130,156,1.1987179487179487,0.03795852487682835,652,Neighbor's candies are always sweeter
8443,7061,6,19,131,156,1.1987179487179487,0.03903283997819771,652,"Nah, it’s Kale disguised as dessert."
8564,7061,4,23,129,156,1.1987179487179487,0.03685290524349477,652,It’s just not in line with my paleo diet.
8685,7061,4,23,129,156,1.1987179487179487,0.03685290524349477,652,"Stressed the wrong syllable in the first word too, huh?"
9127,7069,3,24,124,151,1.1986754966887416,0.03641782009236429,652,If only we'd booked on the Good Ship Lollipop...
9115,7069,5,20,126,151,1.1986754966887416,0.038766713321881134,652,It's not very far..but Dr Atkins also sent some sharks
9833,7069,3,24,124,151,1.1986754966887416,0.03641782009236429,652,"Really? you're dairy, gluten, and sugar free?"
9849,7069,2,26,123,151,1.1986754966887416,0.035184618791870695,652,You go ahead. I’m more of a charcuterie person.
8479,7069,7,16,128,151,1.1986754966887416,0.04098119694789331,652,Fyre Festival 2: Dessert Island
3379,7069,7,16,128,151,1.1986754966887416,0.04098119694789331,652,I hope it's a mirage. My doctor told me to lay off sweets.
6035,7069,5,20,126,151,1.1986754966887416,0.038766713321881134,652,"Yeah, but now that it's just us, I'm kind of full."
4874,7069,3,24,124,151,1.1986754966887416,0.03641782009236429,652,"You really think your low carb, low sugar diet created this mirage?"
3802,7069,4,22,125,151,1.1986754966887416,0.037610608091738745,652,Reality Board Games
2595,7069,6,18,127,151,1.1986754966887416,0.03988932542086251,652,Quite a journey from the Big Rock Candy Mountain!
7905,7069,4,22,125,151,1.1986754966887416,0.037610608091738745,652,"Sure, but there is not a dentist or a toothbrush in a 1000 miles."
9975,7080,3,23,120,146,1.1986301369863013,0.03716432253524724,652,"Yes, it’s close and there are no sharks, but no vegetables could mean a trap."
8754,7080,4,21,121,146,1.1986301369863013,0.038414322599695114,652,They've appeared there to test us.
8745,7080,6,17,123,146,1.1986301369863013,0.040799593176557146,652,"Yeah, but it's not allowed on my paleo diet."
8419,7080,5,19,122,146,1.1986301369863013,0.03962490999463604,652,I’d join you if it were any other board game.
7925,7080,6,17,123,146,1.1986301369863013,0.040799593176557146,652,"Really?  You swam from there to here, because this island had what you wanted !"
7787,7080,3,23,120,146,1.1986301369863013,0.03716432253524724,652,I'd like to see their HOA monthly fees!
7624,7080,7,15,124,146,1.1986301369863013,0.041941389040685444,652,"If we could swim, that would be sweet."
7132,7080,3,23,120,146,1.1986301369863013,0.03716432253524724,652,And I was wishing for Chutes and Ladders!
6607,7080,4,21,121,146,1.1986301369863013,0.038414322599695114,652,I wonder if it has pretty lights at night.
5859,7080,3,23,120,146,1.1986301369863013,0.03716432253524724,652,"I mean, I hear some witches are actually pretty nice."
4072,7080,5,19,122,146,1.1986301369863013,0.03962490999463604,652,Nice to meet you Willy. My name is Roald.
3815,7080,4,21,121,146,1.1986301369863013,0.038414322599695114,652,"It can't be Julia Child's Floating Island ,dude, her's was made with meringue."
1701,7080,3,23,120,146,1.1986301369863013,0.03716432253524724,652,"If we can just get through Molasses Swamp, Gumdrop Mountain will be a piece of cake.”"
1364,7080,7,15,124,146,1.1986301369863013,0.041941389040685444,652,thank god we got away!
5006,7094,4,20,117,141,1.198581560283688,0.03926871827107844,652,"Would you please stop singing : ""The Big Rock Candy Mountain!"""
7535,7094,3,22,116,141,1.198581560283688,0.037956753181214165,652,It's lucky we landed on the low glycemic island.
4622,7094,3,22,116,141,1.198581560283688,0.037956753181214165,652,is the good ship lollipop a submarine?
2766,7094,5,18,118,141,1.198581560283688,0.04053824561136123,652,And to think I gave up sweets only last week...
452,7094,2,24,115,141,1.198581560283688,0.0365977866744137,652,They're probably not gluten free anyway.
1669,7094,5,18,118,141,1.198581560283688,0.04053824561136123,652,"I know it’s tempting, but think of the carbs.”"
1072,7094,3,22,116,141,1.198581560283688,0.037956753181214165,652,"Tempting, but think about the calories."
153,7094,3,22,116,141,1.198581560283688,0.037956753181214165,652,"Well, you're the one who wanted to go ""all in"" with the keto diet...."
2201,7094,4,20,117,141,1.198581560283688,0.03926871827107844,652,Let's swim over today. The Big Rock Candy Mountain ain't gonna be around much longer.
6907,7103,1,25,110,136,1.1985294117647058,0.0358826654509767,652,"Screw you, Joyce Kilmer, and the damn tree!"
5341,7103,2,23,111,136,1.1985294117647058,0.03736974901896393,652,I've given up sugar and gone gluten-free.... you?
7530,7103,5,17,114,136,1.1985294117647058,0.041512594804002205,652,"Don’tyou worry, the neighbor’s islands is always sweeter."
1552,7103,3,21,112,136,1.1985294117647058,0.03879987891236252,652,Starbucks is really branching out.
3926,7103,5,17,114,136,1.1985294117647058,0.041512594804002205,652,"Geese Dan, you're taking this no-carbs thing a bit too seriously."
796,7108,4,18,109,131,1.1984732824427482,0.0411517212360109,652,This Keto thing really sucks.
3316,7108,2,22,107,131,1.1984732824427482,0.038191419671095614,652,There goes my diet.
3934,7108,7,12,112,131,1.1984732824427482,0.04523033934180964,652,"If you want to die of diabetes, go ahead."
5176,7108,2,22,107,131,1.1984732824427482,0.038191419671095614,652,It’s not my fault you didn’t ask for a second bag of pretzels.
6491,7108,5,16,110,131,1.1984732824427482,0.04255471739751835,652,The stomach screams yum and the gut whispers chum.
9928,7108,3,20,108,131,1.1984732824427482,0.039699173147435325,652,Survivor Pastry Chef Diet Temptation Island: Desert vs. Dessert
9682,7114,5,15,106,126,1.1984126984126984,0.04367243330856382,652,I think this extreme dieting thing is driving me insane.
4409,7114,5,15,106,126,1.1984126984126984,0.04367243330856382,652,It's obviously a trap set by a creature of great size but we're going to die of dehydration & exposure anyway and Kid Rock's Bawitdaba is stuck in my head so I'm going for it.
128,7114,3,19,104,126,1.1984126984126984,0.040660953962280574,652,So that's how you spend your day off?
4318,7114,1,23,102,126,1.1984126984126984,0.037407819010929336,652,They are palm trees.  Right?
108,7118,4,16,101,121,1.1983471074380165,0.04331293445076264,652,The moral high ground is just as sweet
4216,7118,4,16,101,121,1.1983471074380165,0.04331293445076264,652,"50:50, we eat it or it eats us."
4958,7118,1,22,98,121,1.1983471074380165,0.03824640048736865,652,I’m bored. You wanna play Candyland?
1491,7121,6,20,136,162,1.1975308641975309,0.03800837566741917,652,Damn this gluten allergy!
4669,7121,5,22,135,162,1.1975308641975309,0.036985880884117604,652,At times like these I wish I wasn't so into a healthy diet.
6436,7121,3,26,133,162,1.1975308641975309,0.03485101020875986,652,With your blood sugar levels... don't even think about it!
5504,7124,5,21,131,157,1.197452229299363,0.037737208221581046,652,"Candy Island is a bit of a mouthful for a board game, don't you think?"
9456,7124,6,19,132,157,1.197452229299363,0.03880407455006589,652,Why is it that visions of sugar-plums keep dancing in my head?
9145,7124,2,27,128,157,1.197452229299363,0.034338301244741895,652,I'm sure we can't win the war against sugar.
1925,7124,4,23,130,157,1.197452229299363,0.036639289936226345,652,Pick a card.
873,7124,8,15,134,157,1.197452229299363,0.04085431233472527,652,Could be a mirage.  What do you think?
419,7124,4,23,130,157,1.197452229299363,0.036639289936226345,652,"Maybe the next head of state will inquire on a bridge instead of a wall."""
3627,7124,4,23,130,157,1.197452229299363,0.036639289936226345,652,My diabetes is the only thing keeping me from racing you.
8699,7131,6,18,128,152,1.1973684210526316,0.03964757793433007,652,Have you considered explosive diarrhea in your risk analysis?
846,7131,4,22,126,152,1.1973684210526316,0.03738520676119666,652,Now's not the time to worry about your diet.
2623,7131,5,20,127,152,1.1973684210526316,0.0385329996278268,652,Think they're sugar free?
3429,7131,3,24,125,152,1.1973684210526316,0.036201040162359255,652,I picked the wrong week to quit carbs.
6618,7131,5,20,127,152,1.1973684210526316,0.0385329996278268,652,What are the chances they're gluten-free?
5090,7136,3,23,121,147,1.1972789115646258,0.036935362751103165,652,"No, Doug, it's the lure of the dreaded Candy Kraken."
1159,7136,2,25,120,147,1.1972789115646258,0.03565155061761026,652,You can never escape the Candy Crush...
8646,7136,4,21,122,147,1.1972789115646258,0.03817602626873484,652,"All I'm saying is, maybe next time you manifest something you could be a little more specific, seeing as neither one of us knows how to swim."
5851,7136,3,23,121,147,1.1972789115646258,0.036935362751103165,652,I just really wish we could play Candyland
3710,7136,3,23,121,147,1.1972789115646258,0.036935362751103165,652,It’s not worth the risk. I am gluten free.
701,7136,2,25,120,147,1.1972789115646258,0.03565155061761026,652,That’s just the tip of the sweetburg.
1336,7136,4,21,122,147,1.1972789115646258,0.03817602626873484,652,You know it will only make you sick.
962,7136,6,17,124,147,1.1972789115646258,0.04054361727698009,652,No dessert until you finish your dinner
926,7136,4,21,122,147,1.1972789115646258,0.03817602626873484,652,Some much for the 'Good Ship Lollipop!'
2582,7136,6,17,124,147,1.1972789115646258,0.04054361727698009,652,"Damn,  That Shirley Temple was ahead of her time."
1452,7146,6,16,120,142,1.1971830985915493,0.04149758315400362,652,Go for it. I'll wait for the In'n Out burger delusion.
1558,7146,2,24,116,142,1.1971830985915493,0.03636604080945931,652,Can you believe I gave up Sweets for Lent.
1751,7146,6,16,120,142,1.1971830985915493,0.04149758315400362,652,Sometimes one little ‘s’ can make all the difference.
2380,7146,4,20,118,142,1.1971830985915493,0.03901626796464972,652,"For what it's worth, I was never really allergic to gluten either."
4262,7146,3,22,117,142,1.1971830985915493,0.037714440802195465,652,You see desserts. I see wasted calories.
6245,7146,2,24,116,142,1.1971830985915493,0.03636604080945931,652,"Nah, man, I'm on a diet."
6358,7146,3,22,117,142,1.1971830985915493,0.037714440802195465,652,"They look good, but those desserts are all sour."
7487,7146,3,22,117,142,1.1971830985915493,0.037714440802195465,652,First dibs on the cheesecake
8106,7146,4,20,118,142,1.1971830985915493,0.03901626796464972,652,"I would, but I'm watching my blood glucose level"
6913,7155,5,17,115,137,1.197080291970803,0.04123394083275054,652,"You see, you don’t have to be bitter.  Life could be sweet after all."
7601,7155,8,11,118,137,1.197080291970803,0.044969595255751386,652,Day 1 of Whole 30: A pictorial.
3499,7155,3,21,113,137,1.197080291970803,0.03854287823563807,652,"If  it does not kill us getting there, eating there will..."
9708,7155,5,17,115,137,1.197080291970803,0.04123394083275054,652,"Now,I wish that I would have learned to swim!"
9843,7155,2,23,112,137,1.197080291970803,0.03712426774673741,652,"...Yeah, it could be a UFO trap...I mean, that sand seems a little too shiny."
8445,7155,4,19,114,137,1.197080291970803,0.03991109707390912,652,"On the plus side, we're both in full ketosis."
4812,7155,4,19,114,137,1.197080291970803,0.03991109707390912,652,"Oh, you go on ahead. That doesn’t appear to be gluten free."
1735,7155,5,17,115,137,1.197080291970803,0.04123394083275054,652,"In my hallucination, the desserts are bottles of beer."
3772,7155,1,25,111,137,1.197080291970803,0.03564925032557729,652,"Ha! When Pete Seeger sang that song about the big rock candy mountain, I thought it was a metaphor."
3416,7155,3,21,113,137,1.197080291970803,0.03854287823563807,652,Are candy canes gluten-free?
1645,7155,0,27,110,137,1.197080291970803,0.034110509257703814,652,"Okay, let's say if it is ""The Big Rock Candy Mountain', 
what's its functionality?"
1536,7155,5,17,115,137,1.197080291970803,0.04123394083275054,652,Why do you always insist on the gluten-free option?
486,7155,4,19,114,137,1.197080291970803,0.03991109707390912,652,The winners got Big Macs and Fries.
4085,7155,4,19,114,137,1.197080291970803,0.03991109707390912,652,Think we can beat the sharks to that mirage?
9972,7169,3,20,109,132,1.196969696969697,0.03942595542365462,652,How many votes do you think we need to get ourselves off Keto Island?
7783,7169,3,20,109,132,1.196969696969697,0.03942595542365462,652,I picked a hell of a week to go on a Keto diet.
7545,7169,5,16,111,132,1.196969696969697,0.04225786084358585,652,Last week the line was around the block.
6941,7169,6,14,112,132,1.196969696969697,0.043604899083472246,652,Wanna go island hopping?
6324,7169,2,22,108,132,1.196969696969697,0.03793079935967694,652,I can't believe this. I just started my diet.
4130,7169,4,18,110,132,1.196969696969697,0.04086644567456208,652,Sitting is the new smoking.
2014,7169,5,16,111,132,1.196969696969697,0.04225786084358585,652,This gluten free island sure is lame
2104,7169,6,14,112,132,1.196969696969697,0.043604899083472246,652,Just another mirage. Don't forget we're in the desert.
1545,7169,5,16,111,132,1.196969696969697,0.04225786084358585,652,"Yea, but there's no protein in the gummy fish."
1065,7169,3,20,109,132,1.196969696969697,0.03942595542365462,652,Think the Good Ship Lollipop crashed over there?
812,7169,2,22,108,132,1.196969696969697,0.03793079935967694,652,"It's a small comfort to realize there's no ice cream there, too."
3933,7169,5,16,111,132,1.196969696969697,0.04225786084358585,652,It’s a mirage. Besides I’m diabetic
6272,7181,3,19,105,127,1.1968503937007875,0.04036976028104919,652,"Maybe you were right, the grass is always greener on the other side"
4682,7181,4,17,106,127,1.1968503937007875,0.0418891623466292,652,My endocrinologist warned me about these hallucinations.
283,7181,5,15,107,127,1.1968503937007875,0.04335534914004428,652,Yea but their Governor wears blackface .
2331,7181,4,17,106,127,1.1968503937007875,0.0418891623466292,652,I wouldn’t tell if I lived
814,7185,6,12,104,122,1.1967213114754098,0.046031133268198215,652,Dave. Dave. You can swim. Quit your whining and go get some.
1027,7186,2,19,96,117,1.1965811965811965,0.04069705826019773,652,I'd swim over there myself but I just found out I'm pre diabetic.
6189,7187,3,28,142,173,1.1965317919075145,0.03346198186366337,652,The “what if” that kept Wonka up at night
6043,7188,3,16,93,112,1.1964285714285714,0.04364226155841041,652,Diabetes can take 10 years off your life.   Just sayin'
6478,7188,1,31,136,168,1.1964285714285714,0.03188200078431655,652,Do you think any of it's gluten free?
2829,7190,5,22,136,163,1.196319018404908,0.036778243926969906,652,Do you think there is any milk over there?
1397,7190,5,22,136,163,1.196319018404908,0.036778243926969906,652,I just couldn't swim to dessert island before entree island!
2514,7190,6,20,137,163,1.196319018404908,0.037793909408668336,652,The Good Sub Peppermint Stick just doesn't have the same ring to it.
8521,7190,5,22,136,163,1.196319018404908,0.036778243926969906,652,Hey look-it’s Candy Cthulhu !
9338,7190,5,22,136,163,1.196319018404908,0.036778243926969906,652,"Believe me, in time you'll be grateful to me for choosing this low carb dessert island."
5991,7195,3,25,130,158,1.1962025316455696,0.0353041183940058,652,Oh- I thought you said ‘desert’ island...
3763,7195,5,21,132,158,1.1962025316455696,0.03751842328436623,652,It's the Candy New Deal!
8791,7195,4,23,131,158,1.1962025316455696,0.03642809946540482,652,"I’d swim over there, but I’m allergic to chocolate syrup."
1030,7195,5,21,132,158,1.1962025316455696,0.03751842328436623,652,And here I just turned paleo.
3734,7195,4,23,131,158,1.1962025316455696,0.03642809946540482,652,I'm not sure; you know what they say about the dangers of sugar to one's health.
9443,7195,3,25,130,158,1.1962025316455696,0.0353041183940058,652,Too bad we just started the paleo diet.
8567,7201,4,22,127,153,1.196078431372549,0.03716245114557449,652,I keep waiting for the hot fudge sundae .
9568,7201,6,18,129,153,1.196078431372549,0.039408709686542885,652,"OK, so it's not a mirage. Now, how about that shark that's circling it?"
9892,7201,4,22,127,153,1.196078431372549,0.03716245114557449,652,"We did the right thing swimming here, because we’ll certainly survive longer on a zero-sugar diet."
4917,7201,4,22,127,153,1.196078431372549,0.03716245114557449,652,"So near..
So far"
3336,7201,5,20,128,153,1.196078431372549,0.038302050691219065,652,"I get what you're saying Barry, but how do you know they're gluten free?"
1708,7201,6,18,129,153,1.196078431372549,0.039408709686542885,652,Let's get the Good Ship Lollipop to ferry us across!
1348,7201,5,20,128,153,1.196078431372549,0.038302050691219065,652,Still on that low carb diet?
4543,7201,6,18,129,153,1.196078431372549,0.039408709686542885,652,"Ahoy, Good Ship Lollipop!"
8986,7209,2,25,121,148,1.195945945945946,0.03543492255288161,652,"Yes, I do see that, Mr. Lemonhead."
8724,7209,5,19,124,148,1.195945945945946,0.039133358230548296,652,Just because we're gluten intolerant doesn't mean they need to rub it in our faces.
7265,7209,5,19,124,148,1.195945945945946,0.039133358230548296,652,Maybe we can get a lift from The Good Ship Lollipop . . .
6471,7209,3,23,122,148,1.195945945945946,0.03670915961563207,652,We have to wait a whole week for that thing to come back?
6048,7209,7,15,126,148,1.195945945945946,0.041415903384024975,652,I think a desserted island would be better than Palm Beach.
3995,7209,2,25,121,148,1.195945945945946,0.03543492255288161,652,I see the ocean temps have finally risen past firm-ball stage.
3955,7209,4,21,123,148,1.195945945945946,0.037940625496203764,652,This view is killing my diet.
761,7209,3,23,122,148,1.195945945945946,0.03670915961563207,652,"I'm not unless you'll have some, too."
760,7209,8,13,127,148,1.195945945945946,0.04251124223628529,652,Yeah but its all gluten-free
303,7209,6,17,125,148,1.195945945945946,0.04029079782974838,652,"If it wasn't bad enough, I am diabetic."
4408,7209,3,23,122,148,1.195945945945946,0.03670915961563207,652,Temptation island has never seemed so close since the wall has been down...
7946,7220,4,20,119,143,1.1958041958041958,0.03876699705860279,652,"I hear you, but good luck sticking to a keto diet over there, amirite?"
9257,7220,2,24,117,143,1.1958041958041958,0.03613715468133382,652,Looks like starvation or Diabetes.
4878,7220,4,20,119,143,1.1958041958041958,0.03876699705860279,652,Not another word-about the good ship Lollipop!
3012,7220,2,24,117,143,1.1958041958041958,0.03613715468133382,652,There's  no grass over there.
2645,7220,3,22,118,143,1.1958041958041958,0.03747515183027524,652,"That’s not what they call the Spice Islands, is it?"
2601,7220,6,16,121,143,1.1958041958041958,0.04122943333858455,652,I'm just glad we decided to visit this side of the island.
1686,7220,3,22,118,143,1.1958041958041958,0.03747515183027524,652,Mirage? Oasis? 2020?
1402,7227,4,19,115,138,1.1956521739130435,0.03964656033431293,652,We don't even get a beer?!
3753,7227,1,25,112,138,1.1956521739130435,0.03541878284118934,652,Sweets aren't what I crave right now!
4645,7227,3,21,114,138,1.1956521739130435,0.038289205052407654,652,I’d swim over but I’m doing Keto.
4959,7227,2,23,113,138,1.1956521739130435,0.036881929189622444,652,My dilemma is the choice between starvation and diabetic shock!
7274,7227,3,21,114,138,1.1956521739130435,0.038289205052407654,652,"Dude, if I thought that stuff was gluten free, I'd already be there."
5685,7232,2,31,146,179,1.1955307262569832,0.03176854762690517,652,"It’s tempting, but I’m only on day 10 of Whole 30"
9000,7233,4,18,111,133,1.1954887218045114,0.04058504514387409,652,"If it's any consolation, they're all vegan."
7418,7233,2,22,109,133,1.1954887218045114,0.03767364538009041,652,"They promised we'd land on a chocolate bar, 
but I guess that was just promotional hype."
4933,7233,2,22,109,133,1.1954887218045114,0.03767364538009041,652,"Face it, you can't live on empty carbs alone!"
369,7233,4,18,111,133,1.1954887218045114,0.04058504514387409,652,Quote me the benefits of the Atkins Diet one more time. I dare you.
473,7233,2,22,109,133,1.1954887218045114,0.03767364538009041,652,Candyland's 10 year challenge.
2912,7233,1,24,108,133,1.1954887218045114,0.03613007597102533,652,Your Paleo vacation was ok. But mine would have been sweet.
3281,7239,3,19,106,128,1.1953125,0.0400826436945137,652,We’ve gotta get t-shirts that say: I SURVIVED THE SHIPWRECK OF THE GOOD SHIP LOLLIPOP!”
9970,7239,2,21,105,128,1.1953125,0.03851735750902892,652,We are the lost losers.
6688,7239,3,19,106,128,1.1953125,0.0400826436945137,652,Treasure Island it's not.
2616,7239,2,21,105,128,1.1953125,0.03851735750902892,652,I'm happy to pitch in on next year's vacation.
4284,7239,3,19,106,128,1.1953125,0.0400826436945137,652,Wow! The president's latest bait and switch trick is below the belt.
966,7239,6,13,109,128,1.1953125,0.04444899114412289,652,all of a sudden i have a sweet tooth
1766,7239,5,15,108,128,1.1953125,0.043042784734114534,652,"It seems that the Maldives are actually not sinking into the Indian Ocean as predicted by climate alarmists, but are actually growing in size with more sugar content."
288,7239,3,19,106,128,1.1953125,0.0400826436945137,652,"Lousy time to go Keto, Kirk."
179,7239,2,21,105,128,1.1953125,0.03851735750902892,652,"Diabetes, schmiabetes."
141,7248,4,25,140,169,1.1952662721893492,0.0348871167073119,652,Order us a dozen donuts and two mars bars!
9357,7249,4,16,103,123,1.1951219512195121,0.042666263573966356,652,I was taught no sweets until after dinner...so we wait.
5686,7249,1,30,133,164,1.1951219512195121,0.032222814891435886,652,"Dude, gluten free?"
7745,7249,5,22,137,164,1.1951219512195121,0.03657289427809463,652,You go. I'm doing Keto.
460,7249,5,14,104,123,1.1951219512195121,0.044200566384244126,652,I'm finding it difficult to stick with the Whole-30 diet.
3220,7249,4,16,103,123,1.1951219512195121,0.042666263573966356,652,What do you suppose their property tax is?
4144,7254,5,21,133,159,1.1949685534591195,0.03730212760604782,652,I'm sticking with Sandyland.
5395,7254,5,21,133,159,1.1949685534591195,0.03730212760604782,652,"Hmm, good idea Tony. You go first."
8468,7254,7,17,135,159,1.1949685534591195,0.039378569244423935,652,What people don't realize is sometimes the sweets cut YOU out.
5037,7257,2,19,97,118,1.194915254237288,0.04038506991066491,652,"Since Fantasy Island has been closed down, Candyland is the only game in town."
5079,7258,5,20,129,154,1.1948051948051948,0.03807381854944091,652,"No, you enjoy it. I’m on a sugar free diet."
9664,7258,3,24,127,154,1.1948051948051948,0.03577500221227837,652,"No, I actually think it's really there. It's just all carbs and sugar and I'm not going."
4494,7258,7,16,131,154,1.1948051948051948,0.04024152748819283,652,It's Big Pharma trying to drum up business for their new  diabetes pill
7553,7258,2,26,126,154,1.1948051948051948,0.03456831418314911,652,You can’t get past the sprinkles on the donut?
1252,7258,4,22,128,154,1.1948051948051948,0.03694229582892943,652,No way. I’m on Keto.
677,7258,3,24,127,154,1.1948051948051948,0.03577500221227837,652,We both lost a lot of weight since coming to this island.
562,7258,5,20,129,154,1.1948051948051948,0.03807381854944091,652,I believe it was first discovered by a dentist.
3279,7258,5,20,129,154,1.1948051948051948,0.03807381854944091,652,Sometimes I regret being on a keto diet
8955,7266,4,21,124,149,1.1946308724832215,0.03770806881243978,652,"I'm here for Oompa Loompa harassment too!"""
8418,7266,6,17,126,149,1.1946308724832215,0.04004107761659397,652,So... how are we going to pay to finish building the wall?
6882,7266,1,27,121,149,1.1946308724832215,0.03390891164372692,652,That's Princess Frostine's island here in Snow Flake Lake. That means we're very close to the Chocolate Swamp and Candy Castle.
6600,7266,6,17,126,149,1.1946308724832215,0.04004107761659397,652,"Even if I could swim, I'm not doing sugar right now."
5547,7266,7,15,127,149,1.1946308724832215,0.04115802009651713,652,I told you: there ARE some great things about global warming
4433,7266,4,21,124,149,1.1946308724832215,0.03770806881243978,652,"Yeah, but a lot of empty calories"
5428,7266,3,23,123,149,1.1946308724832215,0.036485664746534203,652,"Weird! When we were living on _that_ island, we thought the goodies were over _here_."
2236,7266,3,23,123,149,1.1946308724832215,0.036485664746534203,652,"Swim? Good idea, but I think I'll stick with the organics."
1126,7266,2,25,122,149,1.1946308724832215,0.0352208604441925,652,Too bad I'm on a gluten- dairy- sugar-free diet.
978,7266,2,25,122,149,1.1946308724832215,0.0352208604441925,652,I'll give up on my diet if you give up on yours.
968,7266,4,21,124,149,1.1946308724832215,0.03770806881243978,652,Aren't you glad we're on a carb-free diet?
747,7266,6,17,126,149,1.1946308724832215,0.04004107761659397,652,I hope it doesn’t contain any GMO
3704,7266,6,17,126,149,1.1946308724832215,0.04004107761659397,652,It's not for us
4261,7279,1,26,117,144,1.1944444444444444,0.03453230891711449,652,"When the ship comes, we’ll get more flour to make more pastries to catch more birds so we don’t starve before the next ship comes."
7411,7279,5,18,121,144,1.1944444444444444,0.03976154860725892,652,I told you we needed to take currents into account when following those !@#$% breadcrumbs!
7021,7279,1,26,117,144,1.1944444444444444,0.03453230891711449,652,"The crumbs might not have been such a great idea this time, Hansel."
6961,7279,3,22,119,144,1.1944444444444444,0.03723883125713291,652,I picked the wrong week to start my swim-free diet.
8151,7279,4,20,120,144,1.1944444444444444,0.03852084696008535,652,Remember when Johnson swam across there last year? Was that a one-finger or two-finger salute he gave us
5010,7279,7,14,123,144,1.1944444444444444,0.04213348955282019,652,Gillian and Maryanne never made it back
3645,7279,3,22,119,144,1.1944444444444444,0.03723883125713291,652,I wonder how long until we evolve into a dessert.
2431,7279,2,24,118,144,1.1944444444444444,0.03591107706922924,652,"""I know it's tempting but we'd never get past the rocking horse people."
2998,7279,5,18,121,144,1.1944444444444444,0.03976154860725892,652,I booked through Vacalocitz.com. It certainly has ocean-views and some shade. Next time I go for the five star island over there.
608,7279,6,16,122,144,1.1944444444444444,0.040964690219413485,652,I've given up sugar for lent.
1693,7279,3,22,119,144,1.1944444444444444,0.03723883125713291,652,Where's the lollipop?
3191,7279,7,14,123,144,1.1944444444444444,0.04213348955282019,652,"That, on the other hand, is a deSSerted island."
2507,7279,2,24,118,144,1.1944444444444444,0.03591107706922924,652,What is a shark's lifespan again?
2803,7279,4,20,120,144,1.1944444444444444,0.03852084696008535,652,Of all the islands in the world you had to choose THIS one!
2279,7279,5,18,121,144,1.1944444444444444,0.03976154860725892,652,We chose the wrong day to start our low-carb diet.
8998,7294,6,22,147,175,1.1942857142857144,0.03596855300212748,652,REAL OR ILLUSION ! SAME DIFFERENCE.
8923,7295,4,19,116,139,1.1942446043165467,0.03938545994905301,652,"Take a ride on the Wonkatania, he said. It’ll be fun, he said!"
8341,7295,5,17,117,139,1.1942446043165467,0.04068757635880725,652,"Yeah, but coconuts are better than sharks."
8044,7295,5,17,117,139,1.1942446043165467,0.04068757635880725,652,Maybe it's not a mirage.
7928,7295,2,23,114,139,1.1942446043165467,0.03664267493357757,652,"Remember, no refined sugar."
7465,7295,4,19,116,139,1.1942446043165467,0.03938545994905301,652,I wonder if those are gluten free?
8517,7295,4,19,116,139,1.1942446043165467,0.03938545994905301,652,I've been thinking about going keto anyway.
3775,7295,7,13,119,139,1.1942446043165467,0.04317415545282149,652,"Coulda, shoulda,woulda."
1996,7295,4,19,116,139,1.1942446043165467,0.03938545994905301,652,I think he mixes it with love
1146,7295,4,19,116,139,1.1942446043165467,0.03938545994905301,652,"If it's any consolation, this is one of the more challenging Vipassana retreats we offer."
7200,7295,4,19,116,139,1.1942446043165467,0.03938545994905301,652,Are you sure you want to go Keto?
854,7295,2,23,114,139,1.1942446043165467,0.03664267493357757,652,"Yeah, I'm not a sweets guy either."
2375,7306,6,21,143,170,1.1941176470588235,0.03665158371040724,652,So do you think they're non gluten?
915,7307,4,18,112,134,1.1940298507462686,0.040307442576898195,652,Don’t say I didn’t warn you that you were giving Party World Caterers the wrong address!
1160,7307,4,18,112,134,1.1940298507462686,0.040307442576898195,652,"Stu, how lucky can we get....landing over there would have killed our Atkins diet.  We’re a shoe in to win the office pool now!"
2928,7307,2,22,110,134,1.1940298507462686,0.03741989077779156,652,"I know you said the island had ""sweet views"", but this still isn't what I eat expecting!"
2950,7307,4,18,112,134,1.1940298507462686,0.040307442576898195,652,Its further then it looks
7315,7307,2,22,110,134,1.1940298507462686,0.03741989077779156,652,I'm really going to miss having such a sweet view.
7813,7307,2,22,110,134,1.1940298507462686,0.03741989077779156,652,I told you Minimalism was better in theory.
8697,7307,4,18,112,134,1.1940298507462686,0.040307442576898195,652,Our darn luck to be stranded on the “one s” island.
9158,7307,4,18,112,134,1.1940298507462686,0.040307442576898195,652,It’s probably all sugar-free anyway.
9380,7307,5,16,113,134,1.1940298507462686,0.04167626156127722,652,"It's the site of the new series, Diabetic Survivor."
10014,7307,2,22,110,134,1.1940298507462686,0.03741989077779156,652,"Thanks, but my cheat day's not until tomorrow."
4229,7307,3,20,111,134,1.1940298507462686,0.03889047539508739,652,Don't bother. Nothing there is gluten free.
5009,7318,5,22,138,165,1.1939393939393939,0.03636979499461686,652,It was my party and I’ll cry if I want to.
7559,7319,5,15,109,129,1.193798449612403,0.0427346454868216,652,I had thought about giving up sweets for lent.
8958,7319,7,11,111,129,1.193798449612403,0.0454807430337261,652,"Sweets huh?  That's ironic, because I'm hallucinating about a giant stripper named Candy!"
10004,7319,3,19,107,129,1.193798449612403,0.039799520887428,652,When you are on a diet and your friend eats a giant chocolate piece of cake in front of you.
7150,7319,2,21,106,129,1.193798449612403,0.03824758596122199,652,I don't suppose they're gluten-free.
5717,7319,7,11,111,129,1.193798449612403,0.0454807430337261,652,Don't you hate Sheila--always taking half a donut!
4870,7319,4,17,108,129,1.193798449612403,0.041293170063299446,652,Looks like a sugar crash waiting to happen.
2467,7319,2,21,106,129,1.193798449612403,0.03824758596122199,652,"Yeah, and when I was stranded in the desert I saw the big rock candy mountain."
3484,7319,2,21,106,129,1.193798449612403,0.03824758596122199,652,That was my 1990 dream?
6199,7319,5,15,109,129,1.193798449612403,0.0427346454868216,652,We'll never be alone as long as the other one's desserted.
2552,7328,3,25,132,160,1.19375,0.03490426597163831,652,Subtlety was never Jim's strong suit
4824,7328,5,21,134,160,1.19375,0.037088279650334066,652,"All things considered, I prefer Weight Watchers."
9349,7330,5,14,105,124,1.1935483870967742,0.043870890606371456,652,Before we sailed we lived on the Big Rock Candy Mountain
8713,7330,3,18,103,124,1.1935483870967742,0.04077247055886129,652,"Nah, sugar's not good for you."
7313,7330,2,26,127,155,1.1935483870967742,0.03436755686236305,652,It doesn't get as sweet as this.
7262,7330,5,14,105,124,1.1935483870967742,0.043870890606371456,652,You also made the same wish twice didn't you?
6254,7330,2,26,127,155,1.1935483870967742,0.03436755686236305,652,"Actually, it's all corn.  You know that, right?"
4290,7330,2,20,102,124,1.1935483870967742,0.0391313686434772,652,I wonder if there are any whoppers over there.
8967,7330,3,24,128,155,1.1935483870967742,0.03556565963466911,652,I read it can be a side effect of Paleo
3230,7330,2,26,127,155,1.1935483870967742,0.03436755686236305,652,I can swim but I swore off sugar.
1957,7330,3,24,128,155,1.1935483870967742,0.03556565963466911,652,I picked the wrong day to start my diet
1379,7330,1,28,126,155,1.1935483870967742,0.03312614955177229,652,"Go ahead, swim over if you want to, but I've sworn off  sugar."
1234,7330,3,18,103,124,1.1935483870967742,0.04077247055886129,652,I heard of greener on the “other side”  but sweeter? Damm
921,7330,5,20,130,155,1.1935483870967742,0.03784825631877749,652,I wish I could remember if candy canes are part of the Atkins diet.
711,7330,1,22,101,124,1.1935483870967742,0.03741836004356966,652,I can't wait to get off this low carb diet.
3544,7330,3,18,103,124,1.1935483870967742,0.04077247055886129,652,"I know it’s a chimera, but a little swim wouldn’t hurt."
743,7344,3,29,149,181,1.1933701657458564,0.032414615703413335,652,Tempting but I'm on a diet
9694,7345,5,19,126,150,1.1933333333333334,0.038653704531062046,652,I’m on a low sugar diet.
9609,7345,7,15,128,150,1.1933333333333334,0.04090329804796426,652,"No, I said I wanted a massage."
9460,7345,4,21,125,150,1.1933333333333334,0.037478305929719805,652,It’s hard to believe Santa’s workshop is underwater and that the reindeer went down with the sleigh. Maybe now they’ll admit global warming is real.
8231,7345,3,23,124,150,1.1933333333333334,0.03626483085233813,652,"If you sing ""Hard Candy Christmas"" one more time....."
6448,7345,6,17,127,150,1.1933333333333334,0.039794400769299465,652,Are there cigarette trees on big rock candy island?
3414,7345,6,17,127,150,1.1933333333333334,0.039794400769299465,652,I only wish i wasn't on that Keto diet
2265,7345,3,23,124,150,1.1933333333333334,0.03626483085233813,652,"Candyland?"" My hallucination is ""Mystery Date""."
1720,7345,3,23,124,150,1.1933333333333334,0.03626483085233813,652,No thanks. I don’t see any choclate
1518,7345,1,27,122,150,1.1933333333333334,0.03370707699464231,652,You do remember we just swore off sugar and carbs.
1456,7345,2,25,123,150,1.1933333333333334,0.03500932016100456,652,"Nah, too many carbs."
4082,7345,5,19,126,150,1.1933333333333334,0.038653704531062046,652,"Please stop saying, ""Sweet are the uses of adversity."""
9545,7356,4,20,121,145,1.193103448275862,0.038277760472061405,652,"Look at the upside: If we make it over there, we'll have the world's greatest excuse for not flossing."
8204,7356,5,18,122,145,1.193103448275862,0.03950914308574072,652,You’ll feel better about our choice after your yearly physical
8109,7356,5,18,122,145,1.193103448275862,0.03950914308574072,652,What a time to be a diabetic!
6781,7356,5,18,122,145,1.193103448275862,0.03950914308574072,652,Guess our only option is the sweet hereafter.
8083,7356,3,22,120,145,1.193103448275862,0.0370054253609316,652,No thank you. Nothing but tooth decay and diabetes over there.
5220,7356,6,16,123,145,1.193103448275862,0.04070329013707074,652,"Hey Joe, you seeing what I'm seeing?"". ""Yeah, Frank. Those humans over there look delicious!"" - The Candy Cane"
952,7356,5,18,122,145,1.193103448275862,0.03950914308574072,652,"Feel free to swim over, just know that quitting Whole30 is quitting on yourself."
1377,7356,5,18,122,145,1.193103448275862,0.03950914308574072,652,But for an additional “s”....
5224,7356,4,20,121,145,1.193103448275862,0.038277760472061405,652,I wonder if there’s big girls on sugar and spice island.
1989,7356,6,16,123,145,1.193103448275862,0.04070329013707074,652,"Sweetland! That's
 where Trump and Kim Jong-un will meet again soon"""
1584,7356,5,18,122,145,1.193103448275862,0.03950914308574072,652,Low tide but High Fructose would kill you!
3993,7367,8,17,146,171,1.1929824561403508,0.03829509868994731,652,I think it's part of The Green New Deal
7846,7367,5,23,143,171,1.1929824561403508,0.03549811593394211,652,"Yeah, it looks good, but is it gluten-free?"
1534,7367,6,21,144,171,1.1929824561403508,0.03645429583003898,652,"Grass is greener mirage, Dear . . .they'd all be overweight and obviously can't swim . .."
498,7370,4,19,117,140,1.1928571428571428,0.03912773055256461,652,"No thanks.  I'm out of toothpaste, and I haven't been able to get to the store."
778,7370,4,19,117,140,1.1928571428571428,0.03912773055256461,652,No problem. I gave up sweets for lent.
1115,7370,3,21,116,140,1.1928571428571428,0.037791591330285236,652,If only the water was insulin”
1202,7370,1,25,114,140,1.1928571428571428,0.03496647722373065,652,You're hallucinating!!!
2464,7370,3,21,116,140,1.1928571428571428,0.037791591330285236,652,"Eww, are those coconut flavored?"
2564,7370,5,17,118,140,1.1928571428571428,0.040419725643711456,652,Not worth the calories.
4460,7370,7,13,120,140,1.1928571428571428,0.04288710840043335,652,At least they're no sharks.
4526,7370,4,19,117,140,1.1928571428571428,0.03912773055256461,652,Guess the grass is greener.
5838,7370,5,17,118,140,1.1928571428571428,0.040419725643711456,652,I would go for it except my cholesterol and blood sugar levels were slightly high when I had my last check-up.
8232,7370,8,11,121,140,1.1928571428571428,0.044069025288396485,652,Wait. Is sugar a gluten?
8792,7370,4,19,117,140,1.1928571428571428,0.03912773055256461,652,"There is no way to sugarcoat this pal, they are sugar free !"
9043,7370,6,15,119,140,1.1928571428571428,0.041671682759779616,652,"You know that's not good for, right?"
9120,7370,7,13,120,140,1.1928571428571428,0.04288710840043335,652,It wasn't MY idea to eat the canoe-li.
6248,7383,2,28,136,166,1.1927710843373494,0.03300199984049825,652,There's no one I'd rather share it with than you.
2036,7383,1,30,135,166,1.1927710843373494,0.03187652182005531,652,It's too bad I'm gluten-free
7259,7385,2,22,111,135,1.1925925925925926,0.03716947024994888,652,Do you think that mirage is gluten-free?
7170,7385,2,22,111,135,1.1925925925925926,0.03716947024994888,652,My study of island ecology tells me they have evolved into carnivorous confections.
6065,7385,3,20,112,135,1.1925925925925926,0.0386280705986641,652,Should we swim?
5523,7385,3,20,112,135,1.1925925925925926,0.0386280705986641,652,I think I might go off the Paleo thing for a bit.
8565,7385,2,22,111,135,1.1925925925925926,0.03716947024994888,652,"What luck, I really hope its gluten free!"
2640,7385,2,22,111,135,1.1925925925925926,0.03716947024994888,652,Don't be fooled by the doorbuster specials.
2414,7385,6,14,115,135,1.1925925925925926,0.042706004223247204,652,"No thanks, I'm on Weight Watchers"
1559,7385,1,24,110,135,1.1925925925925926,0.035651244005620496,652,And you thought Candyland was a game
3357,7385,4,18,113,135,1.1925925925925926,0.04003356289026648,652,Good thing I lost my sweet tooth to scurvy
713,7385,3,20,112,135,1.1925925925925926,0.0386280705986641,652,"Looks sweet, but think of all the excess carbs."
1894,7395,3,25,133,161,1.1925465838509317,0.0347076610458348,652,"It might be real, but I’m cutting carbs and sugar this month anyway."
6673,7395,2,27,132,161,1.1925465838509317,0.03357055232967971,652,Candy island has really gone downhill since those cupcakes moved in.
7093,7395,3,25,133,161,1.1925465838509317,0.0347076610458348,652,"So much for our J.Lo no-sugar, no-carbs challenge…"
7220,7395,4,23,134,161,1.1925465838509317,0.0358086789315852,652,Looks like I picked a bad time to start a paleo diet.
7422,7399,8,14,134,156,1.1923076923076923,0.04078974779090584,652,I think we've been on this island for too long...
9271,7399,1,28,127,156,1.1923076923076923,0.03293649379144905,652,"We could go for it, but I’m afraid my diet would go to hell."
8655,7399,2,26,128,156,1.1923076923076923,0.034169073871162414,652,"Well, at least our dessert island is low-sugar."
7502,7399,4,22,130,156,1.1923076923076923,0.03650960943492191,652,It doesn’t have much nutritional value
7064,7399,4,17,109,130,1.1923076923076923,0.0410014090630856,652,"I still can't believe we're both diabetics."""
2486,7399,5,20,131,156,1.1923076923076923,0.037625318165157504,652,I wonder how much it costs to get in.
1484,7399,5,15,110,130,1.1923076923076923,0.04243083936873441,652,The absence of sugar in my life makes me a better person.
427,7399,5,20,131,156,1.1923076923076923,0.037625318165157504,652,Refined sugar -it’ll kill you!
2590,7399,5,15,110,130,1.1923076923076923,0.04243083936873441,652,At least we won't miss dentists.
9520,7408,3,23,125,151,1.1920529801324504,0.0360466117032233,652,We picked a bad time to go on a sugar-free diet.
7476,7408,5,19,127,151,1.1920529801324504,0.03841820736036572,652,The sweet life is overrated.
5655,7408,4,21,126,151,1.1920529801324504,0.03725128770973571,652,"Tempting, but I actually gave up sweets for Lent."
7878,7408,2,25,124,151,1.1920529801324504,0.03480025854117183,652,I never thought I’d be jealous of Hansel and Gretel.
2435,7408,4,21,126,151,1.1920529801324504,0.03725128770973571,652,"Well, I'm trying to cut out sugar."
801,7408,3,23,125,151,1.1920529801324504,0.0360466117032233,652,"Nah man, too many calories over there"
422,7408,4,21,126,151,1.1920529801324504,0.03725128770973571,652,Saved by ocean garbage -- who knew?
337,7408,5,19,127,151,1.1920529801324504,0.03841820736036572,652,I'm fine either way.
3953,7408,5,19,127,151,1.1920529801324504,0.03841820736036572,652,How lucky can you get?
4886,7417,6,12,107,125,1.192,0.045003225690839595,652,"There's just no escaping  Death, Taxes, and.......Halloween."
8753,7417,5,14,106,125,1.192,0.043546045337276365,652,It's so hard to be a misfit on a gluten-free diet.
7576,7419,4,20,122,146,1.1917808219178083,0.03803768175341878,652,I feel like we’re on an Island.
9341,7419,4,20,122,146,1.1917808219178083,0.03803768175341878,652,This South Beach Diet is killing me.
9061,7419,5,18,123,146,1.1917808219178083,0.03925988467206608,652,You go ahead.  I’m gluten and lactose intolerant.
9057,7419,4,20,122,146,1.1917808219178083,0.03803768175341878,652,"You know, if it wasn't for my diet....."
7675,7419,4,20,122,146,1.1917808219178083,0.03803768175341878,652,Who said the Good Ship Lollipop couldn’t sink?
7431,7419,4,20,122,146,1.1917808219178083,0.03803768175341878,652,"All that sugar will kill you, you know"
3826,7419,3,22,121,146,1.1917808219178083,0.0367748816705752,652,Jimmy  Buffet would NEVER approve.
6729,7419,4,20,122,146,1.1917808219178083,0.03803768175341878,652,Ill trade it all for one Wilson.
5732,7419,5,18,123,146,1.1917808219178083,0.03925988467206608,652,"I'm lucky to have landed here, I'm diabetic."
3231,7419,3,22,121,146,1.1917808219178083,0.0367748816705752,652,"It's not worth the swim,they're all sugar free."
3188,7419,5,18,123,146,1.1917808219178083,0.03925988467206608,652,Forget about it!  It’s not worth the calories.
2195,7419,3,22,121,146,1.1917808219178083,0.0367748816705752,652,"Well, there goes the diet."
6794,7419,3,22,121,146,1.1917808219178083,0.0367748816705752,652,Think any of that stuff is gluten free?
6438,7432,2,19,99,120,1.1916666666666667,0.03977498568775671,652,"Nah, ours is cuter."
7428,7432,4,15,101,120,1.1916666666666667,0.04315276968259602,652,This is much more effective than the keto diet.
9612,7432,4,15,101,120,1.1916666666666667,0.04315276968259602,652,Of all times to be on weight watchers.
9383,7435,5,17,119,141,1.1914893617021276,0.0401553387193002,652,The cake is always sweeter on the other side.
9328,7435,2,23,116,141,1.1914893617021276,0.03617319255858647,652,Any room for dessert?”
9177,7435,5,17,119,141,1.1914893617021276,0.0401553387193002,652,Too bad I'm on a no added sugar diet.
8633,7435,2,23,116,141,1.1914893617021276,0.03617319255858647,652,"Say what you must about climate change, but it's done wonders for my diet."
8629,7435,2,23,116,141,1.1914893617021276,0.03617319255858647,652,"Cover your eyes and ears, Fletcher.  You know we've committed to socially responsible levels of palm oil consumption."
8339,7435,3,21,117,141,1.1914893617021276,0.03754752964542799,652,No...I'm on keto.
7403,7435,4,19,118,141,1.1914893617021276,0.038873308388507555,652,Do you think we should reconsider this Keto Diet thing?
7395,7435,4,19,118,141,1.1914893617021276,0.038873308388507555,652,I wonder if there's a palm tree on the other side of that island.
1758,7435,3,21,117,141,1.1914893617021276,0.03754752964542799,652,But where's the baby?
929,7435,3,21,117,141,1.1914893617021276,0.03754752964542799,652,The people of the Sandwich Islands longed for the Desert Islands
62,7435,4,19,118,141,1.1914893617021276,0.038873308388507555,652,"Look, it’s the gluten-free isle!"
7644,7435,2,23,116,141,1.1914893617021276,0.03617319255858647,652,I've been wanting to try intermittent fasting anyway.
314,7447,4,23,135,162,1.191358024691358,0.03560679388789338,652,At least we'll never have to go on a diet.
1392,7447,5,21,136,162,1.191358024691358,0.03666776523155518,652,what could've been
5229,7447,5,21,136,162,1.191358024691358,0.03666776523155518,652,Big sugar wants you to swim over
6261,7447,2,27,133,162,1.191358024691358,0.033383847872464754,652,Too bad you are a diabetic.
9116,7451,4,18,114,136,1.1911764705882353,0.03976333292288872,652,And you say that giants don't live here.
8817,7451,5,16,115,136,1.1911764705882353,0.04111027982159845,652,I've been doing KETO for a month.  How bout you?
8332,7451,2,22,112,136,1.1911764705882353,0.03692232009759421,652,"Stop pestering me, Brandon. No dessert before dinner."
8130,7451,3,20,113,136,1.1911764705882353,0.03836913060342712,652,"Yes, but you know everything over there has coconut icing."
5005,7451,2,22,112,136,1.1911764705882353,0.03692232009759421,652,That’s Hansel’s Island.
2919,7451,3,20,113,136,1.1911764705882353,0.03836913060342712,652,Race you to Candy Land?
764,7451,4,18,114,136,1.1911764705882353,0.03976333292288872,652,"Ever watch that show, Shark Tank?"
2758,7458,2,26,129,157,1.1910828025477707,0.03397282776631841,652,"Well, we didn’t make it to Cuba, but that island over there doesn’t look
Too bad!"
4609,7458,3,24,130,157,1.1910828025477707,0.03515412271367389,652,"But I thought that once my kids were grown, I wouldn’t ever have to play Candyland again."
4898,7458,6,18,133,157,1.1910828025477707,0.0384810381324668,652,Too heavy on carbs. I say we wait for the next one.
6790,7458,6,18,133,157,1.1910828025477707,0.0384810381324668,652,It’s moments like this that really test your resolve to live gluten-free
7923,7458,4,22,131,157,1.1910828025477707,0.03629699245249046,652,"Sure they're calories, but they're just empty calories."
9132,7458,0,30,127,157,1.1910828025477707,0.031477522008311276,652,I would have been over there a long time ago but there's no dentist on this island.
9744,7458,5,20,132,157,1.1910828025477707,0.0374049592758,652,If you survive the sharks and the currents would you ask them if they have any gluten free options?
8995,7465,3,19,109,131,1.1908396946564885,0.03924493424609721,652,"Not working for me 
I’m gluten free"
8488,7465,5,15,111,131,1.1908396946564885,0.04213127684005191,652,It's probably a mirage.
7389,7465,4,17,110,131,1.1908396946564885,0.04071369150638141,652,Maybe I'll start the low carb diet next monday
8129,7465,5,15,111,131,1.1908396946564885,0.04213127684005191,652,"Look at it this way, at least we won't get diabetes!"
4641,7465,4,17,110,131,1.1908396946564885,0.04071369150638141,652,"It's like a dessert cart, only we have to swim there."
819,7470,5,19,128,152,1.1907894736842106,0.03818552862914048,652,"No way, I'm on a diet."
1050,7470,3,23,126,152,1.1907894736842106,0.03583096210270602,652,How about a game of Candyland?
2228,7470,6,17,129,152,1.1907894736842106,0.03930996021910456,652,"Don't bother, that's the trash vortex."
3467,7470,3,23,126,152,1.1907894736842106,0.03583096210270602,652,This is all Adam and Eve's fault
3675,7470,3,23,126,152,1.1907894736842106,0.03583096210270602,652,Don't bother - it's not gluten free
6345,7470,4,21,127,152,1.1907894736842106,0.037026966132080424,652,Trust me. That will never match your hard-core fantasy.
8601,7470,4,21,127,152,1.1907894736842106,0.037026966132080424,652,"Let's go over, it might be real."
2071,7477,5,23,145,173,1.1907514450867052,0.03512178144586343,652,Those are all bad for you anyway!
5548,7477,6,21,146,173,1.1907514450867052,0.03606595163109779,652,I don't know.  I'm not really much of a risk-taker.
5349,7479,5,18,124,147,1.1904761904761905,0.039013715732043514,652,Are you kidding? I don't want diabetes.
5565,7479,2,24,121,147,1.1904761904761905,0.03524920048560024,652,Thank goodness I’m gluten free.
5712,7479,3,22,122,147,1.1904761904761905,0.036547148931067024,652,"This is your mirage, go for it, a month ago I swam to cruise ship passing by."
6226,7479,5,18,124,147,1.1904761904761905,0.039013715732043514,652,"If she calls that one Candy, what does she call this one?"
6836,7479,4,16,106,126,1.1904761904761905,0.04173124247658407,652,"I could use this to feel bad about my life, but I've never really liked the taste of salty with sweet."
9812,7479,4,20,123,147,1.1904761904761905,0.03780055628036639,652,"Sure, I could make the swim, but I've been trying to cut back on high-fructose corn syrup."
7632,7479,3,22,122,147,1.1904761904761905,0.036547148931067024,652,It's your move!
8026,7479,3,22,122,147,1.1904761904761905,0.036547148931067024,652,I picked a fine time to go Keto.
9086,7479,2,24,121,147,1.1904761904761905,0.03524920048560024,652,"It's a mad, mad, mad, mad world."
7189,7479,3,18,105,126,1.1904761904761905,0.040180996399483776,652,Do you think Mr. Wonka's going to send anyone to save us? Or do you think this was his plan all along?
5168,7479,1,26,120,147,1.1904761904761905,0.03390159546036864,652,Being marooned is no excuse to punt your diet.
1414,7479,3,18,105,126,1.1904761904761905,0.040180996399483776,652,the land is sweeter on the other island
4452,7479,2,20,104,126,1.1904761904761905,0.03856848901203158,652,I believe that our tree is healthier than that mirage
5052,7479,4,20,123,147,1.1904761904761905,0.03780055628036639,652,"I guess we'll have to buy ""Chutes and Ladders"" in order to play ""Candyland."""
1025,7479,3,18,105,126,1.1904761904761905,0.040180996399483776,652,'HELP' is so cliche. Let's write #CandyLandHo in the sand.
2438,7479,3,22,122,147,1.1904761904761905,0.036547148931067024,652,We could be stranded on a De-ss-ert Island.
3201,7479,4,16,106,126,1.1904761904761905,0.04173124247658407,652,It's the most effective diet for people who can't swim.
956,7479,3,18,105,126,1.1904761904761905,0.040180996399483776,652,What an amazing existential sense of being someone else’s mirage. Resist grabbing their candy.
3427,7479,4,20,123,147,1.1904761904761905,0.03780055628036639,652,Don't bother. There's no milk to wash it down.
3768,7479,5,18,124,147,1.1904761904761905,0.039013715732043514,652,"Maybe our Fyre Festival package sent us to the wrong island by mistake."""
4108,7479,5,22,141,168,1.1904761904761905,0.03577364139046235,652,While liquor is quicker... Candy sure is dandy!
4422,7479,4,20,123,147,1.1904761904761905,0.03780055628036639,652,"I tell you, this is a mirage, this is ONLY a mirage!. They don't deliver to this address!"
3419,7479,4,16,106,126,1.1904761904761905,0.04173124247658407,652,There goes my 2019 sugar-free diet resolution
679,7502,5,21,137,163,1.1901840490797546,0.03646102009629538,652,It may be a hallucination but it looks yummy!
2833,7502,3,25,135,163,1.1901840490797546,0.03432091581506232,652,To hell with your diet.  I say go for it.
3586,7502,5,21,137,163,1.1901840490797546,0.03646102009629538,652,"No, I'm diabetic. But you go right ahead."
7766,7502,5,21,137,163,1.1901840490797546,0.03646102009629538,652,I know you think it’s a hallucination but wouldn’t it be sweet if it was real?
7874,7506,3,21,118,142,1.1901408450704225,0.03730655307532889,652,That's the island paradise if you had paid for a state room.
8740,7506,5,17,120,142,1.1901408450704225,0.039894349776583946,652,"Ze Candy Cane! Ze Candy Cane !"""
8477,7506,5,17,120,142,1.1901408450704225,0.039894349776583946,652,"I'd swim over, but I'm gluten intolerant"
7899,7506,3,21,118,142,1.1901408450704225,0.03730655307532889,652,Are you sure we can't swim there without a formal invitation?
6983,7506,6,15,121,142,1.1901408450704225,0.041127232644118786,652,"Must be your mirage, I yearn for a different kind of ""sugar"""
1663,7506,2,23,117,142,1.1901408450704225,0.03594285438714189,652,"Keep saying to yourself, ""I don't need the calories."""
4894,7506,4,19,119,142,1.1901408450704225,0.038622131262132306,652,We're stuck on the shithole island.
3913,7506,6,15,121,142,1.1901408450704225,0.041127232644118786,652,The mirage seems to get sweeter every time we switch islands.
3856,7506,3,21,118,142,1.1901408450704225,0.03730655307532889,652,I’d love to visit your island but I’m diabetic.
2579,7506,3,21,118,142,1.1901408450704225,0.03730655307532889,652,If wishes were candy then life would be dandy
6101,7506,4,19,119,142,1.1901408450704225,0.038622131262132306,652,And I thought fantasy island was just a fantasy.
4134,7517,2,19,100,121,1.1900826446280992,0.03947668975473125,652,"I swear I just saw a midget behind the cupcake yelling, ""Boss, the plane the plane!""  Maybe we swim over there."
9378,7517,4,15,102,121,1.1900826446280992,0.04282395506787311,652,Think of it this way: we'll have so many fewer cavities to search at customs.
7866,7519,3,24,131,158,1.1898734177215189,0.03495184918142526,652,Sure.   But we don't have a dentist.
4105,7519,5,20,133,158,1.1898734177215189,0.03718713583173612,652,"It figures,  I just started my low carb diet."
4179,7519,4,22,132,158,1.1898734177215189,0.03608680390786284,652,I am thinking of re-decorating our island
7554,7519,3,24,131,158,1.1898734177215189,0.03495184918142526,652,"No, I don't regret springing for the all-inclusive package. Do you?"
9965,7523,3,20,114,137,1.1897810218978102,0.038113588558643594,652,"This might be my pre-spring break juice cleanse talking, but that sandbar looks like a cheesecake."
8136,7523,3,20,114,137,1.1897810218978102,0.038113588558643594,652,And me a diabetic ..(heavy sigh)
6141,7523,2,22,113,137,1.1897810218978102,0.03667837817927331,652,Of course it deserted. Santa Clause abandoned it after the ice caps melted.
5288,7523,4,18,115,137,1.1897810218978102,0.0394966813767099,652,I'm saving 'Dessert Island' for after we find 'Balanced Meal Isle'.
5799,7523,4,18,115,137,1.1897810218978102,0.0394966813767099,652,"Nevermind. I'm on a diet, anyway."
2734,7523,5,16,116,137,1.1897810218978102,0.04083295295137394,652,Of course I'm a diabetic
1738,7523,6,14,117,137,1.1897810218978102,0.042126859053161,652,My ex-wife would brave the risk.
1531,7523,4,18,115,137,1.1897810218978102,0.0394966813767099,652,When did you start the Atkin’s diet?
1404,7523,6,14,117,137,1.1897810218978102,0.042126859053161,652,What would YOU do if you were stranded on a dessert island?
461,7523,6,14,117,137,1.1897810218978102,0.042126859053161,652,Do you think it's funny?
3169,7523,3,20,114,137,1.1897810218978102,0.038113588558643594,652,Hm... Candyland seemed so much bigger as a child.
5068,7534,3,23,127,153,1.1895424836601307,0.03561783786016251,652,Can you believe it -- the good ship Lollipop turned out to be an atoll.
8435,7534,3,23,127,153,1.1895424836601307,0.03561783786016251,652,I'm sure we're allowed.There's no fruit of the tree over there.
7605,7534,4,21,128,153,1.1895424836601307,0.03680529426371062,652,"Nah, never going back. No sugar coma's worth it."
7427,7534,4,21,128,153,1.1895424836601307,0.03680529426371062,652,I hope it's gluten-free.
4797,7534,4,21,128,153,1.1895424836601307,0.03680529426371062,652,Must be a new version of Candyland.
4531,7534,2,25,126,153,1.1895424836601307,0.03438940333630873,652,Can't go with you--my doctor has taken me off all that stuff.
4188,7534,5,19,129,153,1.1895424836601307,0.03795561879147583,652,Nope!  I'm sticking to my diet.
2724,7534,6,17,130,153,1.1895424836601307,0.03907209118858802,652,"If it's not sugar free, low carb, non GMO, gluten free, organic, vegan, fair-trade certified I'll pass."
2672,7534,4,21,128,153,1.1895424836601307,0.03680529426371062,652,"Tough on the diet, Clyde."
2211,7534,2,25,126,153,1.1895424836601307,0.03438940333630873,652,"Let’s make a gluten free  exception, it will be full-on and guilt-free."
925,7534,5,19,129,153,1.1895424836601307,0.03795561879147583,652,"Mirage or not, my gluten allergy eliminates the temptation."
9157,7545,3,19,110,132,1.1893939393939394,0.03897331447269078,652,You know refine sugars and carbs will kill you.
8272,7545,3,19,110,132,1.1893939393939394,0.03897331447269078,652,"Yeah, but we agreed to eat less sweets."
6653,7545,4,17,111,132,1.1893939393939394,0.04042993522120931,652,Pity you’ve gone off sweets
2152,7545,2,21,109,132,1.1893939393939394,0.03746009636911411,652,"Too bad we started keto on Tuesday, huh?"
1418,7545,5,15,112,132,1.1893939393939394,0.041835870768935995,652,"Let's wait,watch who lands on Dessert Island..."
750,7545,4,17,111,132,1.1893939393939394,0.04042993522120931,652,Candy crushed
6428,7545,2,21,109,132,1.1893939393939394,0.03746009636911411,652,"‘I hate to tell you this, but I can’t swim’
‘That’s ok, I’m doin the keto diet’"
2039,7552,6,20,143,169,1.1893491124260356,0.03655572582416299,652,"I'd love to swim over with you, but I didn't finish my vegetables."
4225,7552,6,20,143,169,1.1893491124260356,0.03655572582416299,652,But we have the coconut milk to wash it all down.
6643,7554,3,22,123,148,1.1891891891891893,0.036322177069935874,652,So you going first?
7668,7554,4,20,124,148,1.1891891891891893,0.03756633080907703,652,"On the bright side,this arrangement allows us our desire."
3382,7554,3,22,123,148,1.1891891891891893,0.036322177069935874,652,"It's a part of making this diet work longterm"""
4041,7554,3,22,123,148,1.1891891891891893,0.036322177069935874,652,I guess you signed up for the sugarfree cruise.
1756,7554,4,20,124,148,1.1891891891891893,0.03756633080907703,652,"That dessert isle looks tempting, but sugar and gluten are really just empty calories."
1131,7554,4,20,124,148,1.1891891891891893,0.03756633080907703,652,"So far, I don’t like “Handsel and Gretel at Sea.”"
92,7554,3,22,123,148,1.1891891891891893,0.036322177069935874,652,I think it's the Good Ship Lollipop
2270,7554,2,24,122,148,1.1891891891891893,0.03503386766748057,652,"What about your sugar-free, gluten-free diet?"
4948,7562,5,21,138,164,1.1890243902439024,0.03625656529444611,652,There must be a gluten-free island around here somewhere.
5170,7562,5,21,138,164,1.1890243902439024,0.03625656529444611,652,Too bad I'm on Atkins.
6378,7562,4,23,137,164,1.1890243902439024,0.03520968372285099,652,"I know how it looks Gretel, but are you sure it's not the witch?"
8205,7562,3,25,136,164,1.1890243902439024,0.03413070653789578,652,It looks like Coney Island to me
3001,7566,4,16,107,127,1.188976377952756,0.041428503387875924,652,"Well, it's no big deal.  I'm on a low sugar diet."
9083,7567,4,19,120,143,1.1888111888111887,0.03837413849424774,652,This is the most intense diet I have ever tried.
10013,7567,5,17,121,143,1.1888111888111887,0.03963669463281773,652,"So, Hansel, is this a twenty first century version of the witch and her gingerbread house?"
9636,7567,4,19,120,143,1.1888111888111887,0.03837413849424774,652,Let's enjoy the view while we can. A wall would be built soon!
6371,7567,4,19,120,143,1.1888111888111887,0.03837413849424774,652,I'm actually glad! Imagine what all those saturated fats would do to my waistline.
5383,7567,2,23,118,143,1.1888111888111887,0.035715380338120946,652,It's called just deserts island; they're not gluten-free.
5719,7567,1,25,117,143,1.1888111888111887,0.03430882301183037,652,Don't bother. It's all gluten-free.
5045,7567,5,17,121,143,1.1888111888111887,0.03963669463281773,652,So that is where it is.
372,7567,2,23,118,143,1.1888111888111887,0.035715380338120946,652,"Darn Amazon Prime.  This was to celebrate our rescue, in twenty years."
3290,7567,5,17,121,143,1.1888111888111887,0.03963669463281773,652,I'm on a 'no sugar' diet.'What's your excuse?
3127,7567,4,19,120,143,1.1888111888111887,0.03837413849424774,652,I don't think that candy cane would provide enough protection from the sun.
2838,7567,5,17,121,143,1.1888111888111887,0.03963669463281773,652,No one tells you the Whole 30 will make you feel so alone
2749,7567,2,23,118,143,1.1888111888111887,0.035715380338120946,652,Do we have the kahunas to swim to that mirage?
5255,7567,3,21,119,143,1.1888111888111887,0.03706860462623555,652,Let’s hope my Uber doesn’t get confused.
10000,7580,4,22,133,159,1.1886792452830188,0.035879003158758,652,I heard there was an outbreak of diabetes that claimed all the lives there.
8018,7580,6,18,135,159,1.1886792452830188,0.03803322047192668,652,I thought mirages only occured in the desert!
2432,7580,4,22,133,159,1.1886792452830188,0.035879003158758,652,"I don't care if it's just a reward, Pavlov."
1054,7580,5,20,134,159,1.1886792452830188,0.036971804981176866,652,Glad we didn’t land there. I’m sugar and gluten free
51,7580,4,22,133,159,1.1886792452830188,0.035879003158758,652,"Okay you’ve done that joke enough times, thank you Kevin..."
4071,7580,4,22,133,159,1.1886792452830188,0.035879003158758,652,"Well, at least we're not on the COMPLETELY desserted island."
8788,7586,6,21,148,175,1.1885714285714286,0.035685702847990844,652,I wonder if there’s a dentist on the island?
8587,7587,2,19,101,122,1.1885245901639345,0.039182762519031016,652,I hope this isn’t our LAST course!!!
9557,7587,6,11,105,122,1.1885245901639345,0.045576538549547026,652,I swear you said ‘sandy island’.
7640,7589,5,16,117,138,1.1884057971014492,0.0405593033272745,652,That's Mark Zuckerberg's island.
7709,7589,4,18,116,138,1.1884057971014492,0.03923353875954684,652,"Tempting, but I'm on a strict low-carb diet."""
6677,7589,4,18,116,138,1.1884057971014492,0.03923353875954684,652,"Dude, I told you playing Candy Land would come in handy."
9826,7589,3,20,115,138,1.1884057971014492,0.03786137927756817,652,I told you we shouldn't have drank the salt water.
9984,7589,2,22,114,138,1.1884057971014492,0.036437583866152166,652,"Let's just say that I am an optimist, but that's simply far too many calories."
8763,7589,3,20,115,138,1.1884057971014492,0.03786137927756817,652,My doctor advised me to stay away from Sweets
5727,7589,6,14,118,138,1.1884057971014492,0.04184308317023084,652,Did you see the ‘Good Ship Lollipop’ pass by here?
6311,7589,5,16,117,138,1.1884057971014492,0.0405593033272745,652,I'm actually gluten free.
9,7589,5,16,117,138,1.1884057971014492,0.0405593033272745,652,I think you're right.  This Paleo diet  of ours has lost its appeal.
246,7589,5,16,117,138,1.1884057971014492,0.0405593033272745,652,"Years ago that was Candyland, now it’s Cholesterolland."
1753,7589,2,22,114,138,1.1884057971014492,0.036437583866152166,652,"Remember mom told us no sweets until after dinner, so it’s a no go."
1859,7589,1,24,113,138,1.1884057971014492,0.034955843505855747,652,Why do coworkers always bring sweets on the day I am starting my diet?
5424,7589,2,22,114,138,1.1884057971014492,0.036437583866152166,652,"If we swim over there together, this one will be, too!"
3254,7589,2,22,114,138,1.1884057971014492,0.036437583866152166,652,Don't even think about it. That's where Oprah keeps her stash.
4487,7589,4,18,116,138,1.1884057971014492,0.03923353875954684,652,i wonder if they have a vegan option
2619,7589,5,16,117,138,1.1884057971014492,0.0405593033272745,652,Clearly there was no escape from the Type 2 Diabetes epidemic
9413,7605,5,19,130,154,1.1883116883116882,0.03772842943363952,652,It's best just to avoid that isle.
9048,7605,4,21,129,154,1.1883116883116882,0.03658622622935444,652,"What, no lollipops."
7628,7605,3,23,128,154,1.1883116883116882,0.035407195764164776,652,I'm avoiding sugar.
6890,7605,5,19,130,154,1.1883116883116882,0.03772842943363952,652,You know what that looks like to me? One fuck-ton of carbs.
5092,7605,3,23,128,154,1.1883116883116882,0.035407195764164776,652,"My life coach says, "" They have what you shouldn't""."
4733,7605,4,21,129,154,1.1883116883116882,0.03658622622935444,652,Betcha it's a mirage.
8164,7605,5,19,130,154,1.1883116883116882,0.03772842943363952,652,I feel better already.
4109,7605,3,23,128,154,1.1883116883116882,0.035407195764164776,652,I just hope the rescue pilot isn't halfway through his keto diet.
4535,7605,4,21,129,154,1.1883116883116882,0.03658622622935444,652,I told you we shouldn't have eaten those funny mushrooms a moment ago!
131,7605,5,19,130,154,1.1883116883116882,0.03772842943363952,652,I wish the mirage was low-cal.
134,7605,4,21,129,154,1.1883116883116882,0.03658622622935444,652,You just had to have coconut toppings!
1031,7605,3,23,128,154,1.1883116883116882,0.035407195764164776,652,I wonder if any are coconut flavoured.
7565,7605,3,23,128,154,1.1883116883116882,0.035407195764164776,652,"Sure, it looks great, but tooth decay is its own kind of stranded."
2474,7605,3,23,128,154,1.1883116883116882,0.035407195764164776,652,"I guess that 'no sugar diet' doesn't seem so smart now Jake.  Excuse me, I'm going for a little swim."
3980,7605,3,23,128,154,1.1883116883116882,0.035407195764164776,652,"Yes, I'm still having those dentist chair nightmares; why do you ask?"
1209,7605,4,21,129,154,1.1883116883116882,0.03658622622935444,652,I'll race you over.
652,7621,3,26,141,170,1.188235294117647,0.03336164450889911,652,But I'm on a Keto diet.
3174,7621,4,24,142,170,1.188235294117647,0.03438914027149321,652,feel free mate ... I'm sugar free.
7613,7623,5,12,100,117,1.188034188034188,0.04530998763637655,652,Don't fall for it. The cholesterol will kill you.
4087,7624,5,15,113,133,1.1879699248120301,0.04154453635293475,652,If only it were gluten free...
4280,7624,3,19,111,133,1.1879699248120301,0.03870537646987594,652,Islands in the stream...that is what we are... no one in between...
4620,7624,2,21,110,133,1.1879699248120301,0.03720463682287573,652,"No, you're sweet. That’s just sugar."
8507,7624,3,19,111,133,1.1879699248120301,0.03870537646987594,652,"No thanks, I’m doing paleo."
8764,7624,1,23,109,133,1.1879699248120301,0.035640760858451595,652,I escaped from Carb Island to Keto Island just in time.
8522,7629,3,22,124,149,1.1879194630872483,0.03609991716469566,652,It sucks being gluten free
10022,7629,1,26,122,149,1.1879194630872483,0.033493500506269556,652,Tell me more about this paleo diet.
9522,7629,5,18,126,149,1.1879194630872483,0.03853042255714695,652,One of these days I'd like to live on Mirage Island.
9430,7629,3,22,124,149,1.1879194630872483,0.03609991716469566,652,The sea rise from climate change is really bad.  Big Rock Candy Mountain is now Sweets Island.
9294,7629,4,20,125,149,1.1879194630872483,0.03733495333953283,652,Resist the temptation. You won’t live long if you have too much sugar!
6630,7629,3,22,124,149,1.1879194630872483,0.03609991716469566,652,We have to consider the glycemic index
4398,7629,5,18,126,149,1.1879194630872483,0.03853042255714695,652,This keto diet is a lot harder than I thought.
4163,7629,2,24,123,149,1.1879194630872483,0.03482110420033638,652,The sugar keeps me up all night
2523,7629,4,20,125,149,1.1879194630872483,0.03733495333953283,652,"No, I am not worried about my dental identification."
2420,7629,4,20,125,149,1.1879194630872483,0.03733495333953283,652,Now I know where Fantasy Island is!
309,7629,2,24,123,149,1.1879194630872483,0.03482110420033638,652,I bet those candy canes wouldn't give us as much shade as our palm tree.
6,7629,6,16,127,149,1.1879194630872483,0.039689900277016354,652,"Ahhh, No Mate...It's a whale."
6151,7629,4,20,125,149,1.1879194630872483,0.03733495333953283,652,Well I still think Isle of Desolation sounds more romantic than Candy Beach and I’m not sorry!
3069,7642,3,25,137,165,1.187878787878788,0.03394256135573651,652,"Nah, it doesn't tempt me; I'm off sugar and gluten."
8317,7642,5,21,139,165,1.187878787878788,0.03605436355564635,652,Kind of ironic since I always got confused as to how many s’s there were in desert and dessert.
8593,7642,6,19,140,165,1.187878787878788,0.03706517181142036,652,"Apparently, the underwater giantess could only afford one implant."
10009,7645,4,16,108,128,1.1875,0.041130075016539196,652,Wow!  It looks like Julia Childs has taken her Floating Island Dessert to the next level!
9834,7645,5,20,135,160,1.1875,0.03675892481369823,652,Are you sure it's vegan?
9087,7645,2,23,119,144,1.1875,0.03549071855205391,652,I'm on a diet myself.
8813,7645,4,16,108,128,1.1875,0.041130075016539196,652,"Go ahead, I'm off sugar."
8291,7645,3,24,133,160,1.1875,0.03455410032190975,652,I know.  Will we have the ever muster the willpower to wait 30 minutes before swimming back?
8246,7645,1,28,131,160,1.1875,0.032198651286258685,652,I found it on Zillow.
7715,7645,5,17,122,144,1.1875,0.03938231068279761,652,"That desserted island looks nice, but think of the calories."
5259,7645,4,19,121,144,1.1875,0.03812927087673324,652,Stay strong man.  Paleo diet.
4124,7645,4,19,121,144,1.1875,0.03812927087673324,652,"Look on the bright side, diabetes won’t be an issue"
2203,7645,1,25,118,144,1.1875,0.034094955729785104,652,"When I was your age, my mirages were also less about beer and bikinis and more about cakes and candy."
1421,7645,2,26,132,160,1.1875,0.03339714803475509,652,Do you think they're gluten free?
942,7645,4,16,108,128,1.1875,0.041130075016539196,652,"We could swim the 1/4 miles through shark-infested waters only to find out it's a mirage, but that's not my concern, what if there isn't any Tums?"
423,7645,1,25,118,144,1.1875,0.034094955729785104,652,"Dear Mirage, your presence has been dully noted."
222,7645,2,26,132,160,1.1875,0.03339714803475509,652,Did you consider booking passage on the good ship lollipop?
7630,7645,2,20,106,128,1.1875,0.03802131084983996,652,Do you think they have free dental care?
8634,7660,4,21,130,155,1.1870967741935483,0.036369717182832766,652,No dessert for you!
6989,7660,6,17,132,155,1.1870967741935483,0.03860480137343009,652,Those humans do look delish.
6661,7660,3,23,129,155,1.1870967741935483,0.03519899355660425,652,I certainly did not realize how far sharks had evolved!
5156,7660,5,19,131,155,1.1870967741935483,0.03750391324276195,652,Along the waterline; those are macaroons on a dessert island...
1732,7660,7,15,133,155,1.1870967741935483,0.03967515431152554,652,I was hoping for something a little more healthy.
4003,7660,3,23,129,155,1.1870967741935483,0.03519899355660425,652,What's eating at you?
2767,7660,6,17,132,155,1.1870967741935483,0.03860480137343009,652,Sweets without coffee always turns me off.
1638,7660,5,19,131,155,1.1870967741935483,0.03750391324276195,652,What a week to give up sweets.
1575,7660,3,23,129,155,1.1870967741935483,0.03519899355660425,652,Naugh...... I’m afraid of what it will do to my complexion.
4050,7660,5,19,131,155,1.1870967741935483,0.03750391324276195,652,And me on a diet!
9982,7670,4,18,117,139,1.1870503597122302,0.03897383732992529,652,So now we’re tied in Candyland.
5437,7670,4,18,117,139,1.1870503597122302,0.03897383732992529,652,I don’t want to play Candyland; I want to go home.
9212,7670,4,18,117,139,1.1870503597122302,0.03897383732992529,652,isn't great to get away for a few days?
4047,7670,2,22,115,139,1.1870503597122302,0.03619987799853548,652,It’s actually a net negative for calories
7087,7670,3,20,116,139,1.1870503597122302,0.03761243918790917,652,I’ll bet you anything they don’t have prime rib.
3760,7670,4,18,117,139,1.1870503597122302,0.03897383732992529,652,But I’m gluten free.
2914,7670,6,14,119,139,1.1870503597122302,0.041563070451184216,652,Where are the women?
4023,7670,1,24,114,139,1.1870503597122302,0.03472991149648299,652,"Screw that, we should have followed the leprechaun."
3530,7670,4,18,117,139,1.1870503597122302,0.03897383732992529,652,So salt with sweet is a must-have for me!
275,7670,3,20,116,139,1.1870503597122302,0.03761243918790917,652,I was the Captain on the Good Ship..........
719,7680,3,17,103,123,1.1869918699186992,0.04057035967909163,652,"It's Mediterranean. No carbs, no sugars....
you'll thank me later."
5206,7680,3,17,103,123,1.1869918699186992,0.04057035967909163,652,But is it gluten free?
8238,7680,2,19,102,123,1.1869918699186992,0.03889311074169898,652,"...tempting,but Amazon has lost my electric tooth brush order."
3669,7683,3,25,138,166,1.1867469879518073,0.03375644753282386,652,I can't figure if it's a mirage or some kind of flying saucer with a sweet tooth.
6911,7683,1,29,136,166,1.1867469879518073,0.03151918542381326,652,At leasr we've got vegan options.
7443,7683,4,23,139,166,1.1867469879518073,0.034821216236140776,652,"What, you couldn't ask for delivery by drone?"
9481,7683,5,21,140,166,1.1867469879518073,0.03585437839778927,652,I wonder if any restaurants on that island have desert menus.
9889,7683,2,27,137,166,1.1867469879518073,0.032656980875587785,652,Too bad I can't swim.
9622,7688,1,26,123,150,1.1866666666666668,0.033293040524300606,652,The swim allows me to maintain this figure.
9317,7688,3,22,125,150,1.1866666666666668,0.03588032141130668,652,Looks like we missed the Good Shop Lollypop!
7924,7688,5,18,127,150,1.1866666666666668,0.038293189757509415,652,"Right, but you can always come up with some excuse to stray from the paleo diet. Excuses are the language of the unmotivated, Bill."
7888,7688,1,26,123,150,1.1866666666666668,0.033293040524300606,652,"Yeah, I'm hungry too. Why do you ask?"
7671,7688,2,24,124,150,1.1866666666666668,0.0346108654321977,652,"Rats, I told you we should have given up wine not sugar for lent."
9540,7688,4,20,126,150,1.1866666666666668,0.03710637308053225,652,I think that one's for castaways of the Good Ship Lollipop.
3989,7688,5,18,127,150,1.1866666666666668,0.038293189757509415,652,You go... I'am off sweets !
3844,7688,1,26,123,150,1.1866666666666668,0.033293040524300606,652,Well I feel lucky - my doctor told me to cut down on sugar.
2713,7688,3,22,125,150,1.1866666666666668,0.03588032141130668,652,Explain again why you never want the highest valued island in the neighborhood.
519,7688,6,16,128,150,1.1866666666666668,0.03944431315687471,652,The grass is always greener.
2620,7688,4,20,126,150,1.1866666666666668,0.03710637308053225,652,You go ahead. I have up sweets for lent.
5132,7688,5,18,127,150,1.1866666666666668,0.038293189757509415,652,"You can swim over there alone bro, I’m not ruining my keto diet."
2574,7688,2,24,124,150,1.1866666666666668,0.0346108654321977,652,Have you ever wanted to do it while rolling around in a cherry pie?
2100,7701,2,21,111,134,1.1865671641791045,0.03695258124795449,652,"It was part of Disney land, but folks said it wasn't worth the ferry ride."
3218,7701,3,19,112,134,1.1865671641791045,0.03844104722195697,652,"Almost makes you regret going low-carb, eh?"
6780,7701,3,19,112,134,1.1865671641791045,0.03844104722195697,652,"Nice, but I'm on a low carb diet."
6787,7701,1,23,110,134,1.1865671641791045,0.035401587679829136,652,And they say they have it bad.
8054,7701,1,23,110,134,1.1865671641791045,0.035401587679829136,652,Candyland is just a short swim -- and possibly a submerged shark -- away.
3399,7706,5,12,101,118,1.1864406779661016,0.04495261648522338,652,WE just need a few shark fins to add to the a-lure.
9983,7707,3,24,134,161,1.186335403726708,0.03435855077252008,652,"Yeah, but is it gluten-free, dude?"
561,7707,4,22,135,161,1.186335403726708,0.03547040685896674,652,Are mirages common out here?
2730,7707,3,24,134,161,1.186335403726708,0.03435855077252008,652,"You say Keto, I say Sweeto."
1800,7707,3,24,134,161,1.186335403726708,0.03435855077252008,652,"I'm sorry, but it was dark, and they both had only one 's' on the map!"
6433,7707,2,26,133,161,1.186335403726708,0.03320949050550226,652,And thus îles flottante was created.
8188,7712,4,19,122,145,1.186206896551724,0.0378874706295391,652,"Nah, I'm gluten free"
8144,7712,2,23,120,145,1.186206896551724,0.03526881837371553,652,It's where they really  film The British Baking Show
7550,7712,5,17,123,145,1.186206896551724,0.039131136851837243,652,"Hell, I'll risk the sharks if it's gluten-free."
7227,7712,6,15,124,145,1.186206896551724,0.04033647619624502,652,I even heard everything is covered by your public medical insurance there...
4838,7712,5,17,123,145,1.186206896551724,0.039131136851837243,652,I'm pre-diabetic.
4420,7712,2,23,120,145,1.186206896551724,0.03526881837371553,652,Looks like 'The Good Ship Lollipop' passed us by. How long have we been on this island? Are you sure that's not a mirage?
3198,7712,3,21,121,145,1.186206896551724,0.03660157086917392,652,I'm watching my carbohydrates.
3702,7712,3,21,121,145,1.186206896551724,0.03660157086917392,652,Busy Season...temptation island. At least I won’t gain 69 lbs
3773,7712,2,23,120,145,1.186206896551724,0.03526881837371553,652,I thought Candyland was only a board game.
1085,7712,4,19,122,145,1.186206896551724,0.0378874706295391,652,I'm allergic to gluten
2779,7712,3,21,121,145,1.186206896551724,0.03660157086917392,652,It’s a sugar coated mirage!
2996,7712,6,15,124,145,1.186206896551724,0.04033647619624502,652,Unfortunately I am on a low sugar diet
3016,7712,2,23,120,145,1.186206896551724,0.03526881837371553,652,"'I'm sorry, Hansel. I don't think Gretel is coming back.""
Don Urbanus, Valley Springs, C"
2795,7712,2,23,120,145,1.186206896551724,0.03526881837371553,652,Well at least were not part of the obesity epidemic.
3551,7712,4,19,122,145,1.186206896551724,0.0378874706295391,652,I can't tell which is the worst decision - going keto or jumping off the cruise ship.
4463,7727,3,18,108,129,1.186046511627907,0.03932485249554849,652,"Its just your stomach making you see things, a bit of undigested shoe is all."
5054,7727,2,20,107,129,1.186046511627907,0.03775341034646929,652,"Oh, man, I can just FEEL my A1C level rising . . ."
5056,7727,2,28,142,172,1.186046511627907,0.03196205911331519,652,Do you think there are any Gluten-free options?
6751,7727,2,20,107,129,1.186046511627907,0.03775341034646929,652,So exciting...I smell a TV show...
8353,7727,3,18,108,129,1.186046511627907,0.03932485249554849,652,"Damn it, I'm off sweets this week."
9024,7727,4,24,144,172,1.186046511627907,0.03402311177378928,652,"No, not Devil’s Island, Willie Wonka is in exile there."
7484,7733,3,23,130,156,1.185897435897436,0.03499318990757995,652,"There is no where to ""RUN"" or  We will be (EATEN)"
9459,7733,3,23,130,156,1.185897435897436,0.03499318990757995,652,The 99% hidden below is actually a man-eating octopus.
6752,7733,2,25,129,156,1.185897435897436,0.033790684425876356,652,But what about your Hyperglycaemia?
4805,7733,5,19,132,156,1.185897435897436,0.03728202397651635,652,"No, you calm down Carl. Someone is getting a letter from the home owners association."
2202,7733,4,21,131,156,1.185897435897436,0.03615572327926449,652,"That's so funny, my uncle died of diabetes too!"
1847,7733,4,21,131,156,1.185897435897436,0.03615572327926449,652,I know where the kids will go if they make it...
837,7733,2,25,129,156,1.185897435897436,0.033790684425876356,652,They're the man-eating snacks of Tulare Island.
5594,7733,5,19,132,156,1.185897435897436,0.03728202397651635,652,Dang! I just went Keto.
1121,7741,4,18,118,140,1.1857142857142857,0.03871751104384216,652,Yep. Week 6. Right on schedule. Wait to you see what shows up on Week 10.
4356,7741,6,14,120,140,1.1857142857142857,0.04128674735635705,652,"I prefer a non-fat, sugar-free, USDA organic survival."
5393,7741,4,18,118,140,1.1857142857142857,0.03871751104384216,652,"I can't swim. You?""
""Diet"
5721,7741,6,14,120,140,1.1857142857142857,0.04128674735635705,652,That's Paradise Island.
6690,7741,5,16,119,140,1.1857142857142857,0.0400227508343548,652,"So anyway this dude asked if I wanted to be in a music video, yeah? Multi-generational indie crossover type thing, Weezer with Iggy Pop and Kate Pierson? So I was like, yeah, man, sounds great. Had no idea they’d be filming it on location."
6967,7741,5,16,119,140,1.1857142857142857,0.0400227508343548,652,"A part of me is really glad we’re not there because, you know, I’ve been trying this new diet recently..."
8640,7741,2,22,116,140,1.1857142857142857,0.03596520284375474,652,You go ahead. That stuff goes right to my love handles.
2782,7748,0,31,136,167,1.18562874251497,0.03017725869879472,652,"Really?  A mirage in the ocean, are you sure"
4436,7748,6,19,142,167,1.18562874251497,0.03665427865789075,652,the food looks better on the other side
6278,7748,6,19,142,167,1.18562874251497,0.03665427865789075,652,I'm on the South Beach Diet no can do.
8210,7748,5,21,141,167,1.18562874251497,0.03565657410685419,652,Just as well. The dentist's bills were killing me.
9339,7748,5,21,141,167,1.18562874251497,0.03565657410685419,652,"It's a leftover set from ""Diabetic Survivor."""
8011,7753,3,17,104,124,1.185483870967742,0.04027009434807555,652,"Head for the island with the sweet coconuts, you said"
6990,7753,3,17,104,124,1.185483870967742,0.04027009434807555,652,Not Every Island has a Disney Land Nearby.
7429,7755,4,20,127,151,1.185430463576159,0.036880540415818286,652,I'm waiting for the 'good ship lollipop' to take me to the 'big rock candy' island.
1724,7755,2,24,125,151,1.185430463576159,0.0344031077064515,652,That island might look sweet but its really just an illusion
7183,7755,3,22,126,151,1.185430463576159,0.03566334309360599,652,"If we weren't diabetic, it would be worth swimming over to."
5002,7758,4,25,149,178,1.1853932584269662,0.03327393734006044,652,I told you NOT to book us on a cruise when they are paying us to be the passengers.
273,7759,2,21,112,135,1.1851851851851851,0.03670386351646649,652,"Awww, you're the one with the sweet-tooth!"
3245,7759,3,24,135,162,1.1851851851851851,0.034165169635348186,652,Empty calories! Rock-paper-scissors. Who eats who?
3392,7759,2,21,112,135,1.1851851851851851,0.03670386351646649,652,Tell me again about your unmatched navigational skills.
3660,7759,5,15,115,135,1.1851851851851851,0.040973754472540466,652,"She was a good ship, that Lollipop, but shiver me timbers, ye don’t want to wake up to one of her tummy-aches."
4043,7759,3,19,113,135,1.1851851851851851,0.0381802555851705,652,Got an ‘s’?
6128,7759,5,20,137,162,1.1851851851851851,0.03634035344372932,652,You can't live on sweets alone.
6516,7759,5,20,137,162,1.1851851851851851,0.03634035344372932,652,They said we were going to play Chutes and Ladders.
8421,7759,5,20,137,162,1.1851851851851851,0.03634035344372932,652,What's the tip policy here?
9236,7759,6,18,138,162,1.1851851851851851,0.03738050995527878,652,"If I wasn't doing the Keto thing, I'd definitely be interested."
9914,7759,1,23,111,135,1.1851851851851851,0.035165541052596595,652,Have at it...watching my sugar.
4511,7769,3,26,144,173,1.1849710982658959,0.03283493530870879,652,I bet they will die of obesity over there.
7206,7770,5,17,124,146,1.1849315068493151,0.03888311355036097,652,Too bad all our dental equipment went down with the ship.
8462,7770,4,19,123,146,1.1849315068493151,0.037648681359122055,652,"You know, this Paleo diet just isn’t working for me anymore."
3748,7770,4,19,123,146,1.1849315068493151,0.037648681359122055,652,"Yeah, but it's not gluten free."
5737,7770,3,21,122,146,1.1849315068493151,0.03637237821192262,652,I'm from Vienna so every mirage looks like cake.
89,7770,3,21,122,146,1.1849315068493151,0.03637237821192262,652,"I don't care if it's real. I'm finally the size I want to be, so we're not touching it."
9059,7775,2,25,130,157,1.1847133757961783,0.033595639560289964,652,He always did have a flair for the whimsical.
8360,7775,5,19,133,157,1.1847133757961783,0.03706271643375916,652,"I wish they'd fix the bug in this virtual reality Candy Land, I've been stuck in here since I was five."
1125,7775,3,23,131,157,1.1847133757961783,0.03478974439102747,652,"Looks good, but what about the tooth decay & those extra calories!"
4789,7775,2,25,130,157,1.1847133757961783,0.033595639560289964,652,Oh what I'd give to be on that dessert island.
5488,7775,5,19,133,157,1.1847133757961783,0.03706271643375916,652,"Dude, no!  No on is going to buy the movie rights to our memoir if we're stranded on a doggone DESSERT island."
3,7780,5,14,111,130,1.1846153846153846,0.04199073553245282,652,Any changes in your life?
1375,7780,1,22,107,130,1.1846153846153846,0.03586334525736468,652,I remember the day when you could still look up to the Big Rock Candy Mountain.
1670,7780,5,14,111,130,1.1846153846153846,0.04199073553245282,652,"It's a meringue, m-i-r-a-g-e, meringue."
1872,7780,1,22,107,130,1.1846153846153846,0.03586334525736468,652,No tea? How uncivilized. They must be from another planet.
2469,7780,2,20,108,130,1.1846153846153846,0.03748920001048042,652,It looks greener to me!
9180,7780,1,22,107,130,1.1846153846153846,0.03586334525736468,652,"Oddly enough, this just reminds me of how much my Mother always hated Valentine's Day."
9593,7780,3,18,109,130,1.1846153846153846,0.03904741607075517,652,Why the cheap candy canes?
1814,7780,0,24,106,130,1.1846153846153846,0.03416019538398571,652,I’m on a low carb diet.
5359,7788,4,23,141,168,1.1845238095238095,0.03444111705624404,652,I saw this the last time I did Whole30.
7590,7789,1,24,116,141,1.1843971631205674,0.0342865286453498,652,I never go there.  I'm dieting.
9040,7789,2,22,117,141,1.1843971631205674,0.03573350205538369,652,I preferred Chutes and Ladders myself...
7983,7789,3,20,118,141,1.1843971631205674,0.03712412008029051,652,"Sharks?  No, man, the water is a mirage."
7725,7789,6,14,121,141,1.1843971631205674,0.04101404222357245,652,"No,no, that's the tropical version of the big rock candy mountain"
7016,7789,2,22,117,141,1.1843971631205674,0.03573350205538369,652,You go...I'm keeping my sugar at 80 even if it kills me.
5330,7789,3,20,118,141,1.1843971631205674,0.03712412008029051,652,"Your choice: take the plunge and have your cake, alone, or be here, with Edith, too."
4730,7789,5,16,120,141,1.1843971631205674,0.03975970997031122,652,"Sorry man, i'm lactose intolerant."
4137,7789,4,18,119,141,1.1843971631205674,0.03846449550338009,652,"And with Insulin Island behind us, we should be able to stay alive for up to a week before dying of dehydration!"
4118,7789,1,24,116,141,1.1843971631205674,0.0342865286453498,652,I've never had much of a sweet tooth to be honest
7014,7789,3,20,118,141,1.1843971631205674,0.03712412008029051,652,I told you we should have booked on The Good Ship Lollipop.
2043,7799,4,20,128,152,1.1842105263157894,0.03665740687128959,652,Darn!  There goes my diet...
3181,7799,0,28,124,152,1.1842105263157894,0.031546980450822305,652,"We might be starving...but hey, at least we're safe from diabetes."
4283,7799,3,22,127,152,1.1842105263157894,0.03544893655367666,652,"It's tempting, but they have the same idea in mind."
4454,7799,5,18,129,152,1.1842105263157894,0.03782728980865462,652,"Ever since the recession, Brian and Lisa have struggled to keep up with the Joneses."
5854,7799,3,22,127,152,1.1842105263157894,0.03544893655367666,652,"Remember, what happens on Sweet Tooth Island stays on Sweet Tooth Island."
9726,7799,4,20,128,152,1.1842105263157894,0.03665740687128959,652,Could be the good ship Lollipop.
8064,7805,4,22,137,163,1.1840490797546013,0.03507089562210378,652,"When a New Yorker gets stranded: ""You think that's gluten free?"""
1142,7805,4,22,137,163,1.1840490797546013,0.03507089562210378,652,I used to play that game whenI was young.
4864,7805,6,18,139,163,1.1840490797546013,0.037167841527513526,652,Too saccharin.
7781,7805,5,20,138,163,1.1840490797546013,0.03613458290579025,652,"Don’t go there - coconut oil isn’t the problem, sugar is."
133,7809,3,17,105,125,1.184,0.0399741852183502,652,"Nah, I'm on the paleo diet."
2149,7809,3,17,105,125,1.184,0.0399741852183502,652,So what good is it if you don't have a scale?
8146,7809,3,17,105,125,1.184,0.0399741852183502,652,"“The last 10 pounds aren’t tough enough?”

Kevin Collins
Cleveland, Ohio"
9497,7809,2,19,104,125,1.184,0.038326273309656024,652,I was hoping for quiche !
9424,7813,4,17,115,136,1.1838235294117647,0.03933295375128817,652,I picked the wrong week to start a low carb diet.
7754,7813,3,19,114,136,1.1838235294117647,0.03792293223008126,652,It could be worse. Last year I was stranded on The Big Rock Candy Mountain.
2345,7813,3,19,114,136,1.1838235294117647,0.03792293223008126,652,Grab a cupcake as it goes by.
3864,7813,5,15,116,136,1.1838235294117647,0.04069414838370024,652,"Dude, don't you think you're taking this Keto thing a little far?"
897,7813,3,19,114,136,1.1838235294117647,0.03792293223008126,652,"Wayne Thibaud. The artist. Oh, let's just forget about it."
5766,7813,4,17,115,136,1.1838235294117647,0.03933295375128817,652,If only they had cough drops.
9370,7819,6,15,126,147,1.183673469387755,0.039825834794374376,652,Indulgence comes with responsibility.
7164,7819,5,17,125,147,1.183673469387755,0.03863818263005194,652,"Bro, it's a scam! Have you seriously forgotten already how we ended up HERE for Fyre Festival?"
6076,7819,3,21,123,147,1.183673469387755,0.036145998903366075,652,"Brad, nothing tastes better than a summer bod."
7954,7819,7,13,127,147,1.183673469387755,0.04097908097047021,652,Let's hope the first course is not bouillabesse
2070,7819,3,21,123,147,1.183673469387755,0.036145998903366075,652,Starving people normally wish for food but I’m a dessert guy!
1849,7819,2,23,122,147,1.183673469387755,0.03483310604305319,652,"Everybody warned me about Atkins island, but I didn't listen."
1515,7819,4,19,124,147,1.183673469387755,0.03741284801826365,652,I like our empire better!  Primitive...yes but a fine existential model for green living!
3943,7819,5,17,125,147,1.183673469387755,0.03863818263005194,652,Castaway 2
927,7827,4,21,133,158,1.1835443037974684,0.03573511036713668,652,"And does your fantasy also include Kenny Rogers singing ""Islands in the Stream""?"
7008,7827,4,21,133,158,1.1835443037974684,0.03573511036713668,652,I wish I had the app for that.
9327,7827,5,19,134,158,1.1835443037974684,0.03684594642609804,652,Millennial Candyland
7922,7830,5,14,112,131,1.183206106870229,0.04169278734323597,652,At least we're gluten-free and can't eat most of that stuff anyway.
8236,7830,4,16,111,131,1.183206106870229,0.040259765329072605,652,"Ok,if we call that one Sugar Island, what should we call ours?"
5050,7830,2,20,109,131,1.183206106870229,0.03722860567036315,652,I guess I picked the wrong week to go Keto.
4718,7830,4,16,111,131,1.183206106870229,0.040259765329072605,652,"Go for it dude, but I'm sticking to my no junk food diet."
4735,7830,3,18,110,131,1.183206106870229,0.03877381709679479,652,It's incredible how sea level rise has impacted even the Big Rock Candy Mountain.
3266,7830,2,20,109,131,1.183206106870229,0.03722860567036315,652,I hope that island is gluten-free.
1248,7830,3,18,110,131,1.183206106870229,0.03877381709679479,652,"I know it's tempting, but there's a gluten-free vegan restaurant just 2 days away."
499,7837,1,24,117,142,1.1830985915492958,0.03406897513006314,652,"Dude, imagine the rush if we hold off till tomorrow."""
5761,7837,3,20,119,142,1.1830985915492958,0.036884621567083394,652,At the time we were very lucky to have bought this lot from the developer
5902,7837,4,18,120,142,1.1830985915492958,0.03821472790710408,652,Lucky us! Marooned in the flood waters of Big Rock Candy Mountain!
7172,7837,3,20,119,142,1.1830985915492958,0.036884621567083394,652,Don't you know any other songs than from Willy Wonka?
7454,7837,3,20,119,142,1.1830985915492958,0.036884621567083394,652,At least our dentists will be happy.
8510,7837,6,14,122,142,1.1830985915492958,0.04074488520965659,652,"I'm diabetic, anyway."
6872,7843,2,24,127,153,1.1830065359477124,0.03399486557572878,652,"I would swim over there, but I just started the Daniel fast."
5470,7843,5,18,130,153,1.1830065359477124,0.037598521533810096,652,I’m told that too much sugar is not good for you
4635,7843,3,22,128,153,1.1830065359477124,0.035237057163125494,652,..and I was planning to start my diet tomrrow... meanwhile I will go for a swim.
1639,7843,3,22,128,153,1.1830065359477124,0.035237057163125494,652,We should've milked the cow instead of eating her.
841,7843,3,22,128,153,1.1830065359477124,0.035237057163125494,652,I'm still glad we went paleo.
3877,7848,1,28,135,164,1.1829268292682926,0.031492498508225074,652,Don't bother. It's a mirage. We all see it.
901,7849,4,13,98,115,1.182608695652174,0.043812597054545245,652,"From here, you can tell when the president is vacationing."
2597,7849,2,17,96,115,1.182608695652174,0.04018000818902986,652,I’m so glad I’ve given up sugar.
6560,7849,2,17,96,115,1.182608695652174,0.04018000818902986,652,I really wish I had my watercolor kit right now!
6860,7849,2,17,96,115,1.182608695652174,0.04018000818902986,652,The swim was tough but my figure is worth the effort!
9637,7853,3,17,106,126,1.1825396825396826,0.03968253968253967,652,"Not for me, thanks. I’d never be able to look my doctor in the eye again."
7333,7853,3,17,106,126,1.1825396825396826,0.03968253968253967,652,"I’m doing Whole30. All you, buddy."
6208,7853,1,21,104,126,1.1825396825396826,0.03634192760006109,652,You and your darn Candyland.My message asked for Monopoly.
2122,7853,2,19,105,126,1.1825396825396826,0.03804891363327222,652,You'll regret eating all that trans fat later.
3641,7853,5,13,108,126,1.1825396825396826,0.04276297709028909,652,"Stop looking at it Bob, we agreed we were going paleo this year. And before you ask, No, you can not have a cheat day."
1596,7853,2,19,105,126,1.1825396825396826,0.03804891363327222,652,1. There is a witch. 2. Leonard has never returned our calls and 3. No toothpaste.
4372,7853,2,19,105,126,1.1825396825396826,0.03804891363327222,652,Diabetes is my biggest concern now that the shark has gone.
1438,7860,5,15,117,137,1.1824817518248176,0.040418296563569614,652,It's worse than the desert! We'll never reach the food and can't even drink the water.
1682,7860,3,19,115,137,1.1824817518248176,0.03766900958598611,652,"Just when you start your no sugar diet."""
1936,7860,2,21,114,137,1.1824817518248176,0.03621618527997308,652,"well, the GRASS may not be greener..."
1977,7860,5,15,117,137,1.1824817518248176,0.040418296563569614,652,"Keto diet or not, I’m tempted."
4606,7860,2,21,114,137,1.1824817518248176,0.03621618527997308,652,wouldn't you know...right when I started a low sugar diet
5075,7860,4,17,116,137,1.1824817518248176,0.03906784470821097,652,"No, we cannot. It's a private island that belongs to Trump. He was a presidential candidate when my ship went down. What a joke."
6252,7860,5,15,117,137,1.1824817518248176,0.040418296563569614,652,My dentist is gonna kill me.
7894,7860,3,19,115,137,1.1824817518248176,0.03766900958598611,652,"I heard some kids try to swim there, but the fish ate their breadcrumbs"
8748,7860,2,21,114,137,1.1824817518248176,0.03621618527997308,652,"Even if I could swim, I’d probably gain 300 pounds."
7417,7869,4,19,125,148,1.1824324324324325,0.037179916867222204,652,I'm in the mood for Brussels sprouts.
8373,7869,3,21,124,148,1.1824324324324325,0.03592238236665713,652,Even King Candy needs an offshore account
8252,7869,6,15,127,148,1.1824324324324325,0.03957528957528957,652,"No, you go ahead. I've got celiac."
6719,7869,5,17,126,148,1.1824324324324325,0.03839628734149682,652,Too bad I gave up eating processed sugar.
931,7869,4,19,125,148,1.1824324324324325,0.037179916867222204,652,"Next time ask Suri to spell check your "" Genie request ""what you would like do and where to take me after Valentines dinner"
2757,7869,3,21,124,148,1.1824324324324325,0.03592238236665713,652,Doesn't it look sweet?
1882,7869,5,17,126,148,1.1824324324324325,0.03839628734149682,652,Gotta be a dame behind this
1068,7869,4,19,125,148,1.1824324324324325,0.037179916867222204,652,"Take my word for it, it's a mirage...I know"
2941,7869,2,23,123,148,1.1824324324324325,0.034619198308728706,652,Candy Land is a well known mirage around here.
876,7869,3,21,124,148,1.1824324324324325,0.03592238236665713,652,"Yes, but  how will we pay the dental bills?"
382,7879,2,25,132,159,1.1823899371069182,0.033212118485010475,652,"Go ahead, just don’t complain to me when your tum tum is grumbling and you’ve spoiled your dinner."
4132,7879,3,23,133,159,1.1823899371069182,0.03438977042904448,652,Too bad I can't have gluten.
4525,7879,3,23,133,159,1.1823899371069182,0.03438977042904448,652,"It's okay, I'm off sugar anyway"
5087,7879,6,17,136,159,1.1823899371069182,0.03770266300757025,652,"Even if I could swim over there, I'm on Keto."
9226,7879,3,23,133,159,1.1823899371069182,0.03438977042904448,652,Only six more days until we’re off the Whole 30!
993,7884,6,19,145,170,1.1823529411764706,0.036054575768074866,652,"Yeah, but it’s all fattening stuff."
6602,7884,1,29,140,170,1.1823529411764706,0.030852296712634904,652,Maybe this time it isn't a mirage...
6617,7886,4,20,130,154,1.1818181818181819,0.03621904876770889,652,Thank goodness I've given up sugar!
5658,7886,8,14,143,165,1.1818181818181819,0.03870857561979608,652,I knew Frye Festival II was a bad idea
6083,7886,3,22,129,154,1.1818181818181819,0.0350276612952401,652,I hear that the cupcakes are gluten-free.
6124,7886,5,14,113,132,1.1818181818181819,0.04139899935510188,652,Why couldn't we get stranded on that island?
5524,7886,4,16,112,132,1.1818181818181819,0.039977702867971206,652,"Though this high-fiber diet has done wonders for my bowels, I am tempted."
6483,7886,3,22,129,154,1.1818181818181819,0.0350276612952401,652,Forget the fresh coconut juice! It's time to change our diet.
6523,7886,3,20,120,143,1.1818181818181819,0.03664815316682569,652,"That's gotta be ""Paradise Island""."
6853,7886,5,18,131,154,1.1818181818181819,0.03737247558646991,652,"I wish the guy that cursed us was dyslexic, too"
8347,7886,5,20,140,165,1.1818181818181819,0.035729880163405225,652,So are you coming or still sticking to your keto nonsense?
6888,7886,5,16,122,143,1.1818181818181819,0.03924376693206433,652,Probably a good idea we passed on the Greek Island of Diabetes
7051,7886,3,22,129,154,1.1818181818181819,0.0350276612952401,652,Wish I hadn’t just gone low carb.
7814,7886,4,16,112,132,1.1818181818181819,0.039977702867971206,652,"Well  ... maybe gluten and sugar aren't THAT bad, after all."
8208,7886,1,24,118,143,1.1818181818181819,0.033854113753871116,652,"Mirage or no mirage, sweets were never “my thing!”"
8547,7886,4,20,130,154,1.1818181818181819,0.03621904876770889,652,Finally a diet that keeps the weight off.
9610,7886,5,16,122,143,1.1818181818181819,0.03924376693206433,652,We really picked the wrong week to start our keto diet.
9966,7886,2,20,110,132,1.1818181818181819,0.03697155507402858,652,The swim thru is around the back.
5089,7886,4,20,130,154,1.1818181818181819,0.03621904876770889,652,They're inflatables. It's tempting.
6875,7886,5,14,113,132,1.1818181818181819,0.04139899935510188,652,My mom told me we couldn’t have sweets on this trip.
4871,7886,2,20,110,132,1.1818181818181819,0.03697155507402858,652,"When I said I was bored, I was thinking chess not Candyland."
6097,7886,4,20,130,154,1.1818181818181819,0.03621904876770889,652,"Trust me, the grass is always greener on the other side."
4749,7886,2,22,119,143,1.1818181818181819,0.03527880488763162,652,"I don't think it really matters if there's an extra 's' when we're 2,000 miles from anywhere. Besides, it's a mirage."
488,7886,4,18,121,143,1.1818181818181819,0.03796814700217342,652,Is it worth it without dental coverage?
868,7886,3,18,111,132,1.1818181818181819,0.038503977789260437,652,"""Most people live on a lonely island
Lost in the middle of a foggy sea
Most people long for another island
One where they know they would like to be..."" Sing it, woman!"
945,7886,3,18,111,132,1.1818181818181819,0.038503977789260437,652,My wife says that carbs will be the death of me.
1511,7886,5,14,113,132,1.1818181818181819,0.04139899935510188,652,"'""We could swim over there if you like peppermint."""
2010,7886,5,18,131,154,1.1818181818181819,0.03737247558646991,652,Any food for thoughts?
2273,7886,4,16,112,132,1.1818181818181819,0.039977702867971206,652,"The candy man can, cause he mixes it with love"
2421,7886,4,14,103,121,1.1818181818181819,0.04231587892051194,652,My endocrinologist would have my head!
2443,7886,4,18,121,143,1.1818181818181819,0.03796814700217342,652,"Nah, neither one of us is a dentist"
2473,7886,3,22,129,154,1.1818181818181819,0.0350276612952401,652,Is it just me or do you also see Candyland?
4847,7886,4,18,121,143,1.1818181818181819,0.03796814700217342,652,It's called a mirage
2881,7886,3,22,129,154,1.1818181818181819,0.0350276612952401,652,How long have you been diabetic?
2898,7886,2,24,128,154,1.1818181818181819,0.0337942986018418,652,"Hey, no cavities."
3029,7886,6,14,123,143,1.1818181818181819,0.04047920823407643,652,"Just our luck, and I don't even like coconut."
3395,7886,3,16,102,121,1.1818181818181819,0.040655781409087086,652,Maybe we'll start that Keto diet next week
478,7886,5,14,113,132,1.1818181818181819,0.04139899935510188,652,Oh snap. I forgot Valentine's Day.
3631,7886,4,18,121,143,1.1818181818181819,0.03796814700217342,652,"The genie must have heard "" Sandyland"""
3928,7886,5,16,122,143,1.1818181818181819,0.03924376693206433,652,I dunno. Doesn’t look Keto-friendly.
4469,7886,3,22,129,154,1.1818181818181819,0.0350276612952401,652,I heard these are popping up all over.
4557,7886,2,22,119,143,1.1818181818181819,0.03527880488763162,652,It’s always greener on the other side!
2740,7886,6,14,123,143,1.1818181818181819,0.04047920823407643,652,Don't buy it for a minute. It's Shamu that shape shifting shark !!
8854,7927,3,23,134,160,1.18125,0.03419316544125568,652,They call it Pardise Regained if you can get there.
8737,7927,4,21,135,160,1.18125,0.0353240557565852,652,It’s a Mirage
3691,7927,5,19,136,160,1.18125,0.036419847161892345,652,Most people only know the first verse to “The Big Rock Candy Mountain”.
4796,7927,4,21,135,160,1.18125,0.0353240557565852,652,"Go figure, we didn't get to the dessert-Ted island"
792,7927,4,21,135,160,1.18125,0.0353240557565852,652,"I can swim, but I’m gluten intolerant. So I think I’ll pass."
580,7927,3,23,134,160,1.18125,0.03419316544125568,652,I should have accepted the Candy Crush request.
845,7927,4,21,135,160,1.18125,0.0353240557565852,652,"I texted The Good Ship Lolly Pop, they will take us there for $20 each."
198,7927,4,21,135,160,1.18125,0.0353240557565852,652,Candy land is calling.
2157,7935,1,25,123,149,1.1812080536912752,0.03306366849063164,652,Talk to me after you cover it in chocolate and add a miracle or two.
2699,7935,4,19,126,149,1.1812080536912752,0.03694983543616943,652,"I’d be careful, it might be a booby trap."
3665,7935,5,17,127,149,1.1812080536912752,0.038157372293269966,652,"You had to say you hated The Good Ship Lollipop, didn’t you?"
3694,7935,4,19,126,149,1.1812080536912752,0.03694983543616943,652,"I dont know about you, but after a month on the ""Stranded on a Desert Island Diet"", I've lost my craving for sweets."
4076,7935,3,21,125,149,1.1812080536912752,0.03570147920174733,652,"Steady, Al. We're just a few more weeks from our optimum body mass index."
5602,7935,1,25,123,149,1.1812080536912752,0.03306366849063164,652,My doc would be very very disappointed in me
6268,7935,4,19,126,149,1.1812080536912752,0.03694983543616943,652,",
“It must be your hallucination because I’m fructose intolerant.”"
7531,7935,3,21,125,149,1.1812080536912752,0.03570147920174733,652,I hear she's some sweet trip to the candy shop.
9067,7935,3,21,125,149,1.1812080536912752,0.03570147920174733,652,I told you that we should not have listened to our travel agent.
9567,7935,1,25,123,149,1.1812080536912752,0.03306366849063164,652,I think God is trying to buy us back again.
9727,7935,3,21,125,149,1.1812080536912752,0.03570147920174733,652,Tempting...but not worth the calories.
6402,7946,3,19,116,138,1.181159420289855,0.03741842178725129,652,Is the mirage at least fat-free?
5507,7946,4,17,117,138,1.181159420289855,0.03880624707241912,652,The candy canes.  I'm gluten-free.
2883,7946,3,19,116,138,1.181159420289855,0.03741842178725129,652,Careful - I heard that a dentist lives on the other side.
4937,7946,2,21,115,138,1.181159420289855,0.03597710058150387,652,Too bad I just started my sugar-free diet.
1636,7950,3,17,107,127,1.1811023622047243,0.039395067685066495,652,You know it's just a mirage.
3074,7950,3,17,107,127,1.1811023622047243,0.039395067685066495,652,"Yeah but we have to play 1,000 games of Candyland to get there"
3210,7950,3,17,107,127,1.1811023622047243,0.039395067685066495,652,it's too fattening
4174,7950,3,17,107,127,1.1811023622047243,0.039395067685066495,652,The polar ice caps melted and no more Big Rock Candy Mountain.”
5434,7950,2,19,106,127,1.1811023622047243,0.03777548121411677,652,"Can't say it's bothers me, I never really had a sweet tooth"
4759,7955,4,22,140,166,1.180722891566265,0.03448802155817515,652,It's my latest work of conceptual art.
9898,7956,3,22,130,155,1.1806451612903226,0.03482070629799701,652,I just wish we would have wordplayed it first.
9367,7956,4,20,131,155,1.1806451612903226,0.03600373269055227,652,Too bad they’re not gluten free.
7757,7956,0,28,127,155,1.1806451612903226,0.031001936155783016,652,I am tired of the same old stuff on Candy island
7457,7956,4,20,131,155,1.1806451612903226,0.03600373269055227,652,I’m sure they have insulin there too!
5652,7956,5,18,132,155,1.1806451612903226,0.03714910427202945,652,Carbs to the rescue!
4164,7956,4,20,131,155,1.1806451612903226,0.03600373269055227,652,I wouldn't do it.  Sugar is so bad for you.
3706,7956,3,22,130,155,1.1806451612903226,0.03482070629799701,652,"Excellent! With this new diet, it looks like we’re entering the Candyland Dream Phase. This is progress!"
3683,7956,4,20,131,155,1.1806451612903226,0.03600373269055227,652,No thanks - I'm on a low-carb diet
3263,7956,3,22,130,155,1.1806451612903226,0.03482070629799701,652,So near yet so far away.
3002,7956,3,22,130,155,1.1806451612903226,0.03482070629799701,652,It’s all yours. I am a gluten-free diabetic.
1828,7956,0,28,127,155,1.1806451612903226,0.031001936155783016,652,"Me, I gave up sweets when I got here."
1277,7956,2,24,129,155,1.1806451612903226,0.03359604748374419,652,I could really go for some of my favorite candied insects right about now.
4117,7956,4,20,131,155,1.1806451612903226,0.03600373269055227,652,"I agree, its chef Janine’s work.  I hear she’s opened her own place."
6342,7969,2,22,120,144,1.1805555555555556,0.035055702397312434,652,"So, I was reading palm hearts are in season now."
7960,7969,4,18,122,144,1.1805555555555556,0.03772469303810345,652,"Stay optimistic, we will be getting coconuts soon"
7276,7969,3,20,121,144,1.1805555555555556,0.036414658692538,652,Too bad my wife just signed me up for whole 30
6935,7969,3,20,121,144,1.1805555555555556,0.036414658692538,652,I'm glad we're here. I could never keep my diet over there.
4075,7969,2,22,120,144,1.1805555555555556,0.035055702397312434,652,And I thought candy crush was hard
302,7969,3,20,121,144,1.1805555555555556,0.036414658692538,652,"It sucks that we're both diabetic."""
3196,7969,4,18,122,144,1.1805555555555556,0.03772469303810345,652,"Yes, I am now sorry I gave up sugar."
1047,7969,3,20,121,144,1.1805555555555556,0.036414658692538,652,Forget it! It isn't gluten free....
965,7969,7,12,125,144,1.1805555555555556,0.041406856391115014,652,So close and yet... so far.
885,7969,4,18,122,144,1.1805555555555556,0.03772469303810345,652,"Yeah, but it's nothing but carbs."
3492,7969,6,14,124,144,1.1805555555555556,0.04021694492461263,652,They'll eat us if we get too close
2206,7980,3,18,112,133,1.1804511278195489,0.038237822407240246,652,Well if that is Christmas Island the Turkey dinner and gifts will be on the other side.
3035,7980,3,18,112,133,1.1804511278195489,0.038237822407240246,652,No thanks. I’m on a low carb diet.
4506,7980,2,20,111,133,1.1804511278195489,0.03671797782959866,652,Can you imagine what that would do to your blood sugar?!
6526,7980,2,20,111,133,1.1804511278195489,0.03671797782959866,652,"Being celiac really sucks, man..."
7767,7980,3,18,112,133,1.1804511278195489,0.038237822407240246,652,"No thanks go ahead, doing low carbs this week"
8585,7980,1,22,110,133,1.1804511278195489,0.03513244553603055,652,What a shame. I gave up sweets for Lent.
485,7986,1,20,101,122,1.180327868852459,0.036838173157401725,652,Careful...its a giant candy angler fish!
4263,7987,4,23,145,172,1.180232558139535,0.03370498176107748,652,Ate capitalism
9218,7988,4,21,136,161,1.1801242236024845,0.03512201309968182,652,That
3818,7988,3,23,135,161,1.1801242236024845,0.03399876545731369,652,That's no mirage. It's a sugar shark.
226,7988,5,19,137,161,1.1801242236024845,0.036210434348775994,652,I picked a fine time to give up sugar.
4459,7988,4,21,136,161,1.1801242236024845,0.03512201309968182,652,"My dear guests! I am Mr. Roarke, your host. Welcome... to 'Trans-Fat-Free Island'!"
1641,7992,3,21,126,150,1.18,0.03548324115247314,652,Can you swim through Syrup?
9791,7992,5,17,128,150,1.18,0.03792138341240353,652,You were right ... ordering the fresh fruit medley would have absurd.
8649,7992,3,21,126,150,1.18,0.03548324115247314,652,Where's the big rock?
6426,7992,5,17,128,150,1.18,0.03792138341240353,652,"A dessert island next to our desert island, and I've got diabetes!"
6160,7992,4,19,127,150,1.18,0.03672255248886627,652,I'd swim over but I'm on a diet.
8810,7992,4,19,127,150,1.18,0.03672255248886627,652,"Can't, I'm on a Carb-ibbean free diet."
5137,7992,2,23,125,150,1.18,0.034199048876709826,652,"Nah, I’m doing Keto."
3094,7992,6,15,129,150,1.18,0.039083459142244426,652,I don't understand it.  We've been here a year and that island just popped up today.
2294,7992,3,21,126,150,1.18,0.03548324115247314,652,"No, the doctor says I have to lower my A1C level."
5371,7992,3,21,126,150,1.18,0.03548324115247314,652,It'll just give us headaches
851,7992,3,21,126,150,1.18,0.03548324115247314,652,"It’s tempting, but it’s not for me."
1180,8003,2,21,116,139,1.1798561151079137,0.03574110524631316,652,"I’d swim over there, but those Oompa Loompas scare me to death!"
4517,8003,4,17,118,139,1.1798561151079137,0.03854809247341117,652,"I mean I love breasts, but can you imagine..."
4678,8003,0,25,114,139,1.1798561151079137,0.03269400212756783,652,You go ahead--I'm trying to avoid sugar.
7099,8003,1,23,115,139,1.1798561151079137,0.03425145529277146,652,You bet’cha there is going to be a price to pay!
7819,8003,3,19,117,139,1.1798561151079137,0.03717110462151141,652,Only if we had a wall
9071,8008,2,19,107,128,1.1796875,0.03750589479587144,652,At least it would be a sweet rescue.
1710,8008,3,17,108,128,1.1796875,0.039111681637356996,652,I shall call you 'Man Cheat-day'.
7658,8008,1,21,106,128,1.1796875,0.035828210231268656,652,"Sure, but will we be able to make it to Dentist’s Island afterwards?"
4945,8011,4,22,141,167,1.1796407185628743,0.03429796109134218,652,Sweet Dreams
1130,8012,0,28,128,156,1.1794871794871795,0.03082432343782198,652,"It’s just a mirage, I think."
2802,8012,3,15,99,117,1.1794871794871795,0.041372319495311546,652,. . .ohhh who can take an island. ..!
8444,8012,4,20,132,156,1.1794871794871795,0.03579093263879318,652,"I'd love to, but I'm doing Whole 30."
2718,8015,2,22,121,145,1.1793103448275861,0.034835361978601695,652,"It's The Big Rock Candy Island!"""
2938,8015,4,18,123,145,1.1793103448275861,0.03748430772211569,652,"I ordered you the Macy’s Thanksgiving Day Parade 
on Amazon Prime."
3809,8015,2,22,121,145,1.1793103448275861,0.034835361978601695,652,don't fall for it Humphrey... remember last time it was just fool's gold
4961,8015,4,18,123,145,1.1793103448275861,0.03748430772211569,652,I didn't spend six years at Giant Candy Cane University to be stared at by two men on an island.
5200,8015,4,18,123,145,1.1793103448275861,0.03748430772211569,652,"Sorry, there wasn't an option for a sugar-free mirage."
9905,8015,4,18,123,145,1.1793103448275861,0.03748430772211569,652,"If you could bring 3 things on a deserted island, what would they be?"
7544,8021,5,21,147,173,1.1791907514450868,0.03451363854533352,652,"I told you it would be desserted.""
""Yeah, but I thought you said it was a rhetorical question!"
7012,8022,3,18,113,134,1.1791044776119404,0.037975277188599596,652,I wish Mikie was here.
5461,8022,3,18,113,134,1.1791044776119404,0.037975277188599596,652,My parents don't allow me to eat sugar...
3343,8022,3,18,113,134,1.1791044776119404,0.037975277188599596,652,"Trust me, it's a mirage!"
4285,8022,3,18,113,134,1.1791044776119404,0.037975277188599596,652,"Sorry, buddy, it's my fault. This is what I get for wishing I could resist junk-food!"
2698,8022,1,22,111,134,1.1791044776119404,0.03489527154619774,652,"You know, sugar isn't on our diet."
3296,8022,3,18,113,134,1.1791044776119404,0.037975277188599596,652,Are you sure you see nude maidens over there?
645,8022,4,16,114,134,1.1791044776119404,0.03942515095957175,652,Just remember; these are shark filled waters!
3396,8022,2,20,112,134,1.1791044776119404,0.036467805348237306,652,I'm going to ask Santa for those big candy canes.
2314,8022,2,20,112,134,1.1791044776119404,0.036467805348237306,652,But empty calories don't really satisfy you.
2652,8031,6,17,139,162,1.1790123456790123,0.03705300885072394,652,"I don't man, it looks pretty sweet to me. I say we go for it."
9204,8031,2,25,135,162,1.1790123456790123,0.03265272608046261,652,I would rate it somewhere between hula dancers and cannibals.
9679,8033,3,16,104,123,1.1788617886178863,0.040046155440119593,652,"The carbs, though."
1340,8034,3,21,127,151,1.1788079470198676,0.03526762107468701,652,Number one: it's not good for us.  Number two: those sneaky sharks.
1982,8034,1,25,125,151,1.1788079470198676,0.03266809842593541,652,If only I was not on this low carb sugar free diet.
6931,8034,5,17,129,151,1.1788079470198676,0.037688267906190794,652,You're a diabetic? ... No s**t?
7517,8034,1,25,125,151,1.1788079470198676,0.03266809842593541,652,Let's name it.  How about Wonka Island?
4990,8038,4,17,119,140,1.1785714285714286,0.03829331427382206,652,Too bad that I'm on a no carb diet!
9771,8038,4,17,119,140,1.1785714285714286,0.03829331427382206,652,"I know, but sugar's bad for you."
9291,8038,4,17,119,140,1.1785714285714286,0.03829331427382206,652,Boredom really is not far from bliss.
8665,8038,3,24,141,168,1.1785714285714286,0.0330484999418314,652,"I wonder why they call it ""Poison Island""?"
7622,8038,4,17,119,140,1.1785714285714286,0.03829331427382206,652,I’ll take the Candy Cane
7481,8038,5,15,120,140,1.1785714285714286,0.03961253388755271,652,"This really challenges validity of the paleo diet theory, doesn't it?"
6419,8038,4,17,119,140,1.1785714285714286,0.03829331427382206,652,"We may be on a desert island, but at least we're an ocean away from diabetes."
6148,8038,2,21,117,140,1.1785714285714286,0.03550814092903328,652,"Empty calories? We're marooned, no morons."""
4485,8038,4,17,119,140,1.1785714285714286,0.03829331427382206,652,There goes my Paleo diet
3929,8038,3,19,118,140,1.1785714285714286,0.03692699547966089,652,"Hey Hansel?"" ""Yes Gretyl?"" ""What is that over there?"
3529,8038,4,17,119,140,1.1785714285714286,0.03829331427382206,652,Aren't you glad you swore off carbs?
3369,8038,3,19,118,140,1.1785714285714286,0.03692699547966089,652,The mirages don't know I'm diabetic.
3168,8038,2,21,117,140,1.1785714285714286,0.03550814092903328,652,"They call it the island of  temptation but what's tempting about high blood sugar?"" - Chris Knight, London U"
1551,8038,0,20,92,112,1.1785714285714286,0.03635209121577807,652,What do you think the vegan options are like?
1494,8038,1,23,116,140,1.1785714285714286,0.03403017997773859,652,Cheat Island really is a lot closer than it looks.
1231,8038,4,17,119,140,1.1785714285714286,0.03829331427382206,652,"I knew we had a plastic problem, but this is getting ridiculous."
4588,8038,3,19,118,140,1.1785714285714286,0.03692699547966089,652,"When I raised Cain about our situation, I didn't mean the raising of candy canes."
3465,8055,3,22,132,157,1.178343949044586,0.03441395302457576,652,I wouldn’t. You promised Edna you’d be dessert free.
7978,8055,5,18,134,157,1.178343949044586,0.036710200182427793,652,Plane carrying Hall & Oats goes down somewhere in the confectionery latitudes.
9093,8055,5,18,134,157,1.178343949044586,0.036710200182427793,652,Bummer being diabetic!
9897,8055,4,20,133,157,1.178343949044586,0.035580605392626675,652,"Milo, we leaped to the island of conclusions!"
9911,8055,4,20,133,157,1.178343949044586,0.035580605392626675,652,The question is: would you be willing to trade a palm tress for  a peppermint stick?
6651,8060,1,21,107,129,1.178294573643411,0.035576666183499646,652,"Relax under a palm tree, with unparalleled views sounded much better before we started that sugar detox!"
5382,8060,2,19,108,129,1.178294573643411,0.037240075291813245,652,"I’m good... I was never really a sweets kinda guy, you know?"
6960,8060,4,15,110,129,1.178294573643411,0.04036175503809792,652,A wall sounds like a great idea.
6902,8060,1,21,107,129,1.178294573643411,0.035576666183499646,652,I’m not swimming over there unless I know it’s vegan.
9106,8060,3,17,109,129,1.178294573643411,0.038832296336267204,652,I prefer the vegetation over there.
4399,8060,4,15,110,129,1.178294573643411,0.04036175503809792,652,"Man, did I pick the wrong week to give up carbs?"
2231,8060,6,11,112,129,1.178294573643411,0.04325874861540642,652,"I would, but I'm diabetic."
850,8060,1,21,107,129,1.178294573643411,0.035576666183499646,652,Too bad you're on the Keto diet.
3256,8060,1,21,107,129,1.178294573643411,0.035576666183499646,652,"It's not a ""good ship"" if it can't serve bacon and eggs for breakfast."
1644,8060,3,17,109,129,1.178294573643411,0.038832296336267204,652,"Boy, what I wouldn't give for a lizard tongue right now."
9104,8070,5,16,125,146,1.178082191780822,0.0384942517371362,652,Your mirages are always a little too sweet for me
8561,8070,2,22,122,146,1.178082191780822,0.03461773364813663,652,"It’s the Great Angler Shark’s lure, thankfully, my diabetes keeps me away."
6541,8070,3,20,123,146,1.178082191780822,0.035956373485418296,652,Never thought I'd be grateful I'm diabetic.
6280,8070,3,20,123,146,1.178082191780822,0.035956373485418296,652,"Next time we travel, remind me to upgrade."
5576,8070,2,22,122,146,1.178082191780822,0.03461773364813663,652,Those cruise excursions certainly break up the boring view!
4746,8070,5,16,125,146,1.178082191780822,0.0384942517371362,652,"Actually, sea mirages are as common as desert mirages."
4325,8070,1,24,121,146,1.178082191780822,0.033225203861583306,652,"Really makes you rethink your commitment to keto, doesn't it?"
8679,8070,3,20,123,146,1.178082191780822,0.035956373485418296,652,I'm having the craziest hallucination Queen Elizabeth!
3860,8070,5,16,125,146,1.178082191780822,0.0384942517371362,652,Swim for it? What's the point. It's not gluten free.
3175,8070,3,20,123,146,1.178082191780822,0.035956373485418296,652,I'm doing Paleo - too many carbs
2748,8070,4,18,124,146,1.178082191780822,0.03724693417601578,652,"I agree it looks enticing, but you should know, my dentistry license is not good here."
2739,8070,4,18,124,146,1.178082191780822,0.03724693417601578,652,So tempting...but how about our extreme diet???
2130,8070,4,18,124,146,1.178082191780822,0.03724693417601578,652,"So, where do you wanna go after we leave Whole30 island?"
1064,8070,3,20,123,146,1.178082191780822,0.035956373485418296,652,Yes it looks good but your doctor says no sugar
1055,8070,3,20,123,146,1.178082191780822,0.035956373485418296,652,I guess the cartographer forgot that ‘desert’ has one ‘s.’
3936,8070,3,20,123,146,1.178082191780822,0.035956373485418296,652,I'm watching my calories.
5947,8086,1,27,135,163,1.177914110429448,0.03128232830425021,652,...and the yacht to get there will arrive tomorrow morning.
8710,8087,4,16,115,135,1.1777777777777778,0.039154506304142495,652,If only we hadn’t just committed to Paleo.
8691,8087,5,22,153,180,1.1777777777777778,0.03357043750218141,652,"You go ahead, I am on a gluten free diet."
8302,8087,1,22,112,135,1.1777777777777778,0.03466122336820361,652,That's exactly why I still have these pearly whites.
8115,8087,3,18,114,135,1.1777777777777778,0.037716270287603874,652,"Sure, inflatables are easy to store, but their Con Ed bill must be sky-high."
7821,8087,3,18,114,135,1.1777777777777778,0.037716270287603874,652,"I don’t know, my dentist says I need to lay off the sweets."
7623,8087,2,20,113,135,1.1777777777777778,0.03622097078895108,652,Diet island.
5308,8087,2,20,113,135,1.1777777777777778,0.03622097078895108,652,"Unfortunately, my guess is they were made in a facility that also produces salt."
6934,8087,2,20,113,135,1.1777777777777778,0.03622097078895108,652,I’m glad we washed up on a gluten-free island.
4806,8087,4,16,115,135,1.1777777777777778,0.039154506304142495,652,I can't believe we only chose to bring a book.
1235,8087,2,20,113,135,1.1777777777777778,0.03622097078895108,652,"Well, I like coconut on my cupcakes."
536,8087,6,12,117,135,1.1777777777777778,0.0418830753759585,652,You know what fuck that island.
7037,8087,4,16,115,135,1.1777777777777778,0.039154506304142495,652,I thought getting away from carbs would be the big plus of being marooned
7374,8099,5,17,130,152,1.1776315789473684,0.037457974225273,652,But are they gluten and dairy free?
9252,8099,2,23,127,152,1.1776315789473684,0.033788825162162535,652,This is what being on a keto diet means.
7558,8099,4,19,129,152,1.1776315789473684,0.03627618305886853,652,Curse them fine hallucinations!
9929,8099,4,19,129,152,1.1776315789473684,0.03627618305886853,652,it’s not good for our health anyway...
6822,8099,3,21,128,152,1.1776315789473684,0.035054572905398006,652,"Just hope whoever baked  that doesn’t come back on Atkins, looking for protein."
6349,8099,7,13,132,152,1.1776315789473684,0.03971620053004276,652,"Interesting plan, but I'm not sure the Good Ship Lollipop is real."
6047,8099,4,19,129,152,1.1776315789473684,0.03627618305886853,652,"…but it’s a cupcake!”, she exclaimed. 
“A true countryman never leaves his comfort zone, Madeleine."
1147,8099,3,21,128,152,1.1776315789473684,0.035054572905398006,652,Do you think the hens lay soft boiled eggs?
6914,8099,3,21,128,152,1.1776315789473684,0.035054572905398006,652,If you want to eat all that refined sugar - go ahead. I'm staying here.
1282,8108,6,18,145,169,1.1775147928994083,0.03594052696246389,652,All those sweets and nothing to wash it down with but saltwater?  No thank you!
4804,8109,4,14,106,124,1.1774193548387097,0.04136471301633127,652,"It looks inviting, but before getting on our flight, my doctor said I needed to start watching my cholesterol."
7853,8109,5,12,107,124,1.1774193548387097,0.042920505897355694,652,"Naw, I don’t have a toothbrush."
9850,8111,5,15,121,141,1.177304964539007,0.03935097565539706,652,"You go ahead, I'm on a Keto diet right now."
9412,8111,3,19,119,141,1.177304964539007,0.03668603330757109,652,I'M not gonna say it...YOU say it.
9290,8111,3,19,119,141,1.177304964539007,0.03668603330757109,652,"I'm off sugar, how about you?"
8673,8111,7,11,123,141,1.177304964539007,0.04184654741097632,652,Your first wish should have been to speak the same language as your wish-granting genie
8596,8111,4,17,120,141,1.177304964539007,0.038041847516096454,652,I bet there's food over there.
9725,8111,3,19,119,141,1.177304964539007,0.03668603330757109,652,The keto diet isn't all it's cracked up to be anyway.
7308,8111,3,19,119,141,1.177304964539007,0.03668603330757109,652,"It's too bad I'm low-carb, eh?"
6973,8111,5,15,121,141,1.177304964539007,0.03935097565539706,652,I would...but it's not Keto.
5575,8111,2,21,118,141,1.177304964539007,0.03527815070621612,652,"Don't even think about it; your cholesterol is high enough

as it is!"
3042,8111,6,13,122,141,1.177304964539007,0.040617932094400996,652,"Do you think it's a mirage, or Mar-A-Lago?"
2633,8111,4,17,120,141,1.177304964539007,0.038041847516096454,652,"What happened to the good ship ""Lollipop""?"
7692,8111,4,17,120,141,1.177304964539007,0.038041847516096454,652,I knew I should have played more Candyland as a kid.
9304,8123,0,28,130,158,1.1772151898734178,0.030475004517281364,652,Shirley Temples island. On the good ship lollipop I’m going
7600,8123,3,22,133,158,1.1772151898734178,0.03421407408623916,652,"Tempting, but I'm on a low carb diet."
6018,8123,2,24,132,158,1.1772151898734178,0.03301480289953606,652,We'll have to talk to Nemo about getting some healthier care packages from the Nautilus.
6912,8123,4,20,134,158,1.1772151898734178,0.035372708698403484,652,"Hansel and Gretel Fan Fiction, Entry #271"
3990,8123,4,20,134,158,1.1772151898734178,0.035372708698403484,652,I wish I'd picked a different month to go low-carb.
1721,8123,4,20,134,158,1.1772151898734178,0.035372708698403484,652,What makes you so sure we're not on Candy Island?
1510,8123,5,18,135,158,1.1772151898734178,0.03649457734712867,652,My stomach tells me to swim to the sweet side.
4155,8123,7,14,137,158,1.1772151898734178,0.03864072315462603,652,You go ahead. I'm on Atkins.
6928,8131,4,12,97,113,1.176991150442478,0.04396241731830613,652,We are so lucky that we started our coconut only diet before our shipwreck.
9689,8132,4,15,111,130,1.176923076923077,0.0400735528508516,652,The say sugar will kill you.
212,8132,2,19,109,130,1.176923076923077,0.03697794571547032,652,This island is one S away from diabetes.
1251,8132,6,11,113,130,1.176923076923077,0.042946604136342645,652,"No, I have zero interest in playing Candyland."
2536,8132,3,17,110,130,1.176923076923077,0.03855682888559604,652,"Don't forget, the grass is always sweeter..."
5363,8132,1,21,108,130,1.176923076923077,0.035328570378086434,652,I don’t know...maybe the candy canes are gluten-free.
5582,8132,3,17,110,130,1.176923076923077,0.03855682888559604,652,Glad we’re not stuck on that island – gluten makes me gassy.
6785,8132,2,19,109,130,1.176923076923077,0.03697794571547032,652,At least we have some shade!
9821,8132,4,15,111,130,1.176923076923077,0.0400735528508516,652,Little did they know it was a whale.
9097,8140,2,22,123,147,1.1768707482993197,0.034402768589717754,652,I'd bring a spoon
9888,8140,6,14,127,147,1.1768707482993197,0.03944999780861696,652,We've waited a loooong time for dessert!
6654,8140,3,20,124,147,1.1768707482993197,0.03573147697413617,652,"On the Good Ship Lollipop
It's a sweet trip to a candy shop
Where bon bons play
On the sunny beach of Peppermint Bay"
8790,8140,5,16,126,147,1.1768707482993197,0.03825067799378633,652,"Just my luck, sugar and empty carbs!"
1699,8140,5,16,126,147,1.1768707482993197,0.03825067799378633,652,"Yeah, but think of the calories?"
350,8140,6,14,127,147,1.1768707482993197,0.03944999780861696,652,I'm keto so I don't think it would be worth the swim.
4389,8140,3,20,124,147,1.1768707482993197,0.03573147697413617,652,"I got tired of playing Candy Land with my daughter every day, so I decided to make it more interesting...Unfortunately they love it even more..."
377,8140,3,20,124,147,1.1768707482993197,0.03573147697413617,652,You see a rescue ship right? Not exactly.
6264,8148,4,21,139,164,1.1768292682926829,0.034529365645152806,652,I always loved playing Candyland.
9884,8149,4,19,130,153,1.1764705882352942,0.03605699996118444,652,Well for sure I'm re-evaluating my paleo diet.
9513,8149,2,20,114,136,1.1764705882352942,0.03597740900528858,652,I won't make the same mistake again.
8799,8149,3,21,129,153,1.1764705882352942,0.03484405163288779,652,But I can’t swim! You dog paddle and get me those cookies.
8456,8149,3,21,129,153,1.1764705882352942,0.03484405163288779,652,"Big Rock Candy Mountain, redux"
7826,8149,3,18,115,136,1.1764705882352942,0.037460731714789794,652,"Look, the Goodship Lollypop is finally here!"
7677,8149,5,17,131,153,1.1764705882352942,0.037230452027961713,652,... And our cholesterol levels would be through the roof.
7473,8149,6,15,132,153,1.1764705882352942,0.03836803187826895,652,"Yeah, that makes sense."
7115,8149,2,20,114,136,1.1764705882352942,0.03597740900528858,652,Are we allowed to have dessert before our main course?
6539,8149,3,18,115,136,1.1764705882352942,0.037460731714789794,652,I'm feeling like it might be time to go off my Keto diet.
6505,8149,2,23,128,153,1.1764705882352942,0.033587328297884106,652,Too bad I am on a low glutton diet. But why don't you go ahead.
4955,8149,2,20,114,136,1.1764705882352942,0.03597740900528858,652,Satan's place. Sand is hotter than Hell. Year round too.
7419,8149,3,18,115,136,1.1764705882352942,0.037460731714789794,652,Man I was thinking of the other kind of des(s)ert
4537,8149,3,18,115,136,1.1764705882352942,0.037460731714789794,652,"so , do you think we should break our diets?"
4862,8149,3,21,129,153,1.1764705882352942,0.03484405163288779,652,I'm so glad to hear that you won't misspell desserted next time.
705,8149,3,21,129,153,1.1764705882352942,0.03484405163288779,652,My sweet tooth is killing me.
1132,8149,4,16,116,136,1.1764705882352942,0.03888751576638827,652,I thought dessert always came after dinner
1689,8149,5,17,131,153,1.1764705882352942,0.037230452027961713,652,No processed palm oil on OUR island.
2208,8149,3,18,115,136,1.1764705882352942,0.037460731714789794,652,I picked the wrong month to give up sweets.
583,8149,3,21,129,153,1.1764705882352942,0.03484405163288779,652,This is nothing. Last year I did Whole30!
2982,8149,4,19,130,153,1.1764705882352942,0.03605699996118444,652,"Don't tell me about your mirage...plus, I'm on a diet!"
3027,8149,2,23,128,153,1.1764705882352942,0.033587328297884106,652,Look on the bright side. This cleanse would be much tougher over there.
4153,8149,1,25,127,153,1.1764705882352942,0.03228171789394645,652,The Good Ship Lollipop is on the way.
2230,8149,5,20,145,170,1.1764705882352942,0.03475631560121543,652,"Actually, I found the lesson on ""ascent"" and ""assent"" at Mt. Everest much more challenging."
1303,8172,5,18,136,159,1.1761006289308176,0.036281448966745344,652,"WOW, the good ship loly pop!"
5858,8172,2,24,133,159,1.1761006289308176,0.03282543299678655,652,"The Good Ship Lollipop, HAH!"
8214,8172,4,20,135,159,1.1761006289308176,0.035167201242443775,652,I'll wait for the savouries.
8289,8172,5,18,136,159,1.1761006289308176,0.036281448966745344,652,Maybe this was a bad time to try Whole 30.
9038,8172,4,20,135,159,1.1761006289308176,0.035167201242443775,652,I think I need my medication.
8071,8177,2,21,119,142,1.176056338028169,0.03505107903487607,652,"Stay with me or go for the sweets--it's a false choice, really."
9307,8177,5,15,122,142,1.176056338028169,0.03909281908624994,652,I bet they envy our Paleolithic diet.
8950,8177,3,19,120,142,1.176056338028169,0.03644815855946875,652,"They call it ""Paradise Island."""
8948,8177,1,23,118,142,1.176056338028169,0.03359595244433595,652,I hear when you get up close it’s a little bit off-putting.
6932,8177,3,19,120,142,1.176056338028169,0.03644815855946875,652,Just as well. I'm gluten free.
8770,8177,0,25,117,142,1.176056338028169,0.03207487957537855,652,"The good news is, I'm on a diet."
4114,8177,4,17,121,142,1.176056338028169,0.03779362887105737,652,"*Mirage carbs or mirage calories. You can't have both."""
3322,8177,4,17,121,142,1.176056338028169,0.03779362887105737,652,"Your right, you promised me a secluded tropical island
vacation ........ not Candy-land."
5843,8177,4,17,121,142,1.176056338028169,0.03779362887105737,652,"You're right, it does look better from back here"
2742,8177,2,21,119,142,1.176056338028169,0.03505107903487607,652,Want to see who gets there first?
2667,8177,2,21,119,142,1.176056338028169,0.03505107903487607,652,"Well, this is one way to guarantee a sugar free diet."
1684,8177,2,21,119,142,1.176056338028169,0.03505107903487607,652,Eat your heart out!
6608,8189,2,18,105,125,1.176,0.037783765074775245,652,But it's not paleo or gluten-free.
3259,8189,2,18,105,125,1.176,0.037783765074775245,652,I'm waiting for some gluten free options.
1308,8189,0,22,103,125,1.176,0.034198660603841975,652,I don't swim.
2058,8189,1,20,104,125,1.176,0.03603582446900985,652,"Looks tempting,but it just not part of  my Paleo diet."
9161,8193,4,21,140,165,1.1757575757575758,0.034336187517090576,652,Where do you think the gluten-free island is?
4808,8194,4,18,126,148,1.1756756756756757,0.036781001705130593,652,I bet Fred's the donut.
8851,8194,3,20,125,148,1.1756756756756757,0.03550934275758402,652,I don't really have a sweet tooth.
8681,8194,6,14,128,148,1.1756756756756757,0.03920075781343122,652,Must be the Candyland Expansion.
7812,8194,2,22,124,148,1.1756756756756757,0.0341904191217123,652,Not on my watch.
8856,8194,3,20,125,148,1.1756756756756757,0.03550934275758402,652,I wish your spelling was not that good
3964,8194,5,16,127,148,1.1756756756756757,0.038010140091692034,652,Horatio. Darn it!  We go on weight loss retreat  and that Abu Dhabi food barge just won't leave us alone.
5212,8194,5,16,127,148,1.1756756756756757,0.038010140091692034,652,That mirage wouldn't bother you if you were doing Paleo.
2755,8194,2,22,124,148,1.1756756756756757,0.0341904191217123,652,"You may feel great at first, but then—the carb crash.  Plus, it isn’t gluten-free."
2678,8194,2,22,124,148,1.1756756756756757,0.0341904191217123,652,Not for me I’m watching my weight.
2033,8194,4,18,126,148,1.1756756756756757,0.036781001705130593,652,I would if my A1C wasn’t so high
1512,8194,2,22,124,148,1.1756756756756757,0.0341904191217123,652,Too bad I’m on a gluten-free diet.
797,8194,3,20,125,148,1.1756756756756757,0.03550934275758402,652,"It’s either a mirage, or there’s a big baker somewhere."
751,8194,5,16,127,148,1.1756756756756757,0.038010140091692034,652,Are you hungry?
3959,8194,3,20,125,148,1.1756756756756757,0.03550934275758402,652,"Actually, I really don't yearn to be young again."
8434,8208,4,15,112,131,1.1755725190839694,0.03978939865733033,652,30 days on Keto Island should do the trick.
5567,8208,2,19,110,131,1.1755725190839694,0.03671943111377625,652,You should have let me roll the dice.
8672,8208,1,21,109,131,1.1755725190839694,0.03508385396764527,652,It's times like this that I wish I wasn't on my diet.
79,8208,3,17,111,131,1.1755725190839694,0.0382851986205591,652,Big deal—I'm gluten free anyway
5324,8208,3,17,111,131,1.1755725190839694,0.0382851986205591,652,"lets visit the island across the way, wouldn't that be sweet?"
10,8213,4,22,145,171,1.1754385964912282,0.03355798503060304,652,Could we contact the travel company for a room upgrade honey ?
8058,8213,2,26,143,171,1.1754385964912282,0.03144104737608739,652,"Say, why don't we swim over to that island? It's filled with enormous candy and pastries, while this one lacks food alltogether. By the way, have you ever noticed that the words ""desert"" and ""dessert"" are only one letter apart?"
1349,8215,4,19,131,154,1.1753246753246753,0.03584042205260224,652,Is that on the Keto Diet?
3957,8215,5,17,132,154,1.1753246753246753,0.037005652145750266,652,Pity I gave up carbs and sugar.
8093,8217,4,16,117,137,1.1751824817518248,0.038624106730869946,652,"Believe in global warming now? We're sitting on top of Hawaii, and over yonder is the peak of the Big Rock Candy Mountain."
2397,8217,2,20,115,137,1.1751824817518248,0.03573705649387038,652,No! Our cholesterol will spike.
3014,8217,4,16,117,137,1.1751824817518248,0.038624106730869946,652,I don't see it- but I am getting tired of coconuts.
4576,8217,4,16,117,137,1.1751824817518248,0.038624106730869946,652,Gosh darn it Kyle! I though you said Desert.
5572,8217,4,16,117,137,1.1751824817518248,0.038624106730869946,652,I wish the sharks would go away!
6696,8217,3,18,116,137,1.1751824817518248,0.0372085932789975,652,"I would, but I'm on keto."
8112,8223,4,20,136,160,1.175,0.034964042625668434,652,Too bad it’s only a mirage!
4062,8223,5,18,137,160,1.175,0.03607077250255139,652,"Yeah, they do look organized and hungry."
3516,8223,3,15,102,120,1.175,0.04041538520594029,652,This was the low calorie marooned option
324,8226,3,19,121,143,1.1748251748251748,0.03621331315291399,652,Didn't I see an ice cold milk ferry pass us a few minutes ago?
528,8226,4,17,122,143,1.1748251748251748,0.037548596588295395,652,"You contemplating ""your just deserts?"""
5440,8226,4,17,122,143,1.1748251748251748,0.037548596588295395,652,"Oh, my, it's the good ship Sugar Shop!"
6667,8226,1,23,119,143,1.1748251748251748,0.03338289887100794,652,Do you think we have a good enough reason not to play Candyland?
8275,8226,4,17,122,143,1.1748251748251748,0.037548596588295395,652,"To me, it still looks like a pile of junk. On the other hand, you no longer resemble a dead bush. So I guess on some level this has been a pretty good vacation for both of us."
8832,8226,4,17,122,143,1.1748251748251748,0.037548596588295395,652,"Boy, weight watchers has really gone too far this time!"
8876,8226,2,21,120,143,1.1748251748251748,0.03482687171239298,652,Better not try it.  I understand the sharks have a sweet tooth.
9517,8226,4,17,122,143,1.1748251748251748,0.037548596588295395,652,"Okay, so it's an illusion that in our shared delusion is real?"
8826,8234,8,13,145,166,1.1746987951807228,0.03818334305345972,652,So you really are a diabetic?
6497,8235,3,16,107,126,1.1746031746031746,0.03916487749407272,652,I’m sure they have a gluten-free option.
7461,8235,3,16,107,126,1.1746031746031746,0.03916487749407272,652,"I think of it as ""deserted"" with one ""s.""  At least here we have each other."
9614,8237,3,20,126,149,1.174496644295302,0.035289921021181316,652,"I think I'm starting to hallucinate, Magical pixie."
6406,8237,3,20,126,149,1.174496644295302,0.035289921021181316,652,That sucks. I just started my Keto diet.
5656,8237,4,18,127,149,1.174496644295302,0.03655233572903953,652,"I think it's Putin's ""Good Ship Lollipop"" trolling for Trump votes in 2020,"
4949,8237,3,20,126,149,1.174496644295302,0.035289921021181316,652,I picked the wrong day to start this diet.
8604,8237,4,18,127,149,1.174496644295302,0.03655233572903953,652,testing
3109,8237,3,20,126,149,1.174496644295302,0.035289921021181316,652,Lets pass on the a mirage a la carte.
3058,8237,3,20,126,149,1.174496644295302,0.035289921021181316,652,"Yep, we should have listened to our mom's and taken swimming lessons..."
1688,8237,5,16,128,149,1.174496644295302,0.03777258223653269,652,"No, it’s just another cruise ship!"
262,8237,4,18,127,149,1.174496644295302,0.03655233572903953,652,Sea mirage you say and here I thought it was from our sunken shipment of pool toys
3295,8237,2,22,125,149,1.174496644295302,0.033980638665481414,652,Want to go for a swim ?
2669,8247,6,18,148,172,1.1744186046511629,0.03535651315658309,652,How come we don't have any of that on the South Beach?
7540,8247,4,22,146,172,1.1744186046511629,0.0333778985345532,652,Vegan's Paradise
9838,8247,7,16,149,172,1.1744186046511629,0.03630540563877486,652,Are there sharks on the way to Candyland?
3194,8250,3,17,112,132,1.1742424242424243,0.038017327035101224,652,Candyland is my favorite game
5718,8250,2,19,111,132,1.1742424242424243,0.03646445850262836,652,But think about how many calories we’re saving
7331,8250,2,19,111,132,1.1742424242424243,0.03646445850262836,652,"I know it looks tempting, but I’m trying to cut down on sweets."
7458,8250,3,17,112,132,1.1742424242424243,0.038017327035101224,652,"And I thought ""Candy Land"" was just a board game!"
9709,8254,4,19,132,155,1.1741935483870967,0.03562640376028724,652,"Eh, I think their original location is better."
6619,8254,1,25,129,155,1.1741935483870967,0.03190421763978685,652,I gave up sugar for the new year.
174,8254,1,25,129,155,1.1741935483870967,0.03190421763978685,652,So close yet so far away.
1923,8254,2,23,130,155,1.1741935483870967,0.033191358570692164,652,"As a dessert, the floating island is just not that satisfying."
3442,8254,5,17,133,155,1.1741935483870967,0.03678352654997047,652,"Looks good, but it will be bad for our teeth."
6810,8259,3,18,117,138,1.173913043478261,0.03695978853147891,652,"I told you to proof read before this story went to print!"""
9469,8259,2,20,116,138,1.173913043478261,0.035499851344683746,652,"I was never much for sweets, I'm more of a salty guy."
9416,8259,4,20,137,161,1.173913043478261,0.03476319333902042,652,"Yes, I still stand by my ""desert island book"" choice."
8411,8259,4,20,137,161,1.173913043478261,0.03476319333902042,652,I see why Columbus bypassed this deserted island to sail to that desert-ed island
7771,8259,2,24,135,161,1.173913043478261,0.03245304466487734,652,Let’s put our flag on those candy canes!
7683,8259,3,22,136,161,1.173913043478261,0.033627962465384645,652,Nah. I'm on a low glycemic regimen.
7251,8259,2,24,135,161,1.173913043478261,0.03245304466487734,652,So how long have you been a vegan?
5541,8259,2,20,116,138,1.173913043478261,0.035499851344683746,652,Not if it has gluten
3411,8259,5,14,119,138,1.173913043478261,0.03971900066574726,652,The upside to climate change is fewer temptations.
3832,8259,3,18,117,138,1.173913043478261,0.03695978853147891,652,"No thanks, I'm done with that yo-yo diet craze."
3789,8259,3,18,117,138,1.173913043478261,0.03695978853147891,652,I guess the grass is always greener......
3408,8259,2,24,135,161,1.173913043478261,0.03245304466487734,652,I can’t I’m on Whole 30
1373,8259,3,22,136,161,1.173913043478261,0.033627962465384645,652,gluten free?
359,8259,3,18,117,138,1.173913043478261,0.03695978853147891,652,"Yes, but is it gluten free?"
336,8259,4,16,118,138,1.173913043478261,0.03836420846425266,652,That's Selma and Jack over there.They won the Grand Prize on one of those TV quiz shows.
5492,8259,3,22,136,161,1.173913043478261,0.033627962465384645,652,C'mon. I need a donut.
1362,8275,5,19,143,167,1.1736526946107784,0.035002381656157724,652,Every sweet tooth is an island unto itself.
9537,8276,5,15,124,144,1.1736111111111112,0.038586451629178294,652,"It may seem risky now but trust me, that place was loaded with triglycerides."
6565,8276,3,19,122,144,1.1736111111111112,0.035981440425318194,652,I would swim over there but I just started my new Keto diet.
5876,8276,1,23,120,144,1.1736111111111112,0.03317248650358499,652,"Dang, we con't post a picture of that."
4734,8276,4,17,123,144,1.1736111111111112,0.03730669044830725,652,"See, looking at it doesn't add calories."
7915,8276,1,23,120,144,1.1736111111111112,0.03317248650358499,652,Ignore it. It's new WW tempt! I have 5lbs to go.
4311,8276,3,19,122,144,1.1736111111111112,0.035981440425318194,652,"Gluten, dairy, sugar, NO WAY!"
4228,8276,3,19,122,144,1.1736111111111112,0.035981440425318194,652,If only I weren't paleo.
2084,8276,3,19,122,144,1.1736111111111112,0.035981440425318194,652,"It was very nice, but the dentist bills were killing us."
1668,8276,3,19,122,144,1.1736111111111112,0.035981440425318194,652,"Believe me, it’s a lure."
4411,8276,1,23,120,144,1.1736111111111112,0.03317248650358499,652,So how will you know when your sugar levels get low?
4943,8286,2,17,102,121,1.1735537190082646,0.038350432077784796,652,These are the moments I wish I knew how to swim.
1617,8287,3,24,146,173,1.1734104046242775,0.03217153489745255,652,"I left off the ""S"" for savings."
8285,8287,5,20,148,173,1.1734104046242775,0.03419699296589373,652,Doesn't look gluten-free anyway.
9336,8289,2,22,126,150,1.1733333333333333,0.03377338171479713,652,"What's that saying about ""always greener on the other side?""  No truer words eh?"
7849,8289,4,18,128,150,1.1733333333333333,0.036326467343788665,652,I have diabetes anyway.
6917,8289,3,20,127,150,1.1733333333333333,0.03507316311749439,652,Think I'm going to stick with this no carbs diet.
6650,8289,1,24,125,150,1.1733333333333333,0.03242153379839421,652,"Relax, my clients swear by the Isle of Candy hypnotherapy."
6486,8289,1,24,125,150,1.1733333333333333,0.03242153379839421,652,"We should probably stop talking about food so loudly, whenever the sharks are present."
3952,8289,5,16,129,150,1.1733333333333333,0.03753794997455667,652,"Tempting, but I gotta pass. I'm on Whole 30."
5426,8289,4,18,128,150,1.1733333333333333,0.036326467343788665,652,Those dolphins out there look like candy canes and cupcakes.
1880,8289,3,20,127,150,1.1733333333333333,0.03507316311749439,652,"Feb 13th....
It's not or never. After tomorrow it goes back under the sea for a thousand years."
955,8289,4,18,128,150,1.1733333333333333,0.036326467343788665,652,I think you are seeing a mirage!
5728,8289,1,24,125,150,1.1733333333333333,0.03242153379839421,652,"""Let's go see if it sparks our bliss."""
5675,8299,3,16,108,127,1.1732283464566928,0.038879584242416866,652,Wanna go halfsies on the palm tree?
7789,8299,2,18,107,127,1.1732283464566928,0.03723758442636028,652,"I swear, before global waming there was nothing but a wall between us."
4385,8299,3,16,108,127,1.1732283464566928,0.038879584242416866,652,"You were right, it's spelled with two esses."
1893,8299,2,18,107,127,1.1732283464566928,0.03723758442636028,652,Not a single thing on my diet.
3838,8299,1,20,106,127,1.1732283464566928,0.035519759528429076,652,Too bad you can't swim and I'm on the keto diet
4575,8299,2,18,107,127,1.1732283464566928,0.03723758442636028,652,"Nah, we would only get cavities, and there is no dentist here."
6644,8305,3,25,151,179,1.1731843575418994,0.0315080771628772,652,I'm glad we are on a sugar free diet
3524,8306,4,19,133,156,1.1730769230769231,0.035414900550674824,652,Let's jump on the Good Ship Lollipop!
3635,8306,2,23,131,156,1.1730769230769231,0.032996806044473505,652,"Don't know about you, but I'm watching my weight."
8562,8306,3,21,132,156,1.1730769230769231,0.03422721424649391,652,You still think it's a mirage?!
9306,8306,2,23,131,156,1.1730769230769231,0.032996806044473505,652,It isn’t inappropriate. We were on the good ship Lollypop.
9387,8306,2,23,131,156,1.1730769230769231,0.032996806044473505,652,So this is why they asked on the diet-program-application if we'd ever had swim lessons.
9277,8311,5,13,115,133,1.1729323308270676,0.04065884578048786,652,But you promised me you'd go gluten free this year
8602,8311,5,13,115,133,1.1729323308270676,0.04065884578048786,652,"I think I am having a dejà vu, George."
7416,8311,0,23,110,133,1.1729323308270676,0.03291710660792908,652,The problem is once you have sugar you start craving it.
6531,8311,1,21,111,133,1.1729323308270676,0.03460429271045015,652,I'm supposed to watch my sugar levels.
1614,8311,3,17,113,133,1.1729323308270676,0.03775313771193071,652,Good thing I'm a vegan.
4724,8311,1,21,111,133,1.1729323308270676,0.03460429271045015,652,"Another sign of Global Warming, or the Coast Guard has one hell of a sweet tooth!"
2117,8311,3,17,113,133,1.1729323308270676,0.03775313771193071,652,Think of all the keytones we're burning.
9388,8311,1,21,111,133,1.1729323308270676,0.03460429271045015,652,"It's what's left of the Big Rock Candy Mountains.  That William Happer, man..."
414,8311,5,13,115,133,1.1729323308270676,0.04065884578048786,652,I thought this diet would be harder.
6150,8311,2,19,112,133,1.1729323308270676,0.03621295680475787,652,How many 'esses' do you spell that with?
9735,8321,3,22,137,162,1.1728395061728396,0.033436975879986404,652,Diabetech startup?
5471,8321,4,20,138,162,1.1728395061728396,0.034564614739648385,652,I’m more of a lean coconut kinda diet...
6793,8321,4,20,138,162,1.1728395061728396,0.034564614739648385,652,Of all the times to start my new keto diet.
1322,8324,1,22,116,139,1.1726618705035972,0.03375511106617881,652,You still have that mover’s number?
2209,8324,5,14,120,139,1.1726618705035972,0.039452061813184315,652,If only they'd give up their nuclear arms program...
2303,8324,3,18,118,139,1.1726618705035972,0.03671425271200126,652,"Do you think there could be a banana boat over there too?''
""I don't know but it just keeps getting sweeter."
2395,8324,5,14,120,139,1.1726618705035972,0.039452061813184315,652,But at least we have a mnemonic device.
4848,8324,3,18,118,139,1.1726618705035972,0.03671425271200126,652,I miss Candy Crush - I wish I didn't lose my phone.
7938,8324,2,20,117,139,1.1726618705035972,0.03526573319307823,652,It's either starvation or diabetes ... never a joy in life.
8474,8324,2,20,117,139,1.1726618705035972,0.03526573319307823,652,"Are you sure the ""Use By date"" is not over?"
241,8331,1,27,140,168,1.1726190476190477,0.0304385583080682,652,"Ya, but what about your A1C levels?"
2673,8331,4,21,143,168,1.1726190476190477,0.03376927346216977,652,"Wrong again. The double-s is in dessert, not desert. Let's go for double or nothing: Doughnut? or do-nut?"
6577,8333,2,21,122,145,1.1724137931034482,0.034386839773911694,652,"I always imagined the atmospherics would conform to Sting's ""Message in a Bottle"", didn't you?"
6737,8333,4,17,124,145,1.1724137931034482,0.03706785171631516,652,I'm wondering if we should reconsider our sugar-free policy.
5133,8333,3,19,123,145,1.1724137931034482,0.035752485091944335,652,A few more feet and we would have gotten a gated community.
9528,8333,2,21,122,145,1.1724137931034482,0.034386839773911694,652,Good plan. And now we wait for cheat day.
9925,8333,3,19,123,145,1.1724137931034482,0.035752485091944335,652,"I thought you said ""Candy Island"" was just a Fake news hoax."
7779,8333,0,25,120,145,1.1724137931034482,0.031478307902595745,652,Hey - I could deal with greener grass
3573,8333,1,23,121,145,1.1724137931034482,0.0329646675855172,652,"Am I dreaming, or is that a UFO?"
5469,8333,4,17,124,145,1.1724137931034482,0.03706785171631516,652,I don‘t know if they are vegan. But the sharks aren‘t!
2872,8333,4,17,124,145,1.1724137931034482,0.03706785171631516,652,My sweet tooth was always my downfall.
2728,8333,3,19,123,145,1.1724137931034482,0.035752485091944335,652,The best thing with the Paleo diet is just to put sugar and carbs right out of your mind...
1549,8333,2,21,122,145,1.1724137931034482,0.034386839773911694,652,"Frankly, it's not worth the diabetes."
1075,8333,5,15,125,145,1.1724137931034482,0.0383381151267998,652,"Is it one ""S"" or two?  Boy, I could kill for a dictionary right now."
515,8333,1,23,121,145,1.1724137931034482,0.0329646675855172,652,I've only ever been here before on the keto diet.
510,8333,3,19,123,145,1.1724137931034482,0.035752485091944335,652,I wouldn't.  We'd only put on weight.
484,8333,3,19,123,145,1.1724137931034482,0.035752485091944335,652,Must be one of those quantum fluctuations.
3437,8333,3,19,123,145,1.1724137931034482,0.035752485091944335,652,I told you we shouldn't have crossed the Duke of Swirl.
8834,8349,4,18,129,151,1.1721854304635762,0.03610334614685831,652,My dietitian would kill me.
8528,8349,4,18,129,151,1.1721854304635762,0.03610334614685831,652,"Hon, next time I'll fly."
6092,8349,2,22,127,151,1.1721854304635762,0.033568603806216984,652,You're full of surprises. Where did you find the palm oil?
4751,8349,2,22,127,151,1.1721854304635762,0.033568603806216984,652,Dieting is tough on this island.
2885,8349,4,18,129,151,1.1721854304635762,0.03610334614685831,652,The Tardís has really been on the fritz lately.
5613,8349,5,16,130,151,1.1721854304635762,0.037306190153249645,652,I’m not going there intil we have a dentist on retainer!”
124,8355,2,17,103,122,1.1721311475409837,0.03806137940125822,652,It’s already been licked by Ariana Grande.
1790,8355,1,19,102,122,1.1721311475409837,0.03623790287865224,652,"I know it's a mirage, because those cupcakes definitely have gluten in them"
9280,8355,2,17,103,122,1.1721311475409837,0.03806137940125822,652,Are you having visions of sugar plums dancing in your head?
5909,8358,3,21,133,157,1.1719745222929936,0.03402637047529577,652,Your entire diet is a mirage.
2695,8358,4,19,134,157,1.1719745222929936,0.035205868900656134,652,I WANT THE CANDY CANE!!!
4342,8358,4,19,134,157,1.1719745222929936,0.035205868900656134,652,"My mind is taking ""decadent mirage"" to a whole new level right now."
1119,8358,2,23,132,157,1.1719745222929936,0.032804490095015536,652,It’s my Bali Hai
685,8358,4,19,134,157,1.1719745222929936,0.035205868900656134,652,Would you get me that cake?
1198,8358,7,13,137,157,1.1719745222929936,0.03852831630157887,652,That's the islet of langerhans
3479,8364,5,12,111,128,1.171875,0.0416641034316566,652,"(this is for last week, please oh please count it:)
You're in luck, this clinic still carries snake oil"
4798,8364,3,16,109,128,1.171875,0.038598374611345944,652,Do you think they'll have any gluten-free options?
5875,8366,5,18,140,163,1.1717791411042944,0.03545304328274259,652,Let's roll the dice on this Candy Land.
9164,8367,4,15,115,134,1.171641791044776,0.03896039816506864,652,"Wait, so Survivor had a Goodship Lollypop episode?"
7659,8367,1,21,112,134,1.171641791044776,0.03436931877821468,652,But my HDL is really high
5945,8367,1,21,112,134,1.171641791044776,0.03436931877821468,652,Too late . We're out of cappucchino .
5893,8367,1,21,112,134,1.171641791044776,0.03436931877821468,652,"'On the Good Ship Lollipop' is still my personal favorite, regardless."
5035,8367,3,17,114,134,1.171641791044776,0.037492556255163983,652,When you choose island A bit the prize was on island B
5034,8367,3,17,114,134,1.171641791044776,0.037492556255163983,652,I never thought that this is what Candy Land would really be like.
2612,8367,6,11,117,134,1.171641791044776,0.04174151801802109,652,Is that a desert island or a dessert island? No need to answer. Just surprise me with something yummy - NOW!
2593,8367,2,19,113,134,1.171641791044776,0.03596485678982454,652,MIRAGE
2516,8367,4,15,115,134,1.171641791044776,0.03896039816506864,652,I didn't know extra terrestrials had a sweet tooth !
2351,8367,5,13,116,134,1.171641791044776,0.040374911465100846,652,Thanks but I'll pass. I doubt anything over there is gluten free.
3217,8367,2,19,113,134,1.171641791044776,0.03596485678982454,652,China could have had our island for a lot less.
6033,8378,3,18,119,140,1.1714285714285715,0.03647192269686756,652,"-If only there was a way to safely move our bodies across the water with let's say coordinated moves.
-If only I were stuck here with someone else."
8919,8378,2,20,118,140,1.1714285714285715,0.03503464317340017,652,"You can do it Gerald, just think of the type II diabetes."
9643,8378,3,18,119,140,1.1714285714285715,0.03647192269686756,652,"Couldn't you have been more specific when you dragged me into your ""desserted"" island scenario?"""
7963,8378,3,18,119,140,1.1714285714285715,0.03647192269686756,652,This is my least favorite diet since that paleo stuff.
7180,8378,3,18,119,140,1.1714285714285715,0.03647192269686756,652,"So, did you catch the Grammys?"
6736,8378,2,20,118,140,1.1714285714285715,0.03503464317340017,652,Aren’t you a dentist? You will finally be back in business.
5512,8378,5,20,150,175,1.1714285714285715,0.03383391428095771,652,Think we can get over and back?
844,8378,2,20,118,140,1.1714285714285715,0.03503464317340017,652,Too many calories.
4626,8378,3,18,119,140,1.1714285714285715,0.03647192269686756,652,pffffft.....all carbs....
3447,8378,3,18,119,140,1.1714285714285715,0.03647192269686756,652,"That's a mirage, right?"
2330,8378,5,14,121,140,1.1714285714285715,0.03918865895949871,652,"Nah, I think I'll skip dessert this year."
1590,8378,1,28,146,175,1.1714285714285715,0.029698619085809945,652,No. I'll wait here. I'm in ketosis.
576,8378,5,14,121,140,1.1714285714285715,0.03918865895949871,652,"After the Great Pacific Garbage Patch, is this the next Great Pacific Junk Food Patch?!?!"
4950,8378,1,22,117,140,1.1714285714285715,0.03353582113753393,652,How can we get to Candyland without a dinghy?
552,8392,4,17,125,146,1.1712328767123288,0.03683202309770149,652,Can you make dinner?
2680,8392,4,17,125,146,1.1712328767123288,0.03683202309770149,652,"If that’s the sunny beach
of Peppermint Bay, where are the bon-bons?"
6829,8392,2,21,123,146,1.1712328767123288,0.034170913111746,652,"Man, keto is really making these mirages insane."
3513,8395,2,15,94,111,1.1711711711711712,0.040216192732314915,652,So I guess it is OK to eat dessert first.
9588,8396,1,24,127,152,1.1710526315789473,0.03203387316738355,652,"I don't care, I started a new diet last week."
8170,8396,2,22,128,152,1.1710526315789473,0.033366261490384144,652,I afraid I'd get diabetic shock If I swim there
6435,8396,3,20,129,152,1.1710526315789473,0.03464744985688511,652,I know you've been using my toothbrush again.
8048,8396,2,22,128,152,1.1710526315789473,0.033366261490384144,652,"Yes,but is it vegan, gluten free and keto?"
4212,8396,4,18,130,152,1.1710526315789473,0.03588292292060451,652,"On my diet, I'm glad I never learned to swim."
5162,8396,2,22,128,152,1.1710526315789473,0.033366261490384144,652,It's also the home of the Good Ship Lolipop
4191,8396,2,22,128,152,1.1710526315789473,0.033366261490384144,652,I'm trying to cut back on sweets.
795,8396,3,20,129,152,1.1710526315789473,0.03464744985688511,652,Vegans.
111,8404,2,23,133,158,1.1708860759493671,0.03261437304701198,652,"I’ll go with you, but only if you are really sure they are vegan and gluten free”"
732,8404,4,19,135,158,1.1708860759493671,0.034999266269688516,652,I told Willy Wonka this would happen if he didn't pay the Oompa Loompas.
3299,8404,4,19,135,158,1.1708860759493671,0.034999266269688516,652,You could be right. Maybe it is a floating island puff pastry piece obit with a misspelling.
5544,8407,3,15,105,123,1.170731707317073,0.039501284398971506,652,I'm up for a dunkin' right about now!
3147,8408,6,17,147,170,1.1705882352941177,0.03542440276208115,652,First one to the cupcake wins the dessert island challenge.
1046,8409,2,18,109,129,1.1705426356589148,0.03670677698619343,652,What are the odds we get caught  sneaking ashore by an Oompa-Loompa ?
1197,8409,5,12,112,129,1.1705426356589148,0.04136132940002528,652,Damn! I​ knew we should have taken the Good Ship Lollipop​​!
1254,8409,2,18,109,129,1.1705426356589148,0.03670677698619343,652,Wayne Thiebaud was marooned there.
5128,8409,4,14,111,129,1.1705426356589148,0.03987023374310268,652,I wonder if it's vegan.
7127,8409,3,16,110,129,1.1705426356589148,0.0383211626614054,652,"Happy 10th Anniversary!
Ordered it via Message-in-the-Bottle.com"
1437,8414,4,22,150,176,1.1704545454545454,0.03267627700798723,652,I wish Global Warming would make up its mind.
7973,8415,1,21,113,135,1.1703703703703703,0.034137465968115434,652,Look at that Dad!- You're so old that even heaven broke out of the sky looking for you.
5914,8415,3,17,115,135,1.1703703703703703,0.03723551022547329,652,"Vegan, and a short swim, but you’ll regret the calories."
8663,8415,3,17,115,135,1.1703703703703703,0.03723551022547329,652,When mom says that we have food at home.
3960,8415,1,21,113,135,1.1703703703703703,0.034137465968115434,652,Glad I can eat my half! Mirage doesn't affect my diabetes.
1401,8415,3,17,115,135,1.1703703703703703,0.03723551022547329,652,"Okay, so if you were stranded on a desert island, what's the one thing you couldn't live without?""
""This game really isn't fun anymore, George. You're just gonna have to stop."
4782,8415,3,17,115,135,1.1703703703703703,0.03723551022547329,652,It was supposed to be “THE GOOD SHIP”!
9285,8421,1,22,118,141,1.1702127659574468,0.03331931844459037,652,Sun and salt make for sweet dreams.
9153,8421,3,18,120,141,1.1702127659574468,0.03623273694877958,652,It’s a typo- there’s only supposed to be one “s.”
8943,8421,3,18,120,141,1.1702127659574468,0.03623273694877958,652,I guess Santa did exist at the North Pole.
7648,8421,2,20,119,141,1.1702127659574468,0.03480652387420695,652,"They salvaged what they could, but in the end the Good Ship Lollypop sunk."
5919,8421,3,18,120,141,1.1702127659574468,0.03623273694877958,652,Top 5 must-haves on a dessert island - you pick first.
5407,8421,4,16,121,141,1.1702127659574468,0.037604897944193055,652,I wonder if they dream about us.
4574,8421,2,20,119,141,1.1702127659574468,0.03480652387420695,652,"Ah - the lure of temptation - You can swim through murky waters for dessert or you can ""feast"" on vegetables, here. Your choice!"
3784,8421,3,18,120,141,1.1702127659574468,0.03623273694877958,652,"Quick, what are your top 5 dessert island mix tape songs?"
2584,8421,1,22,118,141,1.1702127659574468,0.03331931844459037,652,I have a case of the munchies.
1994,8421,1,22,118,141,1.1702127659574468,0.03331931844459037,652,It's December 24th!
1145,8421,3,18,120,141,1.1702127659574468,0.03623273694877958,652,I told you we  shouldn't have  started  that  diet.
4925,8421,5,14,122,141,1.1702127659574468,0.03892872296886829,652,I'm concerned about the round things. Are they eyes? They scare me.
9488,8433,4,17,126,147,1.1700680272108843,0.03659914869499552,652,Oh darn!  I gave up sweets for Lent
8759,8433,2,21,124,147,1.1700680272108843,0.033957646634701966,652,Looks a lot like Mount Dessert Island
8636,8433,5,15,127,147,1.1700680272108843,0.0378508341429082,652,"Did you know, there's no skill involved with Candyland™? 
It's all predetermined by how the cards are shuffled."
7998,8433,1,23,123,147,1.1700680272108843,0.03255662459241948,652,Tell me that’s an hallucination!
7436,8433,2,21,124,147,1.1700680272108843,0.033957646634701966,652,"I'm in the middle of Whole30, so I'd rather just draw straws if that works for you?"
6104,8433,1,23,123,147,1.1700680272108843,0.03255662459241948,652,Diabetic or keto?
2023,8433,2,21,124,147,1.1700680272108843,0.033957646634701966,652,If we eat all that we may need a dentist.
1341,8433,4,17,126,147,1.1700680272108843,0.03659914869499552,652,"See, I told you there was a misprint in our travel brochure!"
105,8433,6,13,128,147,1.1700680272108843,0.03906243214943865,652,"Man, you sure picked the wrong time to do Keto."
6513,8433,2,21,124,147,1.1700680272108843,0.033957646634701966,652,This Survivor: Candy Land season isn't so sweet after all.
7343,8443,2,22,129,153,1.1699346405228759,0.03316631230422294,652,Wishing won't make it so
6259,8443,5,16,132,153,1.1699346405228759,0.03685108150214539,652,I wish we were playing CandyLand
8137,8443,3,20,130,153,1.1699346405228759,0.03443840274848347,652,Well it's a good thing I'm on a gluten-free diet.
1792,8443,5,16,132,153,1.1699346405228759,0.03685108150214539,652,Ever make love atop a cheesecake?
4170,8443,2,22,129,153,1.1699346405228759,0.03316631230422294,652,They can only see you if you move.
932,8448,2,23,134,159,1.169811320754717,0.03242641804699674,652,Fantasy Island step back - here's Fantasy land
1162,8448,3,21,135,159,1.169811320754717,0.033631593528386426,652,It’s Paradise Island.
1386,8448,5,17,137,159,1.169811320754717,0.03592084457607615,652,"Yeah, but I'm going Keto.  Remember?"
2513,8448,3,21,135,159,1.169811320754717,0.033631593528386426,652,Washington DC seems so far away
2913,8448,4,19,136,159,1.169811320754717,0.03479505107279786,652,You’ll have to have them all pulled out after the Savoy truffle.
5944,8453,4,21,146,171,1.1695906432748537,0.033220589179131704,652,I would pass : on the Coconut Macaroons
2424,8454,4,12,102,118,1.1694915254237288,0.04222049957827306,652,"Sorry, honey, too bad you're diabetic."
6098,8455,3,15,106,124,1.1693548387096775,0.0392056153777788,652,I must have left one letter out.
5971,8455,1,19,104,124,1.1693548387096775,0.03570461580842631,652,Even the mirages did not stay immune to the politically incorrect hysteria - no more mermaids!
53,8455,2,17,105,124,1.1693548387096775,0.037495998901067105,652,"I'd  rather wait for another island raised by global warming to come by.  With our luck, those are just sand sculptures, ya know?"
2069,8458,4,14,112,130,1.1692307692307693,0.0395840953021522,652,These trees are organic.
3391,8458,6,10,114,130,1.1692307692307693,0.0424902549962176,652,I didn't know we were so close to Fire Island...
9330,8458,3,16,111,130,1.1692307692307693,0.03804786480885628,652,"'""Been like this all my life."""
8966,8461,3,17,116,136,1.1691176470588236,0.036981929077634895,652,At least we don't have to worry about counting calories.
8366,8461,4,15,117,136,1.1691176470588236,0.03842649528875689,652,Oh darn! I just went on a no sugar diet.
8101,8461,4,15,117,136,1.1691176470588236,0.03842649528875689,652,Big whoopee pie.
6507,8461,1,21,114,136,1.1691176470588236,0.03390867373631621,652,"I tried Uber, but I'm not a great speller."
6308,8461,5,13,118,136,1.1691176470588236,0.039818689105123664,652,Is that the top of a Martian's head?
6025,8461,2,19,115,136,1.1691176470588236,0.03547859377751011,652,Just my luck - I'm on a low carb diet!
5562,8461,3,17,116,136,1.1691176470588236,0.036981929077634895,652,I called for one partridge in a pear tree and one golden goose.
5444,8461,4,15,117,136,1.1691176470588236,0.03842649528875689,652,You can go for it if you want but I'll pass.  It's this gluten free diet I'm on.
8276,8461,1,21,114,136,1.1691176470588236,0.03390867373631621,652,Thank goodness I only did keto in January.
4294,8461,2,19,115,136,1.1691176470588236,0.03547859377751011,652,We need to start the Paleo diet.
4147,8461,3,17,116,136,1.1691176470588236,0.036981929077634895,652,This is nothing like being stuck in molasses swamp
3523,8461,3,17,116,136,1.1691176470588236,0.036981929077634895,652,IT’S JUST AS ASYMMETRICAL AS OUR ISLAND.
2972,8461,4,15,117,136,1.1691176470588236,0.03842649528875689,652,Thank god I'm doing Paleo.
2051,8461,4,15,117,136,1.1691176470588236,0.03842649528875689,652,"I gotta be honest, while we were swimming over here, I thought “gee, I really hope it isn’t just a mirage”... but here we are..."
1486,8461,5,13,118,136,1.1691176470588236,0.039818689105123664,652,There's got to be a reason they call it Diabetes Island
987,8461,3,17,116,136,1.1691176470588236,0.036981929077634895,652,"Go ahead, swim over but I’d rather die on a desert island than play Candyland"
4376,8461,3,17,116,136,1.1691176470588236,0.036981929077634895,652,But we promised ourselves we would stick to the Whole 30 this month
9971,8478,1,22,119,142,1.1690140845070423,0.03310555124621702,652,"It's called Gluten Island, not Putin Island. Why would Trump be building a fifty story hotel there?"
9529,8478,2,20,120,142,1.1690140845070423,0.034581319295003014,652,Are candy canes keto?
9110,8478,1,22,119,142,1.1690140845070423,0.03310555124621702,652,"Yeah, but it would wreck my diet, so..."
7085,8478,3,18,121,142,1.1690140845070423,0.03599663546847113,652,I don't think it's keto-friendly.
2719,8478,2,20,120,142,1.1690140845070423,0.034581319295003014,652,That's just your diabetes delirium.
1632,8478,4,16,122,142,1.1690140845070423,0.037358371028687,652,I always believed in the Good Ship Lollypop and here she is!
918,8478,2,20,120,142,1.1690140845070423,0.034581319295003014,652,I picked the wrong month to do Whole30.
3347,8478,4,16,122,142,1.1690140845070423,0.037358371028687,652,"I told you not to tell her you were giving up sugar for Lent"""
2252,8486,5,15,128,148,1.1689189189189189,0.03761177313491139,652,"Yes, but I'm on a low-carb diet."
3010,8486,3,19,126,148,1.1689189189189189,0.03508259043510859,652,Would you help me unlock the next Candy Crush Saga level please?
7162,8486,3,19,126,148,1.1689189189189189,0.03508259043510859,652,I did not know Christmas Island was a floating island!
9813,8486,2,21,125,148,1.1689189189189189,0.03374699228494797,652,Do you think they're all gluten-free?
9019,8490,2,22,130,154,1.1688311688311688,0.0329687147439996,652,Swimming is a good exercise to gain weight.
2585,8490,2,22,130,154,1.1688311688311688,0.0329687147439996,652,"I could do the swim, but who needs all those carbohydrates?"
5663,8490,5,16,133,154,1.1688311688311688,0.03662763253804509,652,"Before global warming, you could take Gunmdrop Pass right over. Now you have to take the long way around."
7330,8490,3,20,131,154,1.1688311688311688,0.034231835908914245,652,You can have this one. I’d rather have immunity.
9352,8494,2,23,135,160,1.16875,0.032240589041780954,652,"I guess Americans can't figure out the obesity crisis,eh?"
5850,8494,2,23,135,160,1.16875,0.032240589041780954,652,Its a Dylan’s Candy Bar popup”
266,8494,5,17,138,160,1.16875,0.0357114076782865,652,I don’t see anything on my Keto diet.
1723,8494,4,19,137,160,1.16875,0.03459318265444106,652,I reached Ketosis.
4208,8498,2,24,140,166,1.1686746987951808,0.03155754055052784,652,"I believe in multiverse theory, but this is ridiculous!"
2851,8499,0,20,99,119,1.1680672268907564,0.034422676076552354,652,"It may look tempting, but it's a dangerous, ravenous mutant that evolved from a diet of sugary foods."
3733,8499,4,12,103,119,1.1680672268907564,0.04188842371658611,652,"Just my luck, I have to watch my blood sugar level"
4458,8499,2,16,101,119,1.1680672268907564,0.03833771426240422,652,"You fly, I buy?"
6391,8502,2,17,106,125,1.168,0.037219488478223955,652,Ever think of swimming?
8039,8502,5,11,109,125,1.168,0.04209972798931359,652,Used to be a real deal before they raised the price.
6320,8504,2,18,111,131,1.16793893129771,0.0361907125567332,652,It would be sweet to get to that mirage.
7574,8504,2,18,111,131,1.16793893129771,0.0361907125567332,652,That would have certainly played havoc with our diabetes
6712,8504,3,16,112,131,1.16793893129771,0.03777839974721517,652,"'""If only we had one more 'S'!"""
1944,8504,1,20,110,131,1.16793893129771,0.03453010082909961,652,If we do a cheeseburger stand on our island we might consider not offering deserts.
3870,8504,3,16,112,131,1.16793893129771,0.03777839974721517,652,The candy man is here.
6442,8504,2,18,111,131,1.16793893129771,0.0361907125567332,652,You go. I can just look at it for a really sweet high.
7375,8510,2,19,116,137,1.167883211678832,0.03524030104440121,652,Candy land ... your move!
7094,8510,2,19,116,137,1.167883211678832,0.03524030104440121,652,Insulin? Of course there's insulin.  It's behind the chocolate mousse cupcake.
8392,8510,3,17,117,137,1.167883211678832,0.036731744100379986,652,Don't fall for it. It's only acting like a mirage to get us to not go over there.
4412,8510,2,19,116,137,1.167883211678832,0.03524030104440121,652,Let's pass on this one..I never did like Shirley Temple!
8874,8510,3,17,117,137,1.167883211678832,0.036731744100379986,652,High sugar is better than no food.
9658,8510,2,19,116,137,1.167883211678832,0.03524030104440121,652,Too bad sugar is so toxic.
8428,8510,3,17,117,137,1.167883211678832,0.036731744100379986,652,Too bad I’m cutting back on carbs.
6580,8510,2,19,116,137,1.167883211678832,0.03524030104440121,652,Want to try digging for gum drops?
2376,8510,6,11,120,137,1.167883211678832,0.0408808958503006,652,I think I'm seeing hallucinations. I shouldn't have drank from the molasses ocean.
3673,8510,7,9,121,137,1.167883211678832,0.04217333105742182,652,It's the old 'Grass always looks greener......' Bullshit.
2563,8510,3,17,117,137,1.167883211678832,0.036731744100379986,652,This weight loss program is really testing me.
1672,8510,2,19,116,137,1.167883211678832,0.03524030104440121,652,Maybe we should have taken a right at the dessert island instead.
736,8510,2,19,116,137,1.167883211678832,0.03524030104440121,652,"Gluton free or not, I'm all over it."
217,8510,3,17,117,137,1.167883211678832,0.036731744100379986,652,The dessert mirage aids our hunger pains.
6028,8510,1,21,115,137,1.167883211678832,0.0336828830527354,652,Luckily we are gluten free.
847,8525,3,18,122,143,1.167832167832168,0.03576355974804333,652,It is my nutricionist trying me
3195,8525,5,14,124,143,1.167832167832168,0.03841898382741188,652,"No, man, I'm on a low-carb diet."
6144,8525,4,16,123,143,1.167832167832168,0.03711502744295631,652,It all looks wonderful but is it gluten free?
6764,8525,1,22,120,143,1.167832167832168,0.032894469039229,652,If only we weren't vegan...
8872,8525,4,16,123,143,1.167832167832168,0.03711502744295631,652,"Actually, now that I've been on the keto diet for a month, I'm not tempted."
4159,8530,4,17,128,149,1.167785234899329,0.036142045685466466,652,Is that a sign that we have to wait until Christmas to be rescued?
4193,8530,5,15,129,149,1.167785234899329,0.03737568979828399,652,Just when I thought I had this low-sugar diet thing licked!
3117,8530,2,21,126,149,1.167785234899329,0.033538903130483196,652,"Shame we don't touch gluten and dairy."""
9085,8530,2,21,126,149,1.167785234899329,0.033538903130483196,652,I wish I hadn’t gone keto
9134,8530,2,21,126,149,1.167785234899329,0.033538903130483196,652,"It's probably a mirage but if it isn't, it would be bad for our health."
8677,8530,4,17,128,149,1.167785234899329,0.036142045685466466,652,Definitely my personal best.
2402,8530,1,23,125,149,1.167785234899329,0.032158409500917966,652,Sugar is not good-----but water would help
1171,8530,2,21,126,149,1.167785234899329,0.033538903130483196,652,"Brad, you know how sugar mirages affects you."
2072,8530,4,17,128,149,1.167785234899329,0.036142045685466466,652,Check out the big rock candy mountain.
1780,8530,2,21,126,149,1.167785234899329,0.033538903130483196,652,"Diabetes will soon be a bigger global issue than starvation, so we got the safer island."
2439,8530,1,23,125,149,1.167785234899329,0.032158409500917966,652,This keto diet sucks.
551,8530,1,23,125,149,1.167785234899329,0.032158409500917966,652,"I know it's the only food for miles, but I'm sticking to my Keto diet."
380,8530,3,19,127,149,1.167785234899329,0.03486477799675684,652,Can we agree to disagree?
229,8530,1,23,125,149,1.167785234899329,0.032158409500917966,652,"Diabetes Island"" even the pirates avoided it back in the da"
5639,8544,1,24,130,155,1.167741935483871,0.03146919792415939,652,You think those alien dudes have any salt water taffy?
4500,8544,4,18,133,155,1.167741935483871,0.03523736595822736,652,How long has it been since you and Princess Lolly broke up?
4258,8544,0,26,129,155,1.167741935483871,0.030108524331633125,652,I'm glad I'm here.  The other island would kill my diet.
7388,8544,2,22,131,155,1.167741935483871,0.03277342823921983,652,"I thought you said it was an Eminem concert""
"" I said we are going to see an M&M"
1307,8544,2,22,131,155,1.167741935483871,0.03277342823921983,652,I would swim over with you but I'm on the keto diet.
618,8544,2,22,131,155,1.167741935483871,0.03277342823921983,652,I've heard this is the only way you can really stick to the Whole30 diet
264,8544,4,18,133,155,1.167741935483871,0.03523736595822736,652,I'll pass. My doctor told me I need to cut down on sweets.
4083,8544,2,22,131,155,1.167741935483871,0.03277342823921983,652,"It might be the 'Good Ship Lollipop', but I had always 
imagined it would have billowing sails.   This looks like a spaceship from a Dunkin D on Mars."
2328,8552,2,23,136,161,1.1677018633540373,0.03205685075753266,652,"If you go over there, please don't overstay your welcome."
5924,8552,4,19,138,161,1.1677018633540373,0.0343936212631981,652,You are the dumbest castaway I have ever met.
8741,8552,3,21,137,161,1.1677018633540373,0.03324577314552209,652,After a couple more decades we will probably fall for it.
2052,8555,5,19,149,173,1.1676300578034682,0.03387165324859164,652,"Not for me, I'm gluten free."
6191,8556,1,21,116,138,1.1666666666666667,0.03346003635585099,652,This diet is too extreme.
6159,8556,4,16,124,144,1.1666666666666667,0.036874806572392484,652,What were the odds of our being marooned across from the home port of The Good Ship Lollipop?
6118,8556,3,19,128,150,1.1666666666666667,0.034649625823724085,652,"You refused to pay the extra $100 g
to go to the sweet island. So here we are."
6109,8556,2,21,127,150,1.1666666666666667,0.03333333333333334,652,I've been watching my weight.
5419,8556,3,22,143,168,1.1666666666666667,0.03233462527439859,652,"Yes, your mirage does intrigue me, but I'm trying to stick to my keto diet."
5975,8556,0,24,120,144,1.1666666666666667,0.031164899666948572,652,"Somehow, I have this intense  craving for salt water taffy"
5714,8556,3,17,118,138,1.1666666666666667,0.03648488835845413,652,"Alas, my doctor told me to avoid sweets."
6230,8556,3,19,128,150,1.1666666666666667,0.034649625823724085,652,The view is somewhat deceiving; it's actually 1% the size of ours.
5264,8556,1,23,126,150,1.1666666666666667,0.03196287928985961,652,"Not again, Stu. How quickly you forget the muffin’s ill effects."
6351,8556,1,21,116,138,1.1666666666666667,0.03346003635585099,652,Where's Gumdrop pass?
8931,8556,1,21,116,138,1.1666666666666667,0.03346003635585099,652,"I would,but I'm on a diet."
6549,8556,2,20,122,144,1.1666666666666667,0.03413943709994594,652,That Captain Nemo is always so ingenious.  He got us before  but not again.
7337,8556,4,15,119,138,1.1666666666666667,0.03790690703982399,652,"Hey! I'll swim over there, and  let you know if there's any Dunkin Donuts latte to go with it!"
7773,8556,1,23,126,150,1.1666666666666667,0.03196287928985961,652,"Well, I don't see any Big Rock Candy Mountain."
7793,8556,4,16,124,144,1.1666666666666667,0.036874806572392484,652,Too bad I'm still on the keto diet.
8539,8556,1,25,136,162,1.1666666666666667,0.03064873802040947,652,It would be more ironic if I could have gluten.
8557,8556,2,22,132,156,1.1666666666666667,0.032580413127335194,652,Your expectations are unrealistic. No relationship is perfect.
8712,8556,2,19,117,138,1.1666666666666667,0.03500515041721526,652,"fuck the diet, im goin!"
4905,8556,3,20,133,156,1.1666666666666667,0.033825970872786895,652,I only splurge for crème brûleé.
9564,8556,1,25,136,162,1.1666666666666667,0.03064873802040947,652,"We can enjoy without getting fat"""
9848,8556,5,16,135,156,1.1666666666666667,0.03618870372594482,652,How many more islands do you think we can eat into deserts?
9930,8556,2,19,117,138,1.1666666666666667,0.03500515041721526,652,"I think they're staring at us."" ""I would too."
6525,8556,2,15,97,114,1.1666666666666667,0.03923794084373004,652,Too sweet for me.
4715,8556,4,16,124,144,1.1666666666666667,0.036874806572392484,652,"Nigel, we fucked ourselves. Europe is better."
2797,8556,0,22,110,132,1.1666666666666667,0.032561027715190156,652,I’m beginning to rethink my vegan commitment.
4233,8556,2,20,122,144,1.1666666666666667,0.03413943709994594,652,"'Hey Timmy, good thing i'm diabetic!"""
30,8556,2,20,122,144,1.1666666666666667,0.03413943709994594,652,I really regret staying on Keto Island
252,8556,5,13,120,138,1.1666666666666667,0.0392774760406375,652,"I would, but sugar is really bad for you."
290,8556,5,13,120,138,1.1666666666666667,0.0392774760406375,652,I'm still doing the Paleo Diet.
300,8556,4,19,139,162,1.1666666666666667,0.03419632802726443,652,"I told you ""vegan island"" was not our safest bet."
331,8556,3,17,118,138,1.1666666666666667,0.03648488835845413,652,I'm strictly keto.
421,8556,2,17,107,126,1.1666666666666667,0.036946980459563475,652,Remember when they told us a flying cupcake would be coming?
547,8556,3,18,123,144,1.1666666666666667,0.035533452725935076,652,...and you were doing so well with your keto diet.
816,8556,7,10,127,144,1.1666666666666667,0.04063405777333407,652,"First the crash, then an island with all carbs"
4493,8556,2,20,122,144,1.1666666666666667,0.03413943709994594,652,You wanted to go keto..
917,8556,4,18,134,156,1.1666666666666667,0.035027264972095955,652,So - the Big Rock Candy Mountain is diversifying to Oceanfront.
1465,8556,4,16,124,144,1.1666666666666667,0.036874806572392484,652,"Our only barrier are sharks, no walls."
900,8556,6,15,141,162,1.1666666666666667,0.036369648372665396,652,"For some reason, I'm suddenly up for a game of Candyland."
1522,8556,2,19,117,138,1.1666666666666667,0.03500515041721526,652,"If I lived there, I'd never go home."
2034,8556,3,16,113,132,1.1666666666666667,0.037512688371818655,652,That must be the lesser-known island of misfit desserts.
2132,8556,4,20,144,168,1.1666666666666667,0.033418767048852785,652,I didn't manifest my dream with the correct spelling.
2184,8556,3,19,128,150,1.1666666666666667,0.034649625823724085,652,It's great to see The Good Ship Lollipop has been updated.
2326,8556,5,12,115,132,1.1666666666666667,0.04047866883790824,652,Go for it. My doctor suggested I reduce my sugar.
2818,8556,2,21,127,150,1.1666666666666667,0.03333333333333334,652,"Looks like the good ship lollipop sank!""
Suzi Rines, Duxbury M"
3084,8556,2,21,127,150,1.1666666666666667,0.03333333333333334,652,I think the candy canes are a mirage!
3457,8556,2,22,132,156,1.1666666666666667,0.032580413127335194,652,I think we should go. Big Candy researchers say there's nothing to fear from life on a dessert island.
3471,8556,1,21,116,138,1.1666666666666667,0.03346003635585099,652,"Ohh man, why couldn´t we land in candy-island."
4027,8556,3,15,108,126,1.1666666666666667,0.03862723769652047,652,"Sweet, you stranded us on the wrong dessert-ed island."
1497,8556,1,17,96,114,1.1666666666666667,0.0372069967416221,652,A short swim to a mirage.... yesterday’s vision was dancing with the stars.
2736,8605,5,19,151,175,1.1657142857142857,0.033510670660077825,652,Maybe they’d like a ride when the good ship Broccoli shows up.
7969,8606,2,23,138,163,1.165644171779141,0.03169550903220905,652,"So you’re new here, huh?"
1176,8606,1,25,137,163,1.165644171779141,0.03047728548890001,652,And we'll mark our path with crumbs of ship's biscuit so we don't get lost.
4055,8606,3,21,139,163,1.165644171779141,0.03286861200065765,652,"Look, there’s Jeffrey Epstein’s island."
9309,8609,3,20,134,157,1.1656050955414012,0.03362658902752621,652,"All that, and I chose you. Now will you come meet my parents?"
8284,8609,4,18,135,157,1.1656050955414012,0.0348196324930958,652,This is taking the Keto diet a little too far.
2198,8609,5,16,136,157,1.1656050955414012,0.03597313058773673,652,"Swim over? No thanks, I'm on a strict Keto diet."
2903,8609,5,16,136,157,1.1656050955414012,0.03597313058773673,652,Don't believe it.  Its just the head of an alien emerging from the deep
9272,8613,6,13,132,151,1.1655629139072847,0.03808954660807525,652,I don't know what to think.  The last giant hotdog I met wouldn't admit it was a hotdog either.
6976,8613,7,11,133,151,1.1655629139072847,0.03923154064728135,652,"Nah, I rather have bugs"
6645,8613,2,21,128,151,1.1655629139072847,0.033130238118771936,652,"Ugh Jayne, do you see that island too?"
4057,8613,3,19,129,151,1.1655629139072847,0.03443708609271524,652,Don't be fooled. Sugar puts on the pounds.
5967,8613,3,19,129,151,1.1655629139072847,0.03443708609271524,652,"This is an old Alien trick Jerry
I am not swimming over to “Candy Island”"
6140,8613,5,15,131,151,1.1655629139072847,0.03691223835069048,652,"I booked for ""deserted"" islands, but I guess my spell check turned it into a ""desert"" island."
8266,8619,3,18,124,145,1.1655172413793105,0.03530625874346591,652,Do you think anything over there is Whole30?
7202,8619,3,18,124,145,1.1655172413793105,0.03530625874346591,652,I always knew my lack of spelling skills would come back to haunt me. Two island choices and I forgot an “s.”
5781,8619,1,22,122,145,1.1655172413793105,0.03248016356539033,652,Or maybe we’re just seeing the bald spot on top of the Candyland Sea Monster?
4483,8619,5,14,126,145,1.1655172413793105,0.03792232571568649,652,I told you being vegan wasn't the best idea
6937,8619,2,20,123,145,1.1655172413793105,0.03392265416867519,652,I would so rule that island.  I have that app on my phone.
2943,8619,4,16,125,145,1.1655172413793105,0.03663764931151547,652,I told you this keto diet works.
2879,8619,1,22,122,145,1.1655172413793105,0.03248016356539033,652,"I don5 know about you, but I see Candyland"
2393,8619,1,22,122,145,1.1655172413793105,0.03248016356539033,652,It's too bad we crashed next to Candy Island.  I'm watching my carbs this week.
1902,8619,2,20,123,145,1.1655172413793105,0.03392265416867519,652,Did I tell you I was a vegan?
3924,8619,3,18,124,145,1.1655172413793105,0.03530625874346591,652,I am finally losing weight!
2501,8629,2,19,118,139,1.1654676258992807,0.03477308107373989,652,It's much easier keeping keto over here.
3648,8629,6,11,122,139,1.1654676258992807,0.040326477971453646,652,"Look Herv’e, it’s Fantasy Island!"
3949,8629,2,19,118,139,1.1654676258992807,0.03477308107373989,652,You can go for it but I’ve just gone Paleo.
7594,8629,1,21,117,139,1.1654676258992807,0.033240077509018764,652,"I'm going to paddle on our palm fronds 
I'll send what's left back on the cupcake boat."
8757,8629,2,19,118,139,1.1654676258992807,0.03477308107373989,652,You swim for it. I'm a diabetic.
9531,8634,1,20,112,133,1.1654135338345866,0.034055379435772214,652,"Candy Cane, Cupcake and...Strawberry Cheesecake. What about you?"
5723,8634,3,16,114,133,1.1654135338345866,0.03725065370728289,652,I'd still rather get the full experience.
3935,8634,2,18,113,133,1.1654135338345866,0.03568879425067709,652,I think it’s real but I try to avoid carbs.
4692,8634,5,12,116,133,1.1654135338345866,0.04019270499388414,652,"If I hadn't lost my insulin pump when the ship went down, I would definitely swim over there."
5645,8634,4,14,115,133,1.1654135338345866,0.03874961120027727,652,I know we haven’t eaten in a week but my nutritionist has me on a sugarless diet.
4070,8639,3,15,109,127,1.1653543307086613,0.038344343192484386,652,This isn't good for my low blood sugar.
5785,8639,2,17,108,127,1.1653543307086613,0.03667838979440268,652,I moved here because I wanted to cut down on carbs. How about you?
7732,8639,4,13,110,127,1.1653543307086613,0.039940869192043184,652,When is our whole thirty time up?
4835,8642,1,18,102,121,1.165289256198347,0.03588147660511141,652,We certainly will live longer on this island with our healthy vegetative food.
9581,8642,2,16,103,121,1.165289256198347,0.03775210471212318,652,Big rock candy island—bad for your teeth.
9717,8644,4,21,151,176,1.1647727272727273,0.03234432792618295,652,That's the Swiss Family Robinson island.
2704,8645,4,19,141,164,1.1646341463414633,0.03380839479051624,652,Whatever happened with you and Rhonda.
6929,8645,3,21,140,164,1.1646341463414633,0.03268318924499519,652,Darn...this is the week I have gone keto and sworn off of sugar.
1488,8647,3,20,135,158,1.1645569620253164,0.033429520100224736,652,I thought we were giving up sugar.
2455,8647,3,20,135,158,1.1645569620253164,0.033429520100224736,652,"It's definitely a mirage, right?"
2983,8647,1,24,133,158,1.1645569620253164,0.030923801576850714,652,So you had to anger the captain of an alien spaceship.
5937,8650,1,23,128,152,1.1644736842105263,0.031578765829616454,652,"I preyed to god for water,girls and food. Why would he send the good ship lollipop"
7742,8650,2,21,129,152,1.1644736842105263,0.032929573745531966,652,"Oh, my mother would kill me if I ate that stuff."
4624,8650,4,17,131,152,1.1644736842105263,0.035477226195741125,652,I’d swim there but I’m doing Whole 30
3938,8650,3,19,130,152,1.1644736842105263,0.034227112101419016,652,They would have outnumbered us 2 to 1 if it weren't for diabetes.
3537,8650,2,21,129,152,1.1644736842105263,0.032929573745531966,652,It's a pity we're diabetic.
2936,8650,2,21,129,152,1.1644736842105263,0.032929573745531966,652,I bet the hens lay soft boiled eggs
1187,8650,3,19,130,152,1.1644736842105263,0.034227112101419016,652,"I'm sick of coconuts, too, but with our luck, we'll have to swim through shark infested waters to find out they're either not gluten-free or a mirage."
9846,8657,3,18,125,146,1.1643835616438356,0.035081923502890106,652,Is it eye candy or cavities?
8733,8657,3,18,125,146,1.1643835616438356,0.035081923502890106,652,I swear I saw coconuts.
7456,8657,5,14,127,146,1.1643835616438356,0.037678747049785966,652,"Sorry,  I’m. Gluten. Free"
6713,8657,2,20,124,146,1.1643835616438356,0.033708575249824374,652,Darn it. I'm off sugars!
3908,8657,2,20,124,146,1.1643835616438356,0.033708575249824374,652,"It's really tempting, but I'm gluten intolerant."
3243,8657,2,20,124,146,1.1643835616438356,0.033708575249824374,652,"Did you know, Fred, that readers of The New Yorker, when they're tired, hungry, and thirsty, have been know to project comical scenes into cartoons?"
2814,8657,2,20,124,146,1.1643835616438356,0.033708575249824374,652,"Being diabetic, I’m happy where I am."
2346,8657,4,16,126,146,1.1643835616438356,0.036403498018077796,652,"No Jeff, it's not going to be a piece of cake and you know I'm doing Paleo."
2128,8657,1,22,123,146,1.1643835616438356,0.032276845169308475,652,"I am not anxious at all. I explicitly asked the agency 
for a frugal vacation."
1102,8657,2,20,124,146,1.1643835616438356,0.033708575249824374,652,I’m on the no-sugar-no-carb challenge.
1034,8657,4,16,126,146,1.1643835616438356,0.036403498018077796,652,I picked the wrong week to give up fatty foods!
339,8657,3,18,125,146,1.1643835616438356,0.035081923502890106,652,People with type 2 diabetes are not allowed on that desert island.
146,8657,3,18,125,146,1.1643835616438356,0.035081923502890106,652,It's part of the Sugary New Deal.
9500,8670,5,13,122,140,1.1642857142857144,0.03875067785862603,652,What do we do now for fun?
8081,8670,2,19,119,140,1.1642857142857144,0.034544033721419766,652,"We discovered it, so we get to name it. And “Candy Land” is a great name, but we’d never get it by the Hasbro copyright lawyers."
6775,8670,3,17,120,140,1.1642857142857144,0.0360009053867454,652,"Yes, but will we find dental floss?"
5354,8670,3,17,120,140,1.1642857142857144,0.0360009053867454,652,You'll deserve a treat if the sharks don't get you!
1478,8670,0,23,117,140,1.1642857142857144,0.031428337848333154,652,Did you just say you are on the keto diet?
2450,8670,4,15,121,140,1.1642857142857144,0.03740107099514934,652,I DON'T SEE A LOW FAT SMOOTHY ON THAT ISLAND.
1657,8670,4,15,121,140,1.1642857142857144,0.03740107099514934,652,"Sorry, I have diabetes..."
542,8670,4,15,121,140,1.1642857142857144,0.03740107099514934,652,I'm more of a chocolate cake guy.
3368,8670,4,15,121,140,1.1642857142857144,0.03740107099514934,652,Stop worrying about calories.  The swim there and back will take care of that problem.
763,8679,3,16,115,134,1.164179104477612,0.03699222083773449,652,My dentist insisted it was the best charter available.
1557,8679,3,16,115,134,1.164179104477612,0.03699222083773449,652,I’ve heard that’s where Katy Perry filmed one of her music videos.
1809,8679,1,20,113,134,1.164179104477612,0.03382281332532264,652,I think it's a Fataning Morgana.
3376,8679,5,12,117,134,1.164179104477612,0.03991072667561709,652,I never expected Candy Land to get an Xtreme version.
4729,8679,3,16,115,134,1.164179104477612,0.03699222083773449,652,Its only a damn illusion.
4792,8679,3,16,115,134,1.164179104477612,0.03699222083773449,652,"Well, I am guessing Oompa Loompas forgot about us!"
8045,8679,4,14,116,134,1.164179104477612,0.03847915348785321,652,I’d rather stay on our Keto diet
9666,8679,2,18,114,134,1.164179104477612,0.03544296195119237,652,I've seen others there on Instagram.
3737,8687,2,17,109,128,1.1640625,0.03641363378114903,652,"Well,  I was going to give up sugar for Lent, but..."
3592,8687,2,17,109,128,1.1640625,0.03641363378114903,652,We need to eat the goodies there; they'll dissolve in the water!
8100,8689,3,14,105,122,1.1639344262295082,0.03923232960085896,652,Doesn't look very vegan to me
9961,8690,4,19,142,165,1.1636363636363636,0.03361768123424875,652,"This isn't exactly the mirage I was looking for""

By Amy Pau"
8138,8690,1,16,93,110,1.1636363636363636,0.03771468483790463,652,"I scream for ice cream, but I don't swim for dessert."
8191,8692,3,20,136,159,1.1635220125786163,0.03323472458075441,652,I was hoping for the Big Rock Candy Mountain and a train to LA
8725,8692,2,22,135,159,1.1635220125786163,0.0320146126332741,652,"I know where we are, we're near The Big Rock Candy Mountain!"
9820,8692,1,24,134,159,1.1635220125786163,0.030746120505822934,652,"That one is spelled with 2 ""s""s."
28,8695,2,21,130,153,1.1633986928104576,0.032731297476972745,652,It's too bad Oompa Loompas are hostile in real life
2609,8695,4,17,132,153,1.1633986928104576,0.03526097642631427,652,"So, among other problems, you obviously don’t know a trochee from an iamb."
4056,8695,2,21,130,153,1.1633986928104576,0.032731297476972745,652,"Sure, it's tempting, but it'd wreak havoc on my thighs."
8325,8695,2,21,130,153,1.1633986928104576,0.032731297476972745,652,"Just my luck: Cupcake Island floats by right when my blood sugar levels are testing too high.""
John Canning
Sea Cliff, N"
8881,8699,4,16,127,147,1.163265306122449,0.036172296468796966,652,I thought candy canes were vegan!
8437,8699,2,20,125,147,1.163265306122449,0.03349715079817141,652,"If you misspell it, it will come true."
8008,8699,3,18,126,147,1.163265306122449,0.034860394026903774,652,"Candy is not part of my diet, but I could say ""to hell with it."
7901,8699,4,16,127,147,1.163265306122449,0.036172296468796966,652,It is just a figment of Trump’s illusion.
6270,8699,1,22,124,147,1.163265306122449,0.032076021440943736,652,Do you think they have coconuts?
4007,8699,3,18,126,147,1.163265306122449,0.034860394026903774,652,Don’t think about it!  Experts say too much sugar in your diet leads to a shorter lifespan!
1100,8699,2,20,125,147,1.163265306122449,0.03349715079817141,652,"No, I don't have any insulin. Why do you ask?"
783,8699,1,22,124,147,1.163265306122449,0.032076021440943736,652,"We have all of the flavor, none of the guilt."
11,8699,3,18,126,147,1.163265306122449,0.034860394026903774,652,"I think I’m hallucinating from hunger...do you see what I see, Giant Roast Turkey?"
5001,8699,3,18,126,147,1.163265306122449,0.034860394026903774,652,Shark’s bait
8922,8709,4,15,122,141,1.1631205673758864,0.03715314219814079,652,Last week it was a united US Congress
9835,8709,4,15,122,141,1.1631205673758864,0.03715314219814079,652,And you're worried about cavities
9792,8709,3,17,121,141,1.1631205673758864,0.03576365267421032,652,Are those Vegan sweets?
9555,8709,4,15,122,141,1.1631205673758864,0.03715314219814079,652,"Are you seeing that too, or do I need a stronger prescription?"
9135,8709,1,21,119,141,1.1631205673758864,0.03280860569140533,652,I say we lose the Fitbits after we swim to Dessert Island.
8647,8709,5,13,123,141,1.1631205673758864,0.03849250703434355,652,Does the Wicked Witch of East Timor Come to Mind?
3225,8709,3,17,121,141,1.1631205673758864,0.03576365267421032,652,I AM NOT TEMPTED BY OTHER ISLAND I HAVE MOST BEAUTIFUL SWEETHEART IN WORLD HERE
7680,8709,2,19,120,141,1.1631205673758864,0.03431795055080989,652,I think we are seeing the same mirage!
6237,8709,3,17,121,141,1.1631205673758864,0.03576365267421032,652,"Yeah, it looks nice, but I'm Paleo."
5956,8709,3,17,121,141,1.1631205673758864,0.03576365267421032,652,That’s one hell of a jelly fish. Death by e.ectrocution or sugar high!
5764,8709,2,19,120,141,1.1631205673758864,0.03431795055080989,652,Maybe this is for the best...
7794,8709,2,19,120,141,1.1631205673758864,0.03431795055080989,652,Sea levels rose and we got severely delirious.
1290,8721,2,18,115,135,1.162962962962963,0.035200456375828436,652,I hope this mirage doesn’t count against my 10 day no sugar challenge?
3212,8721,3,16,116,135,1.162962962962963,0.03673731683969508,652,It's the first time I long for a submarine eruption.
4380,8721,2,18,115,135,1.162962962962963,0.035200456375828436,652,I like the way this garbage gyre is shaping up.
5431,8721,2,18,115,135,1.162962962962963,0.035200456375828436,652,Thank God we're here.  I'm off gluten and sugar.
7593,8721,1,20,114,135,1.162962962962963,0.033593359605032916,652,"oh the buzzing of the bees and the cigarette trees
and the big rock candy mountain"
9247,8726,3,15,111,129,1.1627906976744187,0.037790697674418616,652,mirages around here make my fillings ache.
9844,8726,0,21,108,129,1.1627906976744187,0.03263073302419136,652,Just look at all that added sugar! We are so lucky to not be marooned on that island!
9376,8726,1,19,109,129,1.1627906976744187,0.034436735744024935,652,"Yeah, but as far as mirages go, I prefer mine in Technicolor."
7620,8726,2,17,110,129,1.1627906976744187,0.03615263198871635,652,"It's powerful motivation to take swimming lessons, don't you think?"
395,8726,3,15,111,129,1.1627906976744187,0.037790697674418616,652,"Hunger is causing us illusions, it's not an island full of treats-it's an alien's head with it's antennas popping out!"
2371,8726,3,15,111,129,1.1627906976744187,0.037790697674418616,652,"I’d swim for it, but I’m gluten free."
1127,8732,2,16,105,123,1.1626016260162602,0.03718393166501752,652,Actually there's a surprising amount of snakes.
2546,8732,3,14,106,123,1.1626016260162602,0.038934878905596916,652,"Gee whiz, just think how easy Candy Land was to play as a kid."
6575,8732,4,12,107,123,1.1626016260162602,0.040610402814036446,652,"""Why, no really, why?"""
9665,8732,4,12,107,123,1.1626016260162602,0.040610402814036446,652,I hear you need a golden ticket to get on.
5871,8736,1,24,135,160,1.1625,0.03057044139021308,652,Next year we are switching our rental from VRBO to Airbnb
5906,8736,3,20,137,160,1.1625,0.03304216383947893,652,"Personally, I'm just not into desserts."
7415,8736,4,18,138,160,1.1625,0.034211123094634394,652,I think we're going to need a longer candy cane.
8801,8736,2,22,136,160,1.1625,0.03183030378418828,652,Martha Stewart to the rescue!
8848,8736,4,18,138,160,1.1625,0.034211123094634394,652,You didn't tell me that you were inviting your parents to dinner!
8786,8741,3,19,132,154,1.1623376623376624,0.033814679942939393,652,"No thanks,my diet emphasizes portion control"
5957,8741,2,21,131,154,1.1623376623376624,0.03253536755316917,652,I forgot my dice.
9447,8741,2,21,131,154,1.1623376623376624,0.03253536755316917,652,Ask not whether the big rock candy mountain can come to you but whether you can come to the big rock candy mountain.
1619,8741,2,21,131,154,1.1623376623376624,0.03253536755316917,652,China builds military islands. I build candy islands. Easy as pie.
2888,8741,3,19,132,154,1.1623376623376624,0.033814679942939393,652,Race you!
7836,8746,2,20,126,148,1.162162162162162,0.03328833244884829,652,Global warming isn't working in our favor here
7584,8746,1,22,125,148,1.162162162162162,0.03187764755856071,652,The cruise signup cost me big too. And I never did well in spelling bees either.
5929,8746,1,22,125,148,1.162162162162162,0.03187764755856071,652,Still on that Keto diet?
5770,8746,3,18,127,148,1.162162162162162,0.03464161861954895,652,We should’ve built a boat rather than that.
5402,8746,2,20,126,148,1.162162162162162,0.03328833244884829,652,Bad week to start Keto.
5286,8746,3,18,127,148,1.162162162162162,0.03464161861954895,652,"Can’t do it, I’m on keto."
2282,8746,2,20,126,148,1.162162162162162,0.03328833244884829,652,This Keto diet thing is killing me.
2143,8746,3,18,127,148,1.162162162162162,0.03464161861954895,652,Are you secretly the witch from Hansel and Gretel?
1257,8746,2,20,126,148,1.162162162162162,0.03328833244884829,652,"I remember a Peppermint Forest and the Gumdrop Mountains, but there was never a Dessert Island

Alec Petty (Charlotte, NC)"
1124,8746,4,16,128,148,1.162162162162162,0.03594398981665106,652,"Next thing your going to say is, ‘drink the sea water if your thirsty’, I’m diabetic Terry!"
603,8746,1,22,125,148,1.162162162162162,0.03187764755856071,652,A mirage at sea is always fun.
4600,8746,5,14,129,148,1.162162162162162,0.037200793906807285,652,Pretty sure candy canes are Paleo ...
7188,8758,4,15,123,142,1.1619718309859155,0.03690845346306802,652,Those shark bastards didn't count on us being partial to coconuts.
7663,8758,2,19,121,142,1.1619718309859155,0.0340947751906559,652,Is that stuff organic?
5277,8758,4,15,123,142,1.1619718309859155,0.03690845346306802,652,"On second thought, I don’t think I’d like to spend Christmas on Christmas Island."
7756,8758,1,21,120,142,1.1619718309859155,0.03259698719873232,652,Too crowded and noisy.
3897,8758,5,13,124,142,1.1619718309859155,0.03823773081528903,652,Are mirages considered keto?
3739,8758,1,21,120,142,1.1619718309859155,0.03259698719873232,652,Up for a little blood sugar swim?
1017,8758,3,17,122,142,1.1619718309859155,0.035529478129694106,652,I wonder if they’re gluten free?
5020,8758,0,23,119,142,1.1619718309859155,0.031026979446399112,652,"It’s tempting, but it would ruin my diet."
8727,8758,4,15,123,142,1.1619718309859155,0.03690845346306802,652,Not a good week to start my Whole30 progam.
5894,8767,2,18,116,136,1.161764705882353,0.034961211365468606,652,Voodoo is changing its supply chain.
6036,8767,3,16,117,136,1.161764705882353,0.036485870717506655,652,You and I... we are hegemons
3658,8767,2,18,116,136,1.161764705882353,0.034961211365468606,652,"Is it just me, or do you see the Isle of Carbs and Candyland on the horizon too?"
7302,8767,5,12,119,136,1.161764705882353,0.03935840044719661,652,The plastic litter is only one of the issues...expecting kids cruises dumping is killing me.
1395,8767,3,16,117,136,1.161764705882353,0.036485870717506655,652,How come our desserted island didn’t come with any treats?
3228,8767,1,20,115,136,1.161764705882353,0.03336695728212767,652,"Just my luck, I’ve just started my no sugar diet."
1273,8767,2,18,116,136,1.161764705882353,0.034961211365468606,652,"Don't be fooled Ross, that's a UFO using goodies to trick us."
1647,8774,3,21,143,167,1.1616766467065869,0.03213914142630027,652,I don't remember seeing that franchise before.
3006,8774,4,19,144,167,1.1616766467065869,0.03324258230812478,652,Shirley Temple was eaten by a shark and didn't make it.
8894,8776,1,19,110,130,1.1615384615384616,0.034193748280183574,652,I think you've had too much sun. Those are clearly pixie sticks.
7123,8776,2,17,111,130,1.1615384615384616,0.035895306180967736,652,I read that sharks have a sweet tooth.
4712,8776,4,13,113,130,1.1615384615384616,0.039076772827079095,652,"Yeah, right, who knew this  fancy giant mermaid would be so helpful !"
4761,8776,4,13,113,130,1.1615384615384616,0.039076772827079095,652,"Makes me think of playing the board game, Candy Land, it also makes me think of never take candy from a stranger."
2561,8776,2,17,111,130,1.1615384615384616,0.035895306180967736,652,It landed last night - out of mid-air.
1523,8776,1,19,110,130,1.1615384615384616,0.034193748280183574,652,"You know, that Wonka guy really found the silver lining in all of this."
558,8776,2,17,111,130,1.1615384615384616,0.035895306180967736,652,I bet it's not rent controlled...
2710,8776,4,13,113,130,1.1615384615384616,0.039076772827079095,652,"Hey, it's not my fault Pia Guerra can't spell."
3475,8784,3,20,138,161,1.1614906832298137,0.03285180010337364,652,This is the worst diet i’ve ever done
5270,8784,4,18,139,161,1.1614906832298137,0.03401294638200013,652,I think they are re-opening the L train next week
5352,8784,4,18,139,161,1.1614906832298137,0.03401294638200013,652,Ain't gentrification sweet?
8153,8787,5,15,135,155,1.1612903225806452,0.0360187436283279,652,"Ya-ya, I also see something real but your reality has always been different tmine."
8301,8787,0,25,130,155,1.1612903225806452,0.029638049695557594,652,"""We should have been marooned ""On the good ship lollipop""."""
9690,8789,2,20,127,149,1.1610738255033557,0.033082072983284624,652,"I have to pass, I'm doing keto."
4393,8789,1,22,126,149,1.1610738255033557,0.03168167974246577,652,Battleship would've been optimal.
1175,8789,4,16,129,149,1.1610738255033557,0.03571852454967562,652,That must be a trap!
32,8789,4,16,129,149,1.1610738255033557,0.03571852454967562,652,"Ugh, there's two S's in dessert, man."
5332,8793,1,26,147,174,1.160919540229885,0.02910204238464233,652,Did you see that shark fin? There it is again.
9706,8794,1,21,121,143,1.1608391608391608,0.03238804543473721,652,"Just add an ""s"" and voila!"
7159,8794,1,21,121,143,1.1608391608391608,0.03238804543473721,652,I was wondering why water does't taste salty today.
4809,8794,3,17,123,143,1.1608391608391608,0.03529832290012759,652,I wish the sharks had a sweet tooth. We might negotiate a deal.
3497,8794,2,19,122,143,1.1608391608391608,0.03387445266453964,652,"Deserted. Dessert.  Who cares what kind of an island it is? Besides, I forgot my insulin."
4145,8794,2,19,122,143,1.1608391608391608,0.03387445266453964,652,"Don't be a fool, you'll rot your teeth."
1864,8794,1,21,121,143,1.1608391608391608,0.03238804543473721,652,"You go ahead, I just hate that sugar crash."
1808,8794,1,21,121,143,1.1608391608391608,0.03238804543473721,652,But my blood sugar!
953,8794,4,15,124,143,1.1608391608391608,0.03666694227504125,652,"Yep, that's the Wicked Witch of the South Seas over there."
118,8794,3,17,123,143,1.1608391608391608,0.03529832290012759,652,"I would, but I’m really trying to stay on track with this new ketogenic thing."
2651,8794,2,19,122,143,1.1608391608391608,0.03387445266453964,652,I say the grass isn't always greener...
1253,8804,3,21,144,168,1.1607142857142858,0.031961755757675195,652,My rationalization: coconuts and fish are much healthier.
3577,8805,3,16,118,137,1.1605839416058394,0.036237813341190174,652,It’s the island of lost sweets
6200,8805,2,18,117,137,1.1605839416058394,0.0347251624732724,652,"I don't know if it's the dehydration, heat exhaustion, or copious amounts of acid I consumed on the cruise but that island is looking mighty delicious right now"
5154,8805,2,18,117,137,1.1605839416058394,0.0347251624732724,652,I guess the lollipop guild didn't represent.
3346,8805,3,16,118,137,1.1605839416058394,0.036237813341190174,652,"If I go, there will be trouble. If I stay there will be double."
5043,8805,7,8,122,137,1.1605839416058394,0.04174383719274068,652,"All I am trying to do is contact Mary Lawton and tell her that her polar bear at the remote Russian outpost cartoon is to die for.   [Thank you Mary!!!  New Yorker, please make it easier for us!!!]"
2406,8805,3,16,118,137,1.1605839416058394,0.036237813341190174,652,You want to be King Kandy or Queen Frostine?
798,8805,4,14,119,137,1.1605839416058394,0.03768980396216881,652,Was that CONEY island?
2622,8805,2,18,117,137,1.1605839416058394,0.0347251624732724,652,That's the south sea's version of the Big Rock Candy Mountain.
1350,8805,2,18,117,137,1.1605839416058394,0.0347251624732724,652,That's how I became a diabetic.
2505,8814,2,22,138,162,1.1604938271604939,0.03146790898406791,652,What a shame we’re out of dental floss
5219,8814,4,18,140,162,1.1604938271604939,0.03381703369653575,652,I am on a sugar free diet so you best go by yourself.
8326,8816,2,17,112,131,1.1603053435114503,0.03564158024405726,652,"Now that, on the other hand,  would have ruined my diet."
2250,8816,2,17,112,131,1.1603053435114503,0.03564158024405726,652,The candy grass is always greener on the other side.
3536,8816,4,13,114,131,1.1603053435114503,0.03879693114778763,652,Beats the big rock candy mountain
4941,8816,3,15,113,131,1.1603053435114503,0.037252678486115236,652,Didn’t Shackleton say he was diabetic?
8104,8820,2,21,133,156,1.1602564102564104,0.032150384422441086,652,I hadn't known that there were billionaires marooned on remote islands.
641,8820,4,17,135,156,1.1602564102564104,0.03462763622294088,652,I can't. It's not Ketogenic.
4684,8822,2,16,107,125,1.16,0.03663243759117005,652,"Look, if we get tired of trying to eat tree bark and sand, we can always start swimming."
5518,8822,3,18,129,150,1.16,0.03421212940840891,652,My dentist said he couldn't approve
6370,8822,2,20,128,150,1.16,0.0328783262962813,652,So much for residential building by-laws.
7561,8822,5,14,131,150,1.16,0.03673473446050303,652,Let's switch cravings - I wonder what they'll morph into.
8506,8822,2,20,128,150,1.16,0.0328783262962813,652,"You always have to have your cake and eat it too, don’t you."
8961,8822,2,20,128,150,1.16,0.0328783262962813,652,I hope it arrives by Christmas.
2284,8828,1,21,122,144,1.1597222222222223,0.032181730781306074,652,So Bill... how’s that diet been treating you?
9256,8828,1,21,122,144,1.1597222222222223,0.032181730781306074,652,"If we were over there, we’d just get FAT"
1291,8828,1,21,122,144,1.1597222222222223,0.032181730781306074,652,"I always thought there were chutes and ladders, not water."
1196,8828,3,17,124,144,1.1597222222222223,0.03507012960242173,652,so you are giving up sweets for Lent
247,8832,3,20,140,163,1.1595092024539877,0.032477516699581724,652,It really *do* be like that sometimes.
2191,8832,3,20,140,163,1.1595092024539877,0.032477516699581724,652,Remember when Temptation Island was still tempting?
2715,8832,3,20,140,163,1.1595092024539877,0.032477516699581724,652,It may or may not be a mirage but as a diabetic I am not at all tempted.
4094,8832,4,18,141,163,1.1595092024539877,0.03362334684427683,652,Too bad we're both on the Keto Diet
4562,8832,3,20,140,163,1.1595092024539877,0.032477516699581724,652,So this is runner-up in the reality show “candy land “ !
6190,8832,2,22,139,163,1.1595092024539877,0.03128975437635584,652,"Careful Roger, don' t be too eager, I saw a cartoon like this in the New Yorker and it was a sea monster. Looks like they may have added some temptation!"""
6332,8838,2,18,118,138,1.1594202898550725,0.034492246910911926,652,Thank god my favorite food is sand.
2788,8838,3,16,119,138,1.1594202898550725,0.03599307738663519,652,"Cool view, ain't it"
2860,8838,1,20,117,138,1.1594202898550725,0.0329230705458394,652,Nah! I just don't have a sweet tooth.
7492,8838,3,16,119,138,1.1594202898550725,0.03599307738663519,652,Too bad I  just started a sugar free diet!
7951,8838,4,14,120,138,1.1594202898550725,0.037433783438991376,652,"The grass is always sweeter on the next island over."""
3407,8843,7,11,139,157,1.1592356687898089,0.03781293743948405,652,"You got ahead, I'm doing the Whole30."
5531,8843,1,23,133,157,1.1592356687898089,0.030657174263680795,652,It’s okay - I cut out carbs anyway.
7532,8845,3,15,114,132,1.1590909090909092,0.03698932558938974,652,Oompa Loompa summer internship class of 2019.
9216,8845,2,17,113,132,1.1590909090909092,0.03539138011654745,652,"Are you thinking of what I'm thinking?  Yeah, diabetes."
2135,8845,2,17,113,132,1.1590909090909092,0.03539138011654745,652,Man the gravy boat!
7579,8845,4,13,115,132,1.1590909090909092,0.038521041374316646,652,"That’s where Valentine’s Day gifts get marrooned if there are no takers,” said Fred. “Cupcake wishes and candy cane dreams washed ashore” said Robin"
6231,8849,4,16,131,151,1.1589403973509933,0.035275910561480224,652,I hate Keto.
512,8849,3,18,130,151,1.1589403973509933,0.034001318286075326,652,Tough choice between my diabetes and lactose intolerance to coconut milk
4580,8849,2,20,129,151,1.1589403973509933,0.03267704736417365,652,They probably wish they were on this island
3599,8852,1,25,144,170,1.1588235294117648,0.02932810936307476,652,Did you ever play CandyLand?
7179,8852,4,19,147,170,1.1588235294117648,0.032695243257013805,652,Did you bring your insulin injection? Nope. You? Nah.
3563,8854,3,14,109,126,1.1587301587301588,0.03806877387662545,652,Hansel and Gretel and The Global Warming
8572,8854,4,12,110,126,1.1587301587301588,0.039701582732351706,652,All yours--I'm trying Keto
5312,8856,3,17,125,145,1.1586206896551725,0.03484484227867613,652,Does that mean it's Christmas time?
126,8856,1,21,123,145,1.1586206896551725,0.03197799481205415,652,Temptation Island is not real I tell you. Stay gluten free with me.
402,8856,4,15,126,145,1.1586206896551725,0.036193210330652384,652,dude
4677,8856,0,23,122,145,1.1586206896551725,0.030443500317583968,652,Wish we had an Amazon.
5022,8856,2,19,124,145,1.1586206896551725,0.03344215293327851,652,"Ed, come on, of course it is and you know it. That was Micheal Jackson's vacation getaway Island."
3961,8861,0,26,138,164,1.1585365853658536,0.02860807047168362,652,It’s a flying food saucer
9010,8861,2,22,140,164,1.1585365853658536,0.031113583758340804,652,"When I said ""help me diet"" I didn't mean psychological torture."
9641,8861,4,18,142,164,1.1585365853658536,0.03343184847509574,652,"It may look good, but they don't have any palm oil."
7808,8864,3,16,120,139,1.158273381294964,0.03575159727802202,652,I'm gluten free and trying to avoid processed sugars.
8345,8864,5,12,122,139,1.158273381294964,0.03855782069879593,652,I’m gaining weight just looking at it!
5124,8864,3,16,120,139,1.158273381294964,0.03575159727802202,652,"Well, that's one way to cut out sweets"
9712,8864,4,14,121,139,1.158273381294964,0.03718119312885459,652,"So, leastways this time, the grass is greener on our side"
9224,8864,1,20,118,139,1.158273381294964,0.03270547169540973,652,"And to the east, is the Big Rock Candy Mountain."
5900,8864,1,20,118,139,1.158273381294964,0.03270547169540973,652,"Isle of Circe, where you'll turn into a pig."
1604,8864,2,18,119,139,1.158273381294964,0.034262403496756605,652,You really think we might be Hansel & Gretel?
4701,8864,2,18,119,139,1.158273381294964,0.034262403496756605,652,Damn! Just when my diet was going so well.
2894,8864,1,20,118,139,1.158273381294964,0.03270547169540973,652,I guess Willie Wonka gave us the wrong directions....
2009,8864,2,18,119,139,1.158273381294964,0.034262403496756605,652,The candy man has a strange sense of  humor.
5674,8864,4,14,121,139,1.158273381294964,0.03718119312885459,652,It’s No Keto Island.
8120,8875,6,13,139,158,1.1582278481012658,0.03649807282889975,652,"Hey Bill, Fuck mirages."
4316,8876,4,16,132,152,1.1578947368421053,0.03505866114063326,652,Thanks for the Valentine's gift - but where are the truffles?
5667,8876,1,19,113,133,1.1578947368421053,0.03348468475159745,652,"You go, I’m type 2 diabetic and gluten intolerant."
4265,8876,2,20,130,152,1.1578947368421053,0.03247819221404412,652,Wish I wasn't on a diet.
5834,8876,3,15,115,133,1.1578947368421053,0.03672963988415016,652,"I hate them. They've all got iPads of their own, and we're still stuck sharing the goddam Palm."
3270,8876,2,23,146,171,1.1578947368421053,0.03032721567340082,652,"Dude, way too much sugar!"
525,8876,3,18,131,152,1.1578947368421053,0.03379306652603567,652,"Is this supposed to be Candyland, or what?"
368,8876,3,15,115,133,1.1578947368421053,0.03672963988415016,652,"Forget Coney Island, I’ll take Candy Island any day."
6512,8876,5,14,133,152,1.1578947368421053,0.03628013363694275,652,"I thought this ""dessert"" only happened in the desert."
3742,8876,5,14,133,152,1.1578947368421053,0.03628013363694275,652,I heard it even has a chocolate custard filling.
7453,8876,2,17,114,133,1.1578947368421053,0.03514463372218593,652,It's no Big Rock Candy Mountain.
7340,8886,3,20,142,165,1.1575757575757575,0.032111588456412814,652,I find that this is the only way to stick to Whole 30.
856,8887,4,15,127,146,1.1575342465753424,0.035960872249713095,652,Don't even think about it. There's definitely an ogre over there. I just hope he can't swim.
1298,8887,5,13,128,146,1.1575342465753424,0.03725127708213164,652,You never heard of fantasy island mirages?
3260,8887,1,21,124,146,1.1575342465753424,0.031776790257851774,652,I'm waiting for the Good Ship Lollipop
4900,8887,3,17,126,146,1.1575342465753424,0.03462240635297646,652,I don’t know. I’m in a diet.
6176,8887,2,19,125,146,1.1575342465753424,0.03323007238001543,652,"Yes, the paleo diet can be challenging."
7882,8887,4,15,127,146,1.1575342465753424,0.035960872249713095,652,Airbnb?
8091,8887,3,17,126,146,1.1575342465753424,0.03462240635297646,652,My dentist says all those sweets are bad for me.
8906,8894,0,25,134,159,1.1572327044025157,0.0289598785171226,652,"Yes, but is it paleo?"
964,8895,4,14,122,140,1.1571428571428573,0.0369319651311846,652,"I would suggest we hitch a ride with them, but my blood sugar is too high."
1917,8895,1,20,119,140,1.1571428571428573,0.032490695278719596,652,"Power of  positive thinking dessert island does sound better 
Frank Buckley Andover, MA"
3162,8895,4,14,122,140,1.1571428571428573,0.0369319651311846,652,The candyman can cause he mixes it with love and makes the world taste good
7699,8895,3,16,121,140,1.1571428571428573,0.03551330913238342,652,"You can go ahead, but I'm on strict keto."
8397,8895,2,18,120,140,1.1571428571428573,0.03403557260592834,652,But there's no escape from carbohydrate island!
8812,8895,4,14,122,140,1.1571428571428573,0.0369319651311846,652,Candyland  Island is in my five year plan.
6975,8901,2,15,104,121,1.1570247933884297,0.037128813933096506,652,I need to know if its gluten free before I'll swim over
3842,8902,2,20,131,153,1.1568627450980393,0.03228171789394645,652,The pilot of Toddlers in Paradise was here but never got off the ground.
3858,8902,3,18,132,153,1.1568627450980393,0.033587328297884106,652,I never knew Wayne Thiebaud lived in this neighborhood.
4350,8902,3,18,132,153,1.1568627450980393,0.033587328297884106,652,"When did you say it was Easter, exactly?"
8324,8902,3,18,132,153,1.1568627450980393,0.033587328297884106,652,"That makes sense:
Miracle-gro for the soil,
Sharks to keep the kids out."
9273,8902,1,22,130,153,1.1568627450980393,0.030921028413990997,652,You can swim over there if you want but would your dentist approve?
2225,8907,2,17,115,134,1.1567164179104477,0.034901270905228765,652,Our coconuts are vegan!
3769,8907,1,19,114,134,1.1567164179104477,0.033254741920004736,652,"You know, historically, Candyland was designed to distract people from lonely times like these..."
472,8909,3,20,143,166,1.1566265060240963,0.03193167155301923,652,At least we don't have to eat that stuff.
3653,8909,2,22,142,166,1.1566265060240963,0.03076706515158886,652,If only we weren’t doing Whole 30.
8860,8911,3,17,127,147,1.1564625850340136,0.034402768589717754,652,"For girls maybe, but not for candy.  Anyway, we've got shade!"
8255,8911,3,17,127,147,1.1564625850340136,0.034402768589717754,652,"No, I've never considered myself eclair-ish.  Why?"
7806,8911,1,21,125,147,1.1564625850340136,0.031578070973486715,652,Think we can sprint over before that great white gets back? Or do you think it's a plant??
6234,8911,4,15,128,147,1.1564625850340136,0.03573147697413617,652,"Ever since we moved to this side of the island, I’ve sensed your FOMO increasing."
6062,8911,1,21,125,147,1.1564625850340136,0.031578070973486715,652,You go ahead. I'm holding out for Candy Land.
9175,8911,5,13,129,147,1.1564625850340136,0.03701251689454226,652,I'd give my eyetooth to be on that island.
4960,8911,2,19,126,147,1.1564625850340136,0.033020637887874266,652,Do you think that doughnut is gluten free?
4637,8911,4,15,128,147,1.1564625850340136,0.03573147697413617,652,Hmmm I think we should have gone over there.
4008,8911,3,17,127,147,1.1564625850340136,0.034402768589717754,652,But ours is Keto-friendly...
1091,8911,2,19,126,147,1.1564625850340136,0.033020637887874266,652,"It's a ""Welcome Home"" party just waiting for us to swim back over there."
5126,8911,2,19,126,147,1.1564625850340136,0.033020637887874266,652,"It’s definitely tempting, but I don’t want to risk getting cavities."
9176,8911,3,17,127,147,1.1564625850340136,0.034402768589717754,652,"I can't eat any of that. I' on a low-carb, sugar-free, and gluten-free diet."
8533,8923,1,18,109,128,1.15625,0.034075060441538296,652,"I wonder if they have any croissant? Yeah, I really have missed my morning croissant."
7827,8923,4,17,139,160,1.15625,0.033817484359834823,652,Do we have enough left for the entrance fee?
8715,8923,2,16,110,128,1.15625,0.035834916494356175,652,"Sorry, but I have just mastered my diabetes and I don't want to undo that."
3807,8923,4,12,112,128,1.15625,0.03911782499428444,652,Just my luck. My cheat day isn’t until tomorrow.
5610,8923,4,12,112,128,1.15625,0.03911782499428444,652,I could really go for some insulin right about now.
3600,8923,2,21,137,160,1.15625,0.03140683912820832,652,"No, Dave, I don’t think it’s gluten-free."
2446,8923,1,18,109,128,1.15625,0.034075060441538296,652,"They say sugar is the new salt, so I'm staying far away"
2413,8923,5,15,140,160,1.15625,0.03496052918119134,652,"I would, but I'm doing the Whole30 this month."
3703,8923,3,14,111,128,1.15625,0.03751230113203498,652,It’d take a Trump to keep up with those Joneses.
2301,8932,2,18,121,141,1.1560283687943262,0.03381169612215245,652,I knew we should have gone with the North Beach Diet.
3031,8932,3,16,122,141,1.1560283687943262,0.03527815070621612,652,That's going to play havoc with my paleo diet.
3438,8932,4,14,123,141,1.1560283687943262,0.03668603330757109,652,"Once you eliminate sugar from your diet, you no longer crave it."
3517,8932,2,18,121,141,1.1560283687943262,0.03381169612215245,652,...but no taffy?
3528,8932,1,20,120,141,1.1560283687943262,0.032278687582723384,652,"'There is another word besides mirage to describe that but I just can't think of it."""
3732,8932,3,16,122,141,1.1560283687943262,0.03527815070621612,652,"Go ahead, I'm 100% Keto."
3813,8932,3,16,122,141,1.1560283687943262,0.03527815070621612,652,I should have packed an extra S.
4016,8932,2,18,121,141,1.1560283687943262,0.03381169612215245,652,Small Rock Candy Island
4113,8932,0,22,119,141,1.1560283687943262,0.030669146539630706,652,"- look, they have cool things on the other side.
- let's take over."
7444,8932,3,16,122,141,1.1560283687943262,0.03527815070621612,652,Marketing directors know no bounds.
8498,8932,3,16,122,141,1.1560283687943262,0.03527815070621612,652,Let's go for it. I'm starved
8148,8943,1,22,131,154,1.155844155844156,0.030736468718504457,652,We're looking at the Island of Lost Joys.
6559,8943,4,16,134,154,1.155844155844156,0.03463203463203463,652,"Those candy canes are probably gluten-free, right?"
4364,8943,2,20,132,154,1.155844155844156,0.03208758244410472,652,"Trust me, we're way better off over here on Diabetes Island."
9987,8946,3,13,106,122,1.1557377049180328,0.038640513151905136,652,I guess we could have gone somewhere a little more sweet.
2660,8947,3,15,117,135,1.1555555555555554,0.03622097078895108,652,"I tried Paleo and Keto, but I need something more restrictive."
4219,8947,3,15,117,135,1.1555555555555554,0.03622097078895108,652,"I can't, I'm off carbs."
5472,8947,2,17,116,135,1.1555555555555554,0.03466122336820361,652,It's times like these I wish I wasn't so committed to my gluten free lifestyle.
6918,8947,2,17,116,135,1.1555555555555554,0.03466122336820361,652,Looks like we did it.  We turned Manhattan into an isle of joy.
7260,8947,2,17,116,135,1.1555555555555554,0.03466122336820361,652,Do you think my Doc would be unhappy if I indulged?
7714,8947,1,19,115,135,1.1555555555555554,0.033027898599017176,652,"Yes, but are they gluten free?"
8334,8947,3,15,117,135,1.1555555555555554,0.03622097078895108,652,"No, I didn't like the movie, and I don't know the words to that song."
269,8954,4,15,129,148,1.1554054054054055,0.03550496941650487,652,I'm watching my weight
852,8954,3,17,128,148,1.1554054054054055,0.034185877053393134,652,It’s because you can’t be 20 on Sugar Island . . .
2461,8954,4,15,129,148,1.1554054054054055,0.03550496941650487,652,But I told my Twitter followers that I wasn't going to eat sugar this month...
4274,8954,3,17,128,148,1.1554054054054055,0.034185877053393134,652,It's not the sharks that keep me from swimming over. It's what that stuff will do to me from the inside if I swim over.
5207,8954,1,21,126,148,1.1554054054054055,0.03138179190542251,652,"When the captain put us ashore he said,""No forgiveness for your sins, therefore you shall suffer forever."""
5749,8954,1,21,126,148,1.1554054054054055,0.03138179190542251,652,"Ok, I’ll take the doughnut.....but you keep the complete works"
8993,8954,3,17,128,148,1.1554054054054055,0.034185877053393134,652,"Yeah, more empty carbs."
8698,8961,4,17,140,161,1.15527950310559,0.033620791559563615,652,Pick your poison - grains or sugar.
2841,8961,4,17,140,161,1.15527950310559,0.033620791559563615,652,It's just not appealing.  I'm on a diet.
829,8961,1,23,137,161,1.15527950310559,0.02995727575119672,652,The Baker is always better on the other side of the Moat
440,8961,3,19,139,161,1.15527950310559,0.032445614087867544,652,"Here we are castaways, but on that exclusive Republican island, they are 'naufragé'."
2534,8965,3,12,101,116,1.1551724137931034,0.039871322779526826,652,"Now that's what I call a true deserted island!

Peter Giessner, Peapack NJ"
6776,8965,0,18,98,116,1.1551724137931034,0.03376310512594238,652,I think we should stick with the coconuts; they have fewer calories.
1136,8967,2,16,111,129,1.1550387596899225,0.035576666183499646,652,Your nose grows every time you tell me you don't want it.
1722,8967,3,14,112,129,1.1550387596899225,0.037240075291813245,652,Enjoy — you could die of sun stroke tomorrow.
5313,8967,2,16,111,129,1.1550387596899225,0.035576666183499646,652,I'm on the Sugar Detox Diet.
9420,8967,1,18,110,129,1.1550387596899225,0.0338315702521242,652,Let’s see the bright side: the money spent on dietologist won’t be wasted.
8025,8971,3,16,123,142,1.1549295774647887,0.035046061344057314,652,Every Dieter's MIRAGE
7750,8971,1,20,121,142,1.1549295774647887,0.03206939622127825,652,But where are the coconuts?
4547,8971,2,18,122,142,1.1549295774647887,0.033590717391332715,652,I can't believe you lost the double purple card.
3696,8971,2,18,122,142,1.1549295774647887,0.033590717391332715,652,"You don't think so huh? Haven't you've heard of pool sharks,loan sharks....hellooooo!!"
9015,8971,3,16,123,142,1.1549295774647887,0.035046061344057314,652,"...Someone wrote ""HELP 911"" on the island behind us...You think that's the WiFi password?"
1702,8971,3,16,123,142,1.1549295774647887,0.035046061344057314,652,Don't even think about it.  You're on low-carb.
1405,8971,3,16,123,142,1.1549295774647887,0.035046061344057314,652,I thought you ordered the gluten-free dessert.
559,8971,3,16,123,142,1.1549295774647887,0.035046061344057314,652,Can you swim? I can't...
1,8971,3,16,123,142,1.1549295774647887,0.035046061344057314,652,Whatever you may think it is
3167,8971,3,16,123,142,1.1549295774647887,0.035046061344057314,652,Think of it as one in the eye to the surgeon general
9573,8981,3,18,134,155,1.1548387096774193,0.03318321445118037,652,We don't qualify.  They're looking for kids.
9016,8981,1,22,132,155,1.1548387096774193,0.03055407272672954,652,They show up every couple of years wanting to lure me off to Candyland.
7844,8981,2,20,133,155,1.1548387096774193,0.031895744869051924,652,"Not for me, buddy. Sugar causes cavities."
9418,8981,3,18,134,155,1.1548387096774193,0.03318321445118037,652,"So... are you afraid of sharks?
Nah...I’m vegan."
3849,8981,1,22,132,155,1.1548387096774193,0.03055407272672954,652,"Hmm, sweet or salty"
1205,8981,2,20,133,155,1.1548387096774193,0.031895744869051924,652,It will probably be too crowded. Let’s wait for the candy canes to melt.
5467,8981,2,20,133,155,1.1548387096774193,0.031895744869051924,652,"No,not this one. It's a toxic sub in disguise."
6703,8988,3,13,107,123,1.1544715447154472,0.03834598472082072,652,"Alright! I agree ! We should have brought ""Chutes and Ladders"" instead of checkers."
8215,8988,4,11,108,123,1.1544715447154472,0.040046155440119593,652,"Trust me, with all the FODMAPs in that stuff, we're better off without it."
6596,8990,1,19,116,136,1.1544117647058822,0.03280409346399258,652,"Nothing like it back home, wouldn’t you say?"
40,8990,0,21,115,136,1.1544117647058822,0.03109945475600372,652,"I'm on Keto, so let's keep this just between us."
1834,8990,3,15,118,136,1.1544117647058822,0.03597184276266143,652,"It's where Little Rocket Man tamed 
the mentally deranged U.S. dotard with fire."
2934,8990,1,19,116,136,1.1544117647058822,0.03280409346399258,652,"No, we are doing the Whole 30"
3503,8990,5,11,120,136,1.1544117647058822,0.03888236612513331,652,Here we are deserted and just desserts?
4235,8990,1,19,116,136,1.1544117647058822,0.03280409346399258,652,If we book our flights now we will be able to afford the extra leg room fee.
6242,8990,1,19,116,136,1.1544117647058822,0.03280409346399258,652,This diet plan is the best ever!
6865,8990,5,11,120,136,1.1544117647058822,0.03888236612513331,652,If only it was sugar-free
9796,8998,6,11,132,149,1.1543624161073827,0.03776452408556386,652,"Now that is the REAL “ “Temptation Island”.
/s/7037adb77c53bda78d7c5a93d95b3af9/a2bb15b3-65f9-42e4-b21e-37336dc3"
9766,8998,0,23,126,149,1.1543624161073827,0.029698332444868084,652,"I thought about it, but the doc told me to lay off the sweets."
7703,8998,3,17,129,149,1.1543624161073827,0.03397168106978986,652,I literally just started keto.
7323,8998,2,19,128,149,1.1543624161073827,0.032609513843973724,652,I made that mistake all the time as a kid.
5751,8998,4,15,130,149,1.1543624161073827,0.03528129584177321,652,You were unconscious and I'm on a diet.
4273,8998,6,11,132,149,1.1543624161073827,0.03776452408556386,652,I picked a bad time to go keto.
1832,8998,1,21,127,149,1.1543624161073827,0.031187909060613684,652,"Mirages only come out in deserts, Baby Brother; this one is for real, trust me!"
1742,8998,1,21,127,149,1.1543624161073827,0.031187909060613684,652,I say we stay here. All that sugar would be bad for our health.
386,9006,4,17,141,162,1.154320987654321,0.03342635703383495,652,I actually lost all my teeth.
5409,9006,1,23,138,162,1.154320987654321,0.0297872059154401,652,"I would go get that donut, but it's not on my diet."
10007,9008,2,16,112,130,1.1538461538461537,0.03532207794572837,652,No way! I gave up carbs and sugar.
8893,9008,2,20,134,156,1.1538461538461537,0.031706165110674034,652,"Go on over, I'm diabetic."
8532,9008,1,20,122,143,1.1538461538461537,0.03186277009554194,652,I heard sugar isn't good for you.
8154,9008,5,10,115,130,1.1538461538461537,0.0400678292840366,652,If you had your Candyland game we could get there!
6147,9008,2,20,134,156,1.1538461538461537,0.031706165110674034,652,Hmm ... I always thought Candyland was a Board Game.
6006,9008,1,22,133,156,1.1538461538461537,0.030373803187722988,652,Let me guess... You also failed Capt. Hooks spelling bee.
5628,9008,1,20,122,143,1.1538461538461537,0.03186277009554194,652,But if I stay here it will be easier to stick to my low carb diet
5722,9008,3,16,124,143,1.1538461538461537,0.03481698192894427,652,We knew there would be lots of temptations when we started the Keto diet.
3446,9008,3,16,124,143,1.1538461538461537,0.03481698192894427,652,I think I will just skip dessert.
3189,9008,1,18,111,130,1.1538461538461537,0.033591496037349206,652,"I wanted to surprise you with a cruise on ""The Good Ship Lollipop."""
3121,9008,2,18,123,143,1.1538461538461537,0.033372581176781886,652,Too bad about the sharks in these waters.
2367,9008,2,18,123,143,1.1538461538461537,0.033372581176781886,652,"Do you think that 10,000 strokes would cover it?"
1469,9008,3,16,124,143,1.1538461538461537,0.03481698192894427,652,I'd like to buy an S - ???
1413,9008,1,20,122,143,1.1538461538461537,0.03186277009554194,652,Good thing we are resetting our metabolism otherwise we 'd have to   figure out how to get those sugary sweets.
833,9008,3,16,124,143,1.1538461538461537,0.03481698192894427,652,"Nope, I can't take gluten either......"
5580,9008,4,12,114,130,1.1538461538461537,0.03855088013467186,652,"Ah yes, the Nestle portion of the Great Pacific Garbage Patch"
5588,9008,2,20,134,156,1.1538461538461537,0.031706165110674034,652,Sweet are the uses of adversity...but do they deliver?
4386,9025,4,17,142,163,1.1533742331288344,0.03323414244921311,652,All we need now are some good books to enjoy the dessert island.
9347,9026,2,19,129,150,1.1533333333333333,0.03240773054773024,652,"I think it is your turn to grab the cake, after all you were the one on swim team"
215,9026,3,17,130,150,1.1533333333333333,0.03376013118853751,652,I’ll have some if you have some.
379,9026,2,19,129,150,1.1533333333333333,0.03240773054773024,652,Remember that game.
4675,9026,3,17,130,150,1.1533333333333333,0.03376013118853751,652,"That's Sammy Davis's old pad. If we make it, what kind of candy do yo want?"
6669,9026,2,19,129,150,1.1533333333333333,0.03240773054773024,652,Behold the Island of Misfit Calories!
8756,9031,1,19,117,137,1.1532846715328466,0.032583266766481996,652,How's your A1-C numbers?
10021,9031,3,15,119,137,1.1532846715328466,0.035726092524753957,652,The sturgeon sent it...they're trying to tempt us off caviar.
8465,9031,1,19,117,137,1.1532846715328466,0.032583266766481996,652,Tasty Treat Island? Really? Two years with nothing else to look at and that’s the best you could come up with? Can we never speak of this again?
6919,9031,1,19,117,137,1.1532846715328466,0.032583266766481996,652,"A mirage I tell you, vortex refractions from the mainland's gluten and corn syrup runoff"
9740,9031,3,15,119,137,1.1532846715328466,0.035726092524753957,652,"Sometimes, it feels like it would’ve been better to be part of a cosmic typo."
3028,9031,4,13,120,137,1.1532846715328466,0.03719806304154902,652,The sea does seem blue-er over there
2396,9031,4,13,120,137,1.1532846715328466,0.03719806304154902,652,Mine was not a low-sugar cruise ship
6414,9031,2,17,118,137,1.1532846715328466,0.03419080987826269,652,"Now there's an island that's fair and bright,
Where the handouts grow on bushes
And you can sleep out every night"
2857,9031,3,15,119,137,1.1532846715328466,0.035726092524753957,652,"Hey man, as tempting as it is, I'm staying committed to this 'Keto' thing"
4248,9040,1,15,95,111,1.1531531531531531,0.03664513893725978,652,"Sorry, I'm a borderline diabetic."
1496,9041,3,18,136,157,1.1528662420382165,0.03278863102225159,652,"Thanks a lot, 
ya led us not into tempation !
but delivered us from evil -
for there is the kingdom
of cane and cake, and gone for ever."
1997,9041,1,22,134,157,1.1528662420382165,0.030195623683857645,652,NO! It is too many calories for our jog.
4658,9041,3,18,136,157,1.1528662420382165,0.03278863102225159,652,"What's the,point of a gluten free person swimming to an island full of cake?  Well first, that giant strawberry is gluten free, and second eating it wiill hold off the scurvy if you value your smile, dude!"
9044,9041,3,18,136,157,1.1528662420382165,0.03278863102225159,652,"Oh darling,if only we lived there,we could play Candy Land all day long!"
9862,9045,4,14,126,144,1.1527777777777777,0.035967378766307144,652,That's what they taught us in school!
9197,9045,2,18,124,144,1.1527777777777777,0.03315723361604233,652,I would think we could loose a few pounds on this diet!
7292,9045,2,18,124,144,1.1527777777777777,0.03315723361604233,652,Islanders 4 Canes 2 on the Food Channel.
6400,9045,2,18,124,144,1.1527777777777777,0.03315723361604233,652,I kind of hope the straws don't spoil the sunset.
4247,9045,1,20,123,144,1.1527777777777777,0.03165875935572508,652,I'm in the intermittent fasting diet.
4935,9045,1,20,123,144,1.1527777777777777,0.03165875935572508,652,"Ugh, all we have on this island is chocolate-less mounds"
3393,9045,3,16,125,144,1.1527777777777777,0.034590854834679996,652,"Ya, but your body doesn't actually need the carbs..."
9923,9045,2,18,124,144,1.1527777777777777,0.03315723361604233,652,"Survivor Pastry Chef Diet Temptation Island: 
Desert vs. Dessert
Binge Now or Starve!"
5108,9045,4,14,126,144,1.1527777777777777,0.035967378766307144,652,Are we in the middle of some gigantic porn movie?
748,9045,6,10,128,144,1.1527777777777777,0.03857333962167647,652,I should have specified we wanted to be over their when I wrote the genie.
9340,9055,3,14,114,131,1.1526717557251909,0.036707221826285365,652,Reminds me of that board game Candyland
3142,9055,1,18,112,131,1.1526717557251909,0.03335476742553483,652,This is still a good thing—at least we’re surrounded by anticavity protection.
4885,9055,1,18,112,131,1.1526717557251909,0.03335476742553483,652,"Must be a mirage. It was Candyland, not CandyIsland"""
1382,9058,2,21,141,164,1.1524390243902438,0.030696576829558155,652,"Yes, it is tempting; but, I don't trust those candy canes."
6029,9058,4,17,143,164,1.1524390243902438,0.033044110325857454,652,We could swim over but what's for lunch?
8229,9060,4,15,132,151,1.1523178807947019,0.03484224221977723,652,How long have you been doing Keto?
4103,9060,5,13,133,151,1.1523178807947019,0.03608714540736325,652,"Wow! I thought Shirley Temple gave up singing ""The Good Ship Lollipop""!"
4324,9060,4,15,132,151,1.1523178807947019,0.03484224221977723,652,Do you want to at least sing Cake By The Ocean
5033,9060,1,21,129,151,1.1523178807947019,0.03080716119102782,652,To survive we must take a dive.
5269,9060,3,17,131,151,1.1523178807947019,0.0335511791469551,652,"Desert, Dessert, and island is an island."
8092,9060,2,19,130,151,1.1523178807947019,0.0322084057568909,652,I'm on this new ketogenic diet so I'm going to have to pass.
299,9066,3,15,120,138,1.1521739130434783,0.035483652461182486,652,I'm a diabetic.
1189,9066,0,21,117,138,1.1521739130434783,0.030687620037972877,652,"Good, because I want the donut."
1924,9066,3,15,120,138,1.1521739130434783,0.035483652461182486,652,"Hey, it's garbage island."
2138,9066,4,13,121,138,1.1521739130434783,0.03694422979009005,652,Let's play rock-paper-scissors.
3498,9066,2,17,119,138,1.1521739130434783,0.033960316093773125,652,"When my options get smaller, my dreams become bigger!"
7936,9066,1,19,118,138,1.1521739130434783,0.032365360285218366,652,"I figure all I have to do is swim, swim, swim as fast as I can"
3443,9072,2,15,108,125,1.152,0.036021498956828185,652,Too bad I’m off sugar this month
410,9072,2,15,108,125,1.152,0.036021498956828185,652,"Now, aren’t you glad i startednus on the paleo diet?"
6192,9074,4,16,138,158,1.1518987341772151,0.03380898197140144,652,I don’t think I need to sugarcoat it; that dessert-ed island looks so sweet!
5114,9074,1,22,135,158,1.1518987341772151,0.030019498608274676,652,It'd just a mirage.
8519,9074,5,14,139,158,1.1518987341772151,0.03498103653447101,652,Dental license up to date?
4192,9074,3,18,137,158,1.1518987341772151,0.032594809507943134,652,"I'd swim over there, but I'll be darned if I didn't just start my diet."
9755,9074,4,16,138,158,1.1518987341772151,0.03380898197140144,652,I bet you're really happy now that we became vegetarians ?
2750,9074,2,20,136,158,1.1518987341772151,0.031333623342595616,652,We shouldn’t have played chutes and ladders
1434,9074,1,22,135,158,1.1518987341772151,0.030019498608274676,652,If only we had whip cream.
739,9074,2,20,136,158,1.1518987341772151,0.031333623342595616,652,"Sweets for my sweet, sugar for my honey . . . I think there's a song in that."
2794,9074,6,12,140,158,1.1518987341772151,0.036115074028851765,652,"Not for me thanks, I’m on a detox."
8911,9083,3,16,126,145,1.1517241379310346,0.034367623879830014,652,Of course the one tree on our island has no coconuts!
2877,9083,4,14,127,145,1.1517241379310346,0.03573400357864326,652,I lost my insulin
8012,9083,1,20,124,145,1.1517241379310346,0.031457315364147156,652,Are you still recommending the Paleo diet?
9569,9083,3,16,126,145,1.1517241379310346,0.034367623879830014,652,I'd love to try buy I am gluten intolerant.
7300,9083,1,20,124,145,1.1517241379310346,0.031457315364147156,652,And this is why we must tax the ultra-sweet.
2543,9083,2,18,125,145,1.1517241379310346,0.03294462217923337,652,Too bad I’m on a diet.
4317,9083,3,16,126,145,1.1517241379310346,0.034367623879830014,652,Too bad I'm on a low-carb diet.
7229,9083,0,22,123,145,1.1517241379310346,0.02989610759457461,652,"It's the sequel to the game, Candyland.  It's Dessertland!"
2089,9083,4,14,127,145,1.1517241379310346,0.03573400357864326,652,"Too bad about the sharks. Humm,I think I can swim faster than you. Let's go for it!"
8747,9092,4,19,155,178,1.151685393258427,0.03131945433888938,652,Candyland: so near rand yet so far!
6849,9093,3,19,143,165,1.1515151515151516,0.03171153774991366,652,"Just like they have been saying, that fentenyl stuff is really dangerous!"
6096,9093,2,16,114,132,1.1515151515151516,0.034823583817867154,652,"I don't know about you, but I'd rather be gluten-free"
5874,9093,4,12,116,132,1.1515151515151516,0.03800003726219073,652,"My mistake, I didn't realize the Candy Land Cruise would actually be piloted by desserts"
5873,9093,1,18,113,132,1.1515151515151516,0.03312131592971642,652,"You go ahead, I’m on a low cholesterol diet."
4856,9093,2,16,114,132,1.1515151515151516,0.034823583817867154,652,Too bad we are on a gluten free diet.
4434,9093,4,12,116,132,1.1515151515151516,0.03800003726219073,652,"Sure, they're simple carbs, but I think that our abs will still shred if we swim over there."
3555,9093,1,18,113,132,1.1515151515151516,0.03312131592971642,652,Sour grapes” if you ask me
3521,9093,3,14,115,132,1.1515151515151516,0.03644643207398979,652,Should I cheat on my Paleo diet?
1862,9093,2,16,114,132,1.1515151515151516,0.034823583817867154,652,LOOK-it's Candy Land !  No it's all in your mind. Well .....good thing my mouth is not in my mind!
1805,9093,3,14,115,132,1.1515151515151516,0.03644643207398979,652,I'd swim for it except I'm watching my weight.
9909,9103,3,17,132,152,1.1513157894736843,0.03334477783514643,652,I wish I had learned to eat gluten as a kid.
8480,9103,1,21,130,152,1.1513157894736843,0.030620213216010113,652,"I told you to sing the ""Big Rock Candy Mountain"" instead of ""Michael Row the Boat Ashore""!"
7244,9103,4,15,133,152,1.1513157894736843,0.034626761104901926,652,We should probably just swim over there.
6073,9103,4,15,133,152,1.1513157894736843,0.034626761104901926,652,"No, it’s no mirage...those are some leftovers from a “party boat” !"
3235,9103,2,19,131,152,1.1513157894736843,0.03201149532800048,652,"It's tempting, but I'm trying to avoid the Freshman 15."
3540,9103,2,19,131,152,1.1513157894736843,0.03201149532800048,652,IF YOU REMOVE THE CANDY COATING WE'RE ALREADY THERE.
3190,9103,3,17,132,152,1.1513157894736843,0.03334477783514643,652,"When it rains, it pours."
2852,9103,2,19,131,152,1.1513157894736843,0.03201149532800048,652,"We're on a Sugar Detox, we'll wait for the next one!!!!!"
4607,9103,3,17,132,152,1.1513157894736843,0.03334477783514643,652,"Originally I liked that we were being more real.
 Now, I just want to get my hands on that candy cane."
7617,9112,2,22,148,172,1.1511627906976745,0.029771882743676783,652,Diabetes can cause the strangest hallucinations.
1172,9113,3,15,121,139,1.1510791366906474,0.035244456730693215,652,Too many carbs.
4794,9113,4,13,122,139,1.1510791366906474,0.03669381616562958,652,Do you know how many calories are in that?
8033,9113,2,17,120,139,1.1510791366906474,0.03373288181709938,652,Can't swim? I'll toss you a candy cane!
9854,9113,1,19,119,139,1.1510791366906474,0.03215031727885562,652,Tell me again about the keto diet.
9870,9113,4,13,122,139,1.1510791366906474,0.03669381616562958,652,If only one of us could doggy-paddle.
5246,9118,1,22,136,159,1.150943396226415,0.02984539314303554,652,"But is it gluten, nut and dairy free?"
1329,9119,2,15,109,126,1.1507936507936507,0.03575482707775329,652,"I'd swim over there with you but last week my doctor told me I have diabetes, so I'd better not..."
4135,9119,2,15,109,126,1.1507936507936507,0.03575482707775329,652,"This is the week 1 mirage on he Keto diet, just wait for week two."
9933,9121,3,16,127,146,1.1506849315068493,0.034147234283379825,652,Let's stay here. None of that looks Keto-friendly.
4876,9121,3,16,127,146,1.1506849315068493,0.034147234283379825,652,I think it's called a Willy Wonka mirage.
7335,9121,5,12,129,146,1.1506849315068493,0.036810056123064414,652,I knew the paleo diet would be the death of me.
4005,9121,2,18,126,146,1.1506849315068493,0.03273469562886555,652,Total carbs. I say we don't. \
3861,9121,0,22,124,146,1.1506849315068493,0.029708814775001514,652,That's fine. I'm off refined sugar these days.
4172,9121,3,16,127,146,1.1506849315068493,0.034147234283379825,652,You know what they say. The candy is always sweeter on the other island...or wherever you aren't.
9806,9127,2,21,143,166,1.1506024096385543,0.030353244486533836,652,"It's fake, from a candy store display window.  The real stuff would have dissolved in the last rain storm."
6590,9128,2,16,115,133,1.150375939849624,0.03457953113825575,652,"I'd go, but lately I'm trying to be more mindful about eating clean."
8558,9128,1,18,114,133,1.150375939849624,0.03289107488649244,652,"If there was only a ""Weight Watchers"" nearby..."
9788,9130,2,19,132,153,1.1503267973856208,0.031816956152907375,652,"I’m still not sure if I believe in global warming, we still have a North Pole after all"
7406,9130,2,19,132,153,1.1503267973856208,0.031816956152907375,652,"Sure, I'd love to go to Big Rock Candy Island, but my therapist says I have an imaginary cavity."
9768,9130,1,21,131,153,1.1503267973856208,0.0304354955082142,652,I don’t really have much of a sweet tooth....
1493,9130,3,17,133,153,1.1503267973856208,0.03314088126229498,652,"Happy Valentine’s Day, Lois. Baked in a nut-free kitchen, so no worries at all."
5491,9130,2,19,132,153,1.1503267973856208,0.031816956152907375,652,"Yes, it is tempting but, one foot on the island, one bite and I won't be  able to stop until we have to rename it Hog Island."
3428,9135,3,15,122,140,1.15,0.03500844120789703,652,I wonder if that gumdrop path could lead us out of here?
6415,9135,1,22,137,160,1.15,0.02967327323795082,652,online baking?
7174,9135,1,16,103,120,1.15,0.03480638725632892,652,I'm doing Whole 30
7695,9135,2,20,138,160,1.15,0.03096965445166197,652,"All that gluten, carelessly dumped into the ocean."
8190,9135,2,14,104,120,1.15,0.03676330529545051,652,"That one's more of a ""sometimes-island."""
8734,9135,1,19,120,140,1.15,0.0319380824403903,652,"I say let's make a break for it, before it gets any closer."
4430,9141,3,19,145,167,1.1497005988023952,0.03135671881204532,652,What's your issue with Whole30? It feels so natural to me...
9958,9142,0,22,125,147,1.1496598639455782,0.02952382240693485,652,You go. My A1c number is getting up there.
8902,9142,1,20,126,147,1.1496598639455782,0.031061938922607217,652,"Don't even give them the satisfaction of looking.  It's """"Candy Land South Pacific"" and the joke is - nothing's edible."""
2240,9142,3,16,128,147,1.1496598639455782,0.03392963262198528,652,This is exactly how I imagined it would be!
5041,9142,0,22,125,147,1.1496598639455782,0.02952382240693485,652,Wa-ter you waiting for...Gary?
7258,9142,2,18,127,147,1.1496598639455782,0.03252740398106394,652,"Alien submersible or hallucination, my sweet tooth still needs satisfying."
3375,9147,0,19,108,127,1.1496062992125984,0.03177603350241964,652,Yeah sorry this island had no gluten-free options
8589,9147,3,13,111,127,1.1496062992125984,0.03721114666340636,652,I'm starting to like this reboot of Castaway.
7739,9149,2,19,133,154,1.1493506493506493,0.03162474612915382,652,The deserted island is always sweeter on the other side...
7026,9149,2,19,133,154,1.1493506493506493,0.03162474612915382,652,"It's not real just like the Green New Deal just a fantasy a delusion of fools"""
5171,9149,3,17,134,154,1.1493506493506493,0.03293944452411188,652,I always wonder what new people are going to get pissed off at me about
6432,9149,2,19,133,154,1.1493506493506493,0.03162474612915382,652,I thought the E.U was trying to discourage us.
3387,9149,3,17,134,154,1.1493506493506493,0.03293944452411188,652,"No, you have to go back for the mugs."
3157,9149,1,21,132,154,1.1493506493506493,0.030252968943722126,652,"We will renovate the kitchen this summer, I promise."
4477,9149,3,17,134,154,1.1493506493506493,0.03293944452411188,652,Is it bigger than a bread box?
8669,9156,1,18,115,134,1.1492537313432836,0.03266397939715914,652,Maybe we should try the flare gun.
9356,9156,3,14,117,134,1.1492537313432836,0.035935737801332704,652,"I told them to send a sugar free, gluten free island!"
9795,9156,3,14,117,134,1.1492537313432836,0.035935737801332704,652,"Gilligan and the Skipper must have dropped us off at Sweat Island instead of Sweet Island. Oh well, at least they’ll be back in a few hours."
1224,9159,2,20,139,161,1.1490683229813665,0.030790793932783694,652,Dame this health craze
4032,9160,1,19,121,141,1.148936170212766,0.031728601853199596,652,Do you think the sweets are worth the swim?
2960,9160,6,9,126,141,1.148936170212766,0.03890102554596026,652,I hope you're not thinking of going off  your diet.
3112,9160,4,13,124,141,1.148936170212766,0.03620297699554577,652,I’m holding out until the desserted island has pie.
727,9160,2,17,122,141,1.148936170212766,0.033286953873140436,652,You said you wanted to cut-back on sugar anyway.
1718,9160,0,21,120,141,1.148936170212766,0.030089650263257342,652,"Qu'ils mangent de la brioche""

hahaha très drôl"
171,9160,3,15,123,141,1.148936170212766,0.034775543428482866,652,"Damn, and I swore off sweets last week!"
1061,9166,2,14,105,121,1.1487603305785123,0.03647928017660087,652,"No, you go.  I'm on the keto diet."
2220,9166,1,16,104,121,1.1487603305785123,0.03453978626701372,652,"Trust me, that island is overrated & oversugared!"
5121,9166,3,12,106,121,1.1487603305785123,0.03832073758469298,652,I'm on the 365-Day No Sugar Challenge.
94,9169,1,20,127,148,1.1486486486486487,0.030867914942629242,652,You go ahead.  I’ve just never liked sweets very much.
594,9169,2,18,128,148,1.1486486486486487,0.03232269846814508,652,The mirage and myth of carb island !
6179,9169,1,20,127,148,1.1486486486486487,0.030867914942629242,652,If I hadn't been born in the 21st century I might consider swimming the 20 yards....
9382,9169,2,18,128,148,1.1486486486486487,0.03232269846814508,652,I heard it’s all coconut flavored.  And the sugar will rot your teeth.
9745,9169,0,22,126,148,1.1486486486486487,0.029341089099557273,652,Is it end of year already?
7023,9174,1,17,110,128,1.1484375,0.03344154714634684,652,Bored
3927,9174,4,11,113,128,1.1484375,0.0385672343282522,652,"If we swim over there and indulge, we may turn into donkeys!"
5800,9174,1,17,110,128,1.1484375,0.03344154714634684,652,YOU can try and swim for it; I’ve finally achieved ketosis!
1174,9177,2,19,134,155,1.1483870967741936,0.03143482413135121,652,Just a warning. She’s got a helluva sweet tooth.
3579,9177,3,17,135,155,1.1483870967741936,0.032740423771392364,652,Maybe if we thought of ours as spearmint
6476,9177,3,17,135,155,1.1483870967741936,0.032740423771392364,652,You wanna bet?
6553,9177,3,17,135,155,1.1483870967741936,0.032740423771392364,652,PGlobal warming...used to be The Big Rock Candy Mountain.
8013,9181,1,22,139,162,1.1481481481481481,0.029334857623755633,652,This new version of candy land loos challenging
10023,9181,8,8,146,162,1.1481481481481481,0.03738050995527878,652,yeah so i feel like piss is more like cum than poop but cum is more like poop than piss. does that make sense?
9369,9181,1,18,116,135,1.1481481481481481,0.03243996627103595,652,"That's Candy Mountain, Charlie."
8702,9181,4,12,119,135,1.1481481481481481,0.03720250489156046,652,Dew hue whish two bee their?
8529,9181,1,18,116,135,1.1481481481481481,0.03243996627103595,652,It's the Island of Doctor AOC
6250,9181,2,16,117,135,1.1481481481481481,0.03410146230265637,652,It’s a new version of the Sirens in the Odyssey. You know . . . Homer? Sirens who sing and cause sailors to shipwreck and die? Here it’s candy they’re using instead of Sirens. Like in the Odyssey. Of Homer. Sailors will row toward the candy. And die.
1342,9181,0,20,115,135,1.1481481481481481,0.030688647610352705,652,Candyland was always just out of reach for me....how about you?
4802,9181,4,12,119,135,1.1481481481481481,0.03720250489156046,652,Do you think they'll notice we're a trap?
1218,9181,5,10,120,135,1.1481481481481481,0.03865985889420865,652,Race you.....diet starts tomorrow!
1208,9181,3,14,118,135,1.1481481481481481,0.03568568411412393,652,I think they call it marriage.
501,9181,0,20,115,135,1.1481481481481481,0.030688647610352705,652,"Well, there are some nice things about being stranded on a desert island, too."
236,9181,2,16,117,135,1.1481481481481481,0.03410146230265637,652,"Hey, maybe we could float home on those two candy canes."
5605,9181,1,18,116,135,1.1481481481481481,0.03243996627103595,652,I picked the wrong time to start my ketogenic diet.
4672,9194,4,17,148,169,1.1479289940828403,0.03212543170906777,652,Just imagine the cavities.
7303,9194,3,19,147,169,1.1479289940828403,0.03100969178110758,652,"Man, I wish we had gotten shipwrecked on that island instead."
8342,9194,4,17,148,169,1.1479289940828403,0.03212543170906777,652,Where did my guide dog swim off to?
9942,9197,1,19,122,142,1.147887323943662,0.03152182294863274,652,The palm tree says this island has more baked goods.
2603,9197,1,19,122,142,1.147887323943662,0.03152182294863274,652,I told you that the codicil to the perpetuity restriction in mom’s would be a bummer.
599,9197,2,17,123,142,1.147887323943662,0.03306834502771489,652,Look at what's due S.
2308,9197,2,17,123,142,1.147887323943662,0.03306834502771489,652,I should listen to mom and take swimming lessons
7073,9201,1,20,128,149,1.1476510067114094,0.03067627458534626,652,Who knew sharks know how to bake?
9397,9201,4,14,131,149,1.1476510067114094,0.03482984334069241,652,I'll take the peppermint. I never eat cheesecake when I'm marooned.
9195,9201,1,20,128,149,1.1476510067114094,0.03067627458534626,652,"I'm going to pass, trying to cut down on carbs."
8430,9201,2,18,129,149,1.1476510067114094,0.03212053150249488,652,You think a Uber work here?
7879,9201,3,16,130,149,1.1476510067114094,0.033502585953474856,652,"You are not delusional, the little fake island is an attempt by Space Force to disguise a reentry capsule."
7508,9201,5,12,132,149,1.1476510067114094,0.03610834680104283,652,Have you Googled anything about sweets recently?
6684,9201,3,16,130,149,1.1476510067114094,0.033502585953474856,652,"Hey, no matter how you slice it . . . Trump got his wall!"
1374,9201,3,16,130,149,1.1476510067114094,0.033502585953474856,652,I’m vegan.
5167,9201,0,22,127,149,1.1476510067114094,0.029160574426241266,652,"...the other one is Holiday Island, Arkansas."
4873,9201,3,16,130,149,1.1476510067114094,0.033502585953474856,652,Should we save our lives for diabetes?
4659,9201,2,18,129,149,1.1476510067114094,0.03212053150249488,652,It’s the Big Rock Candy Mountain!
4308,9201,1,20,128,149,1.1476510067114094,0.03067627458534626,652,But my math teacher is probably there.
1727,9201,0,22,127,149,1.1476510067114094,0.029160574426241266,652,"Of course, now you tell me you’re going carb free!"
5285,9201,4,14,131,149,1.1476510067114094,0.03482984334069241,652,"He was asked what one thing he’d want on a deserted island, and he said ‘a sweet tooth’"
1216,9215,1,16,105,122,1.1475409836065573,0.034277198211624435,652,Makes me want to break out into song: on the good ship lollipop....
9053,9215,3,21,159,183,1.1475409836065573,0.029516202200764598,652,"I told you, I just cant afford the calories on this diet."
4681,9217,1,17,111,129,1.1472868217054264,0.03320124360273608,652,Looks like the Blue Apron Keto diet finally got here!
7941,9217,3,13,113,129,1.1472868217054264,0.03666838745818703,652,What meringue?
4052,9219,1,22,140,163,1.147239263803681,0.029168497471485567,652,Global warming is wreaking havoc on the palm trees.
7900,9219,1,22,140,163,1.147239263803681,0.029168497471485567,652,I say desserts of deserts
7752,9221,2,16,118,136,1.1470588235294117,0.033867310870670894,652,Good thing we are doing the J-lo diet for 10 days no sugar no carbs
7607,9221,2,16,118,136,1.1470588235294117,0.033867310870670894,652,"You can have it, I'm on Keto anyway..."
7420,9221,3,19,148,170,1.1470588235294117,0.030839021197083684,652,"I would,but sweets without a balanced diet is just not healthy."
4418,9221,3,14,119,136,1.1470588235294117,0.03543906329862996,652,And if he knows we know?
3055,9221,2,16,118,136,1.1470588235294117,0.033867310870670894,652,I know I said I’d give it up for Lent; I’m hungry.
2408,9221,2,16,118,136,1.1470588235294117,0.033867310870670894,652,- I don't know... This new diet doesn't convince me.
776,9221,2,16,118,136,1.1470588235294117,0.033867310870670894,652,I’d imagine that’s as nice as The New Yorker automatically keeping you logged-in.
700,9221,1,18,117,136,1.1470588235294117,0.03221897397089213,652,"Sweet view package, amirite​?"
3636,9221,2,16,118,136,1.1470588235294117,0.033867310870670894,652,My doctor told me to cut down on sugar.
806,9230,2,17,124,143,1.1468531468531469,0.03285256524000237,652,It is a good thing I gave up sugar for Lent.
2535,9230,3,15,125,143,1.1468531468531469,0.034318859233490664,652,Dibs on the chocolate cupcake
2955,9230,3,15,125,143,1.1468531468531469,0.034318859233490664,652,Let's race over---winner gets all.
3973,9230,2,17,124,143,1.1468531468531469,0.03285256524000237,652,Looks like Starbucks abandoned their vegan tofu bakery line
4169,9230,3,15,125,143,1.1468531468531469,0.034318859233490664,652,"Yes Jim, the paleo diet's going well."
7066,9230,2,17,124,143,1.1468531468531469,0.03285256524000237,652,This is how I felt like staying in the desert for 40 days!
6297,9236,2,18,130,150,1.1466666666666667,0.03192085664169662,652,"I'm not sure. Too much gluten,maybe?"
8720,9236,2,18,130,150,1.1466666666666667,0.03192085664169662,652,It is all fattening and a mirage.
9124,9236,3,16,131,150,1.1466666666666667,0.033293040524300606,652,"I'm tempted, but...remember the Child Catcher from that old Dick Van Dyke movie?"
4720,9236,2,18,130,150,1.1466666666666667,0.03192085664169662,652,Oh darn.... I meant to make a dentist appointment before I left home!
6692,9236,3,16,131,150,1.1466666666666667,0.033293040524300606,652,it's the only way I can stay keto
3373,9236,1,20,129,150,1.1466666666666667,0.030486974761802316,652,"Well, it looks like I picked the wrong week to start a low-carb diet!"
1881,9236,2,18,130,150,1.1466666666666667,0.03192085664169662,652,Fata Morganas only happen in Deserts
4664,9236,2,18,130,150,1.1466666666666667,0.03192085664169662,652,Der's gotta be somethin'  in dos damn palm leaves doin' dis to us.
2994,9236,1,20,129,150,1.1466666666666667,0.030486974761802316,652,It’s Dessert Cart Island.
2147,9236,5,12,133,150,1.1466666666666667,0.03588032141130668,652,The sugar is always sweeter on the far side of open water.
188,9246,2,19,136,157,1.1464968152866242,0.031061684432245454,652,Those are my top ten desert island empty calories.
991,9246,3,17,137,157,1.1464968152866242,0.03234945991970355,652,I get the cupcake!
4623,9246,3,17,137,157,1.1464968152866242,0.03234945991970355,652,I'm just not convinced it's keto-friendly
5659,9246,2,19,136,157,1.1464968152866242,0.031061684432245454,652,Peter regretted picking coconuts.
5215,9250,5,14,145,164,1.146341463414634,0.03377126680620192,652,...but Mom said sugar was bad for you
6130,9250,2,20,142,164,1.146341463414634,0.030266290893235768,652,Sugar took her. And now there's us two.
9770,9252,2,21,148,171,1.1461988304093567,0.02952730991729023,652,"No thanks, man. I'm on Keto."
8221,9253,1,17,112,130,1.146153846153846,0.03296433529582151,652,it’s very nice but where is the pea green boat?
1393,9253,3,13,114,130,1.146153846153846,0.0364028648632092,652,..but think of the cavities.
7471,9253,3,13,114,130,1.146153846153846,0.0364028648632092,652,Candy Land?  Pick a card.
8864,9256,2,22,154,178,1.146067415730337,0.028838497878924865,652,Because the dessert island had trans fats.
7177,9257,3,14,120,137,1.145985401459854,0.03519580569705459,652,If it's not vegan I won't even touch it.
9227,9257,4,12,121,137,1.145985401459854,0.03668905757335006,652,Too bad I'm off sugar.
8952,9257,5,10,122,137,1.145985401459854,0.03812386591856039,652,"I wouldn't go there if I were you, it's unhealthy."
8436,9257,4,12,121,137,1.145985401459854,0.03668905757335006,652,Is that a groovy lemon pie?  Are you the candyman?
7914,9257,2,16,119,137,1.145985401459854,0.033636327559783415,652,"If it's anything like a jellyfish, we'll have to steer clear of those tentacles."
5388,9257,4,12,121,137,1.145985401459854,0.03668905757335006,652,It is all fattening foods.
2416,9257,2,16,119,137,1.145985401459854,0.033636327559783415,652,Jelly roll gum drop.
3958,9257,0,20,117,137,1.145985401459854,0.030277353216513085,652,I thought the left at rainbow trail took us past the ice cream sea.
2076,9257,1,18,118,137,1.145985401459854,0.03200094256038828,652,"It's probably from the floating island of discarded plastic. If it isn't, we don't have any cold milk"
1066,9257,3,14,120,137,1.145985401459854,0.03519580569705459,652,Last Night only the Periscopes were Visible
456,9257,2,16,119,137,1.145985401459854,0.033636327559783415,652,"I'm going low-carb, so here is actually better."
119,9257,4,12,121,137,1.145985401459854,0.03668905757335006,652,"Do not even think about it!""
""You will slide under water in this Candy Land game."
5029,9257,2,16,119,137,1.145985401459854,0.033636327559783415,652,"Yes, and I won the cupcake making contest last year, too!"
2997,9270,4,13,127,144,1.1458333333333333,0.03549071855205391,652,Too bad I just started my paleo diet this week.
3118,9270,3,15,126,144,1.1458333333333333,0.034094955729785104,652,I hear Shirley Temple had a time share on Peppermint Bay.
3962,9270,4,13,127,144,1.1458333333333333,0.03549071855205391,652,I'm not sure this cartoon can handle another punch line!
6616,9270,2,17,125,144,1.1458333333333333,0.032639560491693344,652,Am I dreaming or is this just a Whole30 mirage
6099,9274,1,20,130,151,1.1456953642384107,0.030299973398275483,652,And you said it wouldn't float!
169,9274,2,18,131,151,1.1456953642384107,0.03172362855486039,652,"See, that's how you can remember the spelling. We're on a desert island; that's a dessert island. Double the S because you'd like it to be real."
2109,9274,2,18,131,151,1.1456953642384107,0.03172362855486039,652,Temptation Island never looked so sweet
2717,9274,1,20,130,151,1.1456953642384107,0.030299973398275483,652,And the great irony is I like the song CAKE BY THE OCEAN.
3328,9274,2,18,131,151,1.1456953642384107,0.03172362855486039,652,Why did I wish you on a deserted island?
6422,9274,3,16,132,151,1.1456953642384107,0.03308608211071999,652,What's the flavor of elusion?
7719,9280,2,11,90,103,1.145631067961165,0.04000705960520683,652,I think we could swim it.
54,9281,2,19,137,158,1.1455696202531647,0.030878389120956445,652,"Dude, I didn’t know human waste was this bad!"
895,9281,2,19,137,158,1.1455696202531647,0.030878389120956445,652,Oh you just have to try the Tiramisu !
2775,9281,2,19,137,158,1.1455696202531647,0.030878389120956445,652,Should I risk it in these shark-infested waters?
6219,9281,1,21,136,158,1.1455696202531647,0.029544022400847074,652,"Let it go, Cyrus"
7660,9281,2,19,137,158,1.1455696202531647,0.030878389120956445,652,"My dentist woulsay, stay put"
9763,9281,2,19,137,158,1.1455696202531647,0.030878389120956445,652,I'm trying to eliminate sugar from my diet.
3806,9287,1,16,107,124,1.1451612903225807,0.03376370813119502,652,"Well, look at it this way. We won't gain weight."
7990,9287,5,8,111,124,1.1451612903225807,0.040798399000628996,652,"Dude, I have seen Shark Week before, there is no way I am going to swim out there"
3417,9289,2,15,114,131,1.1450381679389312,0.034478136765301426,652,I knew we should have spent the extra $500 on our yard
2358,9289,2,15,114,131,1.1450381679389312,0.034478136765301426,652,It’s a good thing we’re both on the palm oil diet.
648,9291,1,18,119,138,1.144927536231884,0.03178581365345059,652,"It looks apatizing, but think what it will do to your thighs."
1570,9291,1,18,119,138,1.144927536231884,0.03178581365345059,652,You want the pie or the donut with sprinkles?
2012,9291,4,12,122,138,1.144927536231884,0.036437583866152166,652,You up for tacos?
2183,9291,1,18,119,138,1.144927536231884,0.03178581365345059,652,Ok but don't think that I'm going to share the tree with you.
2819,9291,1,18,119,138,1.144927536231884,0.03178581365345059,652,Do we swim for it or do you think a shark will get us ?
2827,9291,2,16,120,138,1.144927536231884,0.03340844911708536,652,sugar and spice and everything nice...let's stay!
3126,9291,2,16,120,138,1.144927536231884,0.03340844911708536,652,Man!...told you not to exaggerate on radio about kids surviving the crash.
3797,9291,2,16,120,138,1.144927536231884,0.03340844911708536,652,Is this before or after it was recycled?
9058,9299,3,15,127,145,1.1448275862068966,0.033873935697221545,652,I thought we were playing Candyland I guess not any more
8625,9299,2,17,126,145,1.1448275862068966,0.03242927811417444,652,"I used to avoid them because of the fat,
but now I know its because of the sugar."
7053,9299,1,19,125,145,1.1448275862068966,0.030917190014512097,652,"You know, I thought the Keto Diet would involve more food..."
5436,9299,2,17,126,145,1.1448275862068966,0.03242927811417444,652,Wouldn’t you know it. I just got diagnosed with Type 2 Diabetes before our cruise.
49,9303,3,16,133,152,1.144736842105263,0.03288166348787279,652,So...why are you gluten free?
1312,9303,3,16,133,152,1.144736842105263,0.03288166348787279,652,I hope my dentist doesn't see this!
1568,9303,1,20,131,152,1.144736842105263,0.03011522940720117,652,"If you think that's heaven, I'm fine right here on diet island."
4099,9303,5,12,135,152,1.144736842105263,0.03543276090302672,652,"Oooooh you wanted to go to the dessert island? You dumb m*therfucker, you dopey prick, now we're stranded here! I'll make sure you get your just desserts alright! And by that I mean justice hurts, because I'm going to beat the living sh*t out of you!"
6385,9303,3,16,133,152,1.144736842105263,0.03288166348787279,652,Our relationship would survive long distance...I’m just not sure it could survive your sugar addiction.
6974,9303,3,16,133,152,1.144736842105263,0.03288166348787279,652,I wonder if they’re keto...
8508,9309,2,19,138,159,1.1446540880503144,0.030697226564726208,652,"The grass always looks gr...Not now, Alan."
2846,9310,2,21,150,173,1.1445086705202312,0.029209279143269505,652,"Sure,we agreed Sammy was our cast away artist,but I told you Mr. Bojangles could never make our lives satisfying and delicious."
1188,9311,2,15,115,132,1.143939393939394,0.034233579683922204,652,I said I'd do anything to get away from all that kitsch...
3389,9311,1,17,114,132,1.143939393939394,0.032500423950642836,652,We should avoid junk food anyway...
3463,9311,0,19,113,132,1.143939393939394,0.03066948216008197,652,At least this is better for our diets.
3932,9311,2,15,115,132,1.143939393939394,0.034233579683922204,652,Wanna swim for it?
4095,9311,1,17,114,132,1.143939393939394,0.032500423950642836,652,"You know, that’s a younger ship wreck survivor’s island. I’m watching my waistline and sugars..."
8990,9311,2,15,115,132,1.143939393939394,0.034233579683922204,652,Did I mention I'm on a diet?
9213,9311,0,19,113,132,1.143939393939394,0.03066948216008197,652,Look away. It's the deprivation diet talking.
5304,9318,3,14,122,139,1.143884892086331,0.03471911071516239,652,Looks like Wayne Thibaud was on the same ship we were on.
7609,9318,2,16,121,139,1.143884892086331,0.03318361394267345,652,I’m sorry I wasn’t a worse speller
5073,9318,2,16,121,139,1.143884892086331,0.03318361394267345,652,Well at least we won't get diabetes!
2905,9318,2,16,121,139,1.143884892086331,0.03318361394267345,652,I hope they are Vegan.
1913,9322,1,19,126,146,1.143835616438356,0.030720717711077768,652,"Looks great, but I'm on a diet."
2723,9322,2,17,127,146,1.143835616438356,0.03222166674728805,652,You know sugar is bad for you.
4410,9322,1,19,126,146,1.143835616438356,0.030720717711077768,652,But they’re not gluten-free and have preservatives.
5256,9322,3,15,128,146,1.143835616438356,0.03365574422387431,652,"With our luck, they aren't gluten-free."
8605,9322,5,11,130,146,1.143835616438356,0.03635458350527441,652,we're gluten free
9366,9322,1,19,126,146,1.143835616438356,0.030720717711077768,652,Do we have to? I've always hated that game.
9737,9322,1,19,126,146,1.143835616438356,0.030720717711077768,652,Sometimes a sweet islet is just a sweet islet.
7841,9329,3,16,134,153,1.1437908496732025,0.0326797385620915,652,Invest now. Deserted dessert-watchers is the only diet plan that's FDA approved.
8278,9329,1,20,132,153,1.1437908496732025,0.029932702659059077,652,"I like your mirage better. I see a stack hamburgers and I'm vegan.  
Yeah, well I'm gluten intolerant."
6074,9329,1,20,132,153,1.1437908496732025,0.029932702659059077,652,Let’s stick to tradition
4222,9329,1,20,132,153,1.1437908496732025,0.029932702659059077,652,Hey Buddy? Yes Pete? You got that $50 I lent you?
2822,9329,1,20,132,153,1.1437908496732025,0.029932702659059077,652,"Just keep thinking of all those carbs, Slim."
919,9329,4,14,135,153,1.1437908496732025,0.03397005482027008,652,Is this Alexandria Ocasio-Cortez's Green New Deal?
5789,9329,2,18,133,153,1.1437908496732025,0.03133633674316681,652,Sugarplums? Huh. Must be that low-carb diet you were on.
1975,9336,3,18,146,167,1.1437125748502994,0.030947625246376967,652,"Spotlight, uh; moonlight, uh."
6399,9337,2,21,151,174,1.1436781609195403,0.029052797537384222,652,"Too bad we didn't rescue our toothbrushes.""

""I never believed in all-inclusive-offers for the shipwrecked anyway."""
8041,9338,2,18,134,154,1.1428571428571428,0.031146187627034697,652,I know it looks real but believe me it is a fake island. OK?
6303,9338,1,19,127,147,1.1428571428571428,0.03052670308362059,652,I always imagined Sugarland as larger and more appealing.
6671,9338,3,15,129,147,1.1428571428571428,0.03344032777032302,652,And how is this supposed to help me go on a diet?
8639,9338,3,13,117,133,1.1428571428571428,0.03562874239213164,652,I told you that if I ate gluten something bad would happen.
9701,9338,0,21,126,147,1.1428571428571428,0.02896017335997797,652,"I thought the Good Ship Lollipop was just a song, but look at those bon-boys on the peppermint bay."
9080,9338,1,19,127,147,1.1428571428571428,0.03052670308362059,652,I dreamt of The Good Ship Lollipop.  Poor customer service.
9082,9338,2,15,116,133,1.1428571428571428,0.03399244207014454,652,"I’m pre-diabetic, so I should really pass on those treats."
9769,9338,0,19,114,133,1.1428571428571428,0.030457245193658628,652,"So, do you think we can make it to dessert island before becoming dinner for a shark?"
5888,9338,1,17,115,133,1.1428571428571428,0.03227328541285171,652,"Man, do you think there's life out there?"
8709,9338,3,13,117,133,1.1428571428571428,0.03562874239213164,652,It's a shame I'm diabetic.
5528,9338,3,15,129,147,1.1428571428571428,0.03344032777032302,652,Too bad that it will not survive global warming!
9604,9338,2,19,140,161,1.1428571428571428,0.0303411539918074,652,Go ahead. I'm a vegan.
3480,9338,3,17,141,161,1.1428571428571428,0.031594704890335105,652,"Wow, no kidding, I think this is where the witch in Hansel and Gretel ended up?"
1185,9338,2,17,128,147,1.1428571428571428,0.032016676299564326,652,But then we'd have to worry about getting cavities.
4973,9338,1,16,109,126,1.1428571428571428,0.0332652365649009,652,"I’d rather die on this island, than be a sugar addict again."
1930,9338,3,14,123,140,1.1428571428571428,0.034485543050517,652,"Too bad I'm on a low-carb, sugar-free diet otherwise I'd swim there."
2411,9338,3,15,129,147,1.1428571428571428,0.03344032777032302,652,That explains the drag on that boat
523,9338,2,18,134,154,1.1428571428571428,0.031146187627034697,652,That can’t be good for my diabetes.
2533,9338,1,17,115,133,1.1428571428571428,0.03227328541285171,652,I think it's a Christmas desert tray.
2732,9338,2,16,122,140,1.1428571428571428,0.032961762036794295,652,"It’s not even real. Neither am I. After the field gets to two dozen losers it’ll be time to wake up, Hillary."
3432,9338,4,11,118,133,1.1428571428571428,0.03719312370583605,652,"I got some service earlier and checked the lyrics to Nirvana's ""Something in the Way."" You were right, Kurt says he was living off the ""drippings from the ceiling"" — not ""drippings from the semen."" Sorry for making you do that. Plus, look over there!"
3436,9338,2,19,140,161,1.1428571428571428,0.0303411539918074,652,"And if thou gaze long into an abyss, the abyss will also gaze into thee."
2440,9338,2,16,122,140,1.1428571428571428,0.032961762036794295,652,"I'd join you, but the keto diet is working for me."
4339,9361,0,23,139,162,1.1419753086419753,0.027507008748645884,652,This would be even more miserable if I wasn't diabetic.
8858,9361,3,17,142,162,1.1419753086419753,0.03141145075609624,652,Do you think that's Julia Child's recipe?
9241,9361,1,21,140,162,1.1419753086419753,0.02886722651034573,652,I hope those guys have a good dentist.
9960,9361,3,17,142,162,1.1419753086419753,0.03141145075609624,652,I guess 'Dessert Island Discs' just didn't have the same ring to it.
3148,9365,3,16,136,155,1.1419354838709677,0.03228319088461435,652,Too bad we're both diabetics.
9200,9366,3,15,130,148,1.1418918918918919,0.033227634127526065,652,I think dyslexia is starting to set in.
4384,9366,0,21,127,148,1.1418918918918919,0.028780022231420017,652,Candy Isle is a myth let's wait for another vessel.
5357,9366,2,17,129,148,1.1418918918918919,0.03181425790986645,652,I always wanted to eat my desert or is it dessert first?
6942,9366,3,15,130,148,1.1418918918918919,0.033227634127526065,652,Do you think Kilmer could’ve been sitting here when he came up with the line “only God can make a tree?”
5376,9370,4,12,125,141,1.1418439716312057,0.03570332597507787,652,"Bro, you never should have candy in the jello mold."
7499,9370,2,16,123,141,1.1418439716312057,0.03274283494896606,652,We can make it over there as long as sharks don't like candy.
1384,9370,3,14,124,141,1.1418439716312057,0.034255077916842507,652,But diabetes.
3745,9370,1,18,122,141,1.1418439716312057,0.03115728033544511,652,As they say... the sand has better treasure on the other side.
190,9374,5,9,120,134,1.1417910447761195,0.03841925524332248,652,"Without labels, we can’t tell if it's gluten-free."
5380,9374,4,11,119,134,1.1417910447761195,0.03692991095057656,652,If only one of us were a dentist...
6201,9374,2,15,117,134,1.1417910447761195,0.03375465333179144,652,Got the munchies?
7252,9374,1,17,116,134,1.1417910447761195,0.03204927098882861,652,This new keto diet is intense.
6127,9378,4,15,144,163,1.1411042944785277,0.032420237084101196,652,"Ge, I hope they never build the wall  they keep promising."
7372,9379,3,16,137,156,1.141025641025641,0.03208848130791327,652,I know! We'll call it Desert Island II!
6883,9379,3,16,137,156,1.141025641025641,0.03208848130791327,652,Gee I wonder why you chose this island?
6449,9379,1,20,135,156,1.141025641025641,0.029398038383040368,652,I just can’t derail my keto diet.
7332,9379,1,20,135,156,1.141025641025641,0.029398038383040368,652,The chocolate spread would have made the donut more tempting.
5122,9379,2,18,136,156,1.141025641025641,0.03077267695065717,652,"Seems daddy will go great  distances to part us"""
1778,9379,3,16,137,156,1.141025641025641,0.03208848130791327,652,A floating UFO from Candyville?
6439,9379,3,16,137,156,1.141025641025641,0.03208848130791327,652,"As long as it's gluten free, I'll make the swim..."
2319,9386,2,17,130,149,1.1409395973154361,0.03161436391039247,652,That mirage you have described sounds real wild.
2457,9386,3,15,131,149,1.1409395973154361,0.033017612376214166,652,Candyland did not need to be made more like Jumanji
2705,9386,3,15,131,149,1.1409395973154361,0.033017612376214166,652,"You go ahead, the shade of a candy cane just doesn't do it for me."
5144,9386,0,21,128,149,1.1409395973154361,0.028602072692801767,652,It’s only a mirage!
5920,9386,3,15,131,149,1.1409395973154361,0.033017612376214166,652,They used to call it the Candy Mountain roller coaster--there's a steep drop just below the shoreline.
8525,9386,1,19,129,149,1.1409395973154361,0.03014586677956899,652,Loaded with gluten!
8546,9386,3,15,131,149,1.1409395973154361,0.033017612376214166,652,Wish I wasn't on a 30 day sugarless diet
8609,9386,4,13,132,149,1.1409395973154361,0.034363606454985714,652,looks good from here but i hear its Capitalist...
6818,9394,4,12,126,142,1.1408450704225352,0.03546507269213331,652,"That's the United Sugar Archetypes. It's very rich, but totally lacking nutritional value."
585,9394,1,18,123,142,1.1408450704225352,0.03095320691717033,652,The candy canes are always greener .......
9479,9394,5,10,127,142,1.1408450704225352,0.03684645847195285,652,Did you hear the latest about Trump?
6950,9397,3,13,119,135,1.1407407407407408,0.03513059102800735,652,Not just kitschy scuba gear! When it stands up it has terrible coral decay!
9829,9397,2,15,118,135,1.1407407407407408,0.03352014478583837,652,Good thing I'm on a diet
3791,9397,2,15,118,135,1.1407407407407408,0.03352014478583837,652,That’s how it feels like being diabetic.
2940,9397,5,9,121,135,1.1407407407407408,0.038148067644432494,652,"y'know, i think this might be black history month."
4453,9397,2,15,118,135,1.1407407407407408,0.03352014478583837,652,"It's a mirage,and if it's not,where and the hell am I  going to get a cup of coffee !!"
2278,9402,4,10,114,128,1.140625,0.037996022313054996,652,And to think last week we found out we have Celiac disease...
6394,9402,0,18,110,128,1.140625,0.0308475562624044,652,"Have you ever heard the phrase,""The sand isn't always sweeter?"""
7811,9404,2,22,161,185,1.1405405405405404,0.02782032009032079,652,I got you babe
2137,9405,2,13,106,121,1.140495867768595,0.03580207514332723,652,Aliens still don't know that we don't eat sugar anymore.
690,9406,4,8,102,114,1.1403508771929824,0.04109431705652125,652,"I'm not clear if swimming over there to ""Trick or Treat"" would benefit us or the sharks."
7947,9406,1,22,148,171,1.1403508771929824,0.02790197282682306,652,"Take no notice! Circe is up to her usual tricks - she knows you have a sweet tooth, and that the quickest way to a man's heart is through his stomach."
4468,9408,2,19,143,164,1.1402439024390243,0.029822151170401632,652,Ginger Snaps or MaryAnn Cakes?
4896,9408,2,19,143,164,1.1402439024390243,0.029822151170401632,652,Sand always looks sweeter on the candy side.
5195,9410,4,14,139,157,1.1401273885350318,0.033151470316826886,652,Two words...Swedish. Barracuda.
7412,9410,0,22,135,157,1.1401273885350318,0.027791774230067172,652,Nailed it!
8219,9412,4,13,133,150,1.14,0.03414667664249436,652,I've always much preferred the simple life myself.
7190,9412,2,17,131,150,1.14,0.03141694779097929,652,When you think about it...its really quite funny to think WE are on Candy Island.
9346,9412,1,19,130,150,1.14,0.0299589577570406,652,At least we've got no chance of getting diabetes?
5495,9412,3,15,132,150,1.14,0.03281021284774139,652,An ice age is bound to come.
3108,9412,4,13,133,150,1.14,0.03414667664249436,652,"Looks good from here, but wait till you have to sign a new lease..."
6348,9412,3,15,132,150,1.14,0.03281021284774139,652,I wonder who lives there?  I think it is either Richard Branson or Little Debbie.
351,9418,3,14,126,143,1.1398601398601398,0.03380321293760131,652,"I dunno, sugar is so fattening."
2001,9418,1,18,124,143,1.1398601398601398,0.030751765679806843,652,There gores the neighborhood
2366,9418,0,20,123,143,1.1398601398601398,0.029106322958872888,652,"My arrangement of the the new ""13th DAY OF CHRISTMAS"":  BOXING DAY!!!"
5333,9418,1,18,124,143,1.1398601398601398,0.030751765679806843,652,"Remember, the grass (er, candy) is always greener on the other side."
6840,9418,4,12,127,143,1.1398601398601398,0.035229962548154255,652,"Sorry, I’m on a low carb diet"
7301,9418,1,18,124,143,1.1398601398601398,0.030751765679806843,652,"Sorry pal, but not with my diabetes."
8305,9418,2,16,125,143,1.1398601398601398,0.032313528879794,652,"Your name doesn't happen to be Gretel, doe it?"
9049,9425,1,17,118,136,1.1397058823529411,0.03161036294469461,652,I hope they are pescetarian.
8022,9425,2,15,119,136,1.1397058823529411,0.03328884959515664,652,All we need is a scoop of ice cream with a cherry on top. No nuts required.
8384,9425,0,19,117,136,1.1397058823529411,0.029837603516731766,652,We can eat as much as we want over there cause we'll burn off the calories on the swim back!
667,9428,3,12,114,129,1.1395348837209303,0.03607463269183389,652,Its too bad I am on the keto diet...
2234,9428,4,10,115,129,1.1395348837209303,0.03771608615509412,652,"Hantzel, Gretel, and global warming."
791,9430,2,18,138,158,1.139240506329114,0.030407952720933468,652,I can't think of any reason. Can you?gj
1898,9430,1,20,137,158,1.139240506329114,0.029051986740928366,652,"Just great, even out here,i can't stop thinking about my 400 pound ex wife. I'm having her hallucinations now."
2845,9430,1,20,137,158,1.139240506329114,0.029051986740928366,652,Wonka is escaping the cartel. THAT is as plain vanilla as he gets!
7140,9430,3,16,139,158,1.139240506329114,0.031705981198536855,652,All we get is a palm tree!
7848,9434,0,21,130,151,1.1390728476821192,0.028252621202253695,652,"To capture humans, the aliens adapted their spacecraft to lure humans to their vessel instead of beaming them up."
5716,9434,4,13,134,151,1.1390728476821192,0.0339324547859456,652,And that’s why you should have gotten a sugar daddy.
9804,9434,1,19,131,151,1.1390728476821192,0.029774331655783425,652,This dessert island is a little on the nose.
2480,9434,1,19,131,151,1.1390728476821192,0.029774331655783425,652,"Tempting? Yes, but at least we can pronounce the names in our ingredients."
3848,9434,1,19,131,151,1.1390728476821192,0.029774331655783425,652,Sometimes being on the Keto Diet sucks.
301,9434,1,19,131,151,1.1390728476821192,0.029774331655783425,652,They didn't tell us this part of the keto diet.
539,9440,1,18,125,144,1.1388888888888888,0.030552906574445045,652,Just because I chose the low GI option didn't mean I wanted to go completely vegerarian.
1420,9440,3,14,127,144,1.1388888888888888,0.033581695823721606,652,I can’t wait ‘ till we are done with this Whole 30 nonsense !
1934,9440,3,14,127,144,1.1388888888888888,0.033581695823721606,652,"You see that island populated by every girl I had a crush on in school, right?"
7295,9440,2,16,126,144,1.1388888888888888,0.03210304031196834,652,"I'd say the grass is greener, but that candy cane is definitely monochromatic."
7974,9440,2,16,126,144,1.1388888888888888,0.03210304031196834,652,You should try those pastries. They're out of this world.
8731,9440,2,16,126,144,1.1388888888888888,0.03210304031196834,652,"funny, I thought this was candyland!"
1725,9446,3,13,121,137,1.1386861313868613,0.03464610036473885,652,Let's get rescued---they may have Oreo's!
9979,9446,1,17,119,137,1.1386861313868613,0.031395347689936605,652,... but virgin coconut oil is so much better for you!
439,9446,2,15,120,137,1.1386861313868613,0.03306070270771302,652,"No thanks, I have a gluten allergy."
7334,9446,3,13,121,137,1.1386861313868613,0.03464610036473885,652,"Nah, since going Keto I've cut out processed sugar all together. I feel great...hey do you think this tree will ever grow coconuts?"
4127,9450,3,17,146,166,1.1385542168674698,0.030699079461962847,652,"Besides, I’m on that no-sugar diet."
1883,9451,0,18,112,130,1.1384615384615384,0.030409344344723834,652,Too bad that these Christmas Islanders are so damn possessive!
6057,9452,2,18,139,159,1.1383647798742138,0.030228790060765367,652,Not gluten-free!
9255,9453,3,11,109,123,1.1382113821138211,0.037096405615825154,652,"If we stay here on our desert island, your bariatric surgery will really pay off. If we swim over to that dessert island you'll  just go back to your old ways. What's it going to be"
8774,9453,3,11,109,123,1.1382113821138211,0.037096405615825154,652,"Given we are both diabetic, I see this as a diabolical joke from someone who really does not like us!!"
9268,9455,2,17,133,152,1.138157894736842,0.031029368734405406,652,"It's called Candyland, where my cruise ship was headed when it went down."
1446,9455,3,15,134,152,1.138157894736842,0.03240308781268186,652,Too bad it’s my detox week
91,9455,3,15,134,152,1.138157894736842,0.03240308781268186,652,But if you can wait 3 days the boat will pick you up.
863,9455,2,17,133,152,1.138157894736842,0.031029368734405406,652,I tried to swim over there once. I was almost eaten by a vermicious knid.
1323,9459,1,18,126,145,1.1379310344827587,0.030356580795963806,652,"Yes, but carbs..."
1372,9459,1,18,126,145,1.1379310344827587,0.030356580795963806,652,And it’s not even Thanksgiving yet
1560,9459,3,14,128,145,1.1379310344827587,0.03336304660620688,652,"Nope, no sharks. 
But, the channel is chock-full of right wingers to keep you from reaching the paradise just a short distance away."
5631,9459,2,16,127,145,1.1379310344827587,0.03189525730002669,652,"When you said, ‘a deserted island’, I thought you meant, “a
dessert-ed island’."
6579,9459,1,18,126,145,1.1379310344827587,0.030356580795963806,652,"You know, over there is full of sweets, but since you’re here with me, it makes this deserted island feel much more sweeter..."
9899,9459,1,18,126,145,1.1379310344827587,0.030356580795963806,652,I'm off sweets m'self.
6452,9465,3,17,147,167,1.1377245508982037,0.030525975773621487,652,"Trust me, a diet heavy in sugar can kill you."
7718,9465,3,17,147,167,1.1377245508982037,0.030525975773621487,652,"Darn. If only we had brought our ""s""."
5861,9465,4,15,148,167,1.1377245508982037,0.03168564444388731,652,I booked the tickets during a keto phase.
1786,9468,2,15,121,138,1.1376811594202898,0.03283564079811757,652,"""Sorry but I'm on a diet"""
3619,9468,3,13,122,138,1.1376811594202898,0.03440880453343299,652,I think it's a mirage.
8077,9468,4,11,123,138,1.1376811594202898,0.035913122284437965,652,It’s not quite what I had in mind when I wished to be on a desert island with an everlasting supply of sweets...
9446,9468,3,13,122,138,1.1376811594202898,0.03440880453343299,652,Ist there a line to get in
1249,9472,2,18,140,160,1.1375,0.030051711197732974,652,Anti Atkin propaganda-not falling for it.
4817,9472,2,18,140,160,1.1375,0.030051711197732974,652,Looks to me like too many carbs.
3504,9474,2,14,115,131,1.1374045801526718,0.033861586206062465,652,I'm beginning to suspect it's only a Candy Island of the Mind.
5378,9474,0,18,113,131,1.1374045801526718,0.03019482399680446,652,"But, where would the raised beds for the lavender go? Think about that."
8723,9474,3,12,116,131,1.1374045801526718,0.035553436296466484,652,Too bad I'm off carbs this month.
8782,9477,3,15,135,153,1.1372549019607843,0.03220326888881306,652,Screw the diet! I'm swimming to Candy Island NOW.
4528,9477,0,21,132,153,1.1372549019607843,0.0279115135940114,652,I like to swim there underwater and then pop up with a big silly grin on my face.
6841,9477,2,17,134,153,1.1372549019607843,0.03083911826106076,652,The caloric input on that island has sunk many a ship.
2830,9477,2,17,134,153,1.1372549019607843,0.03083911826106076,652,I believe that's the Good Ship Lollipop. Too bad I 'm on the keto diet.
1400,9477,2,17,134,153,1.1372549019607843,0.03083911826106076,652,"Yeah, but everyone is seriously fat over there."""
3759,9477,1,19,133,153,1.1372549019607843,0.029411764705882356,652,"It must be Christmas and we've been here since 
  Fourth of July"
4167,9483,2,13,109,124,1.1370967741935485,0.03498656109187893,652,Too bad I'm a diet...
6627,9484,1,18,127,146,1.1369863013698631,0.030162740745296356,652,The food always looks sweeter on the other island.
6286,9484,0,20,126,146,1.1369863013698631,0.028553767141629494,652,I bet my kid would love that.
5026,9484,0,20,126,146,1.1369863013698631,0.028553767141629494,652,"Of course its a national emergency.  If I eat the food I'll lose the 
weight.  Make America eat great again.  Or was that a gain"
7641,9484,1,18,127,146,1.1369863013698631,0.030162740745296356,652,"I would, but I'm doing strict keto."
3356,9484,1,18,127,146,1.1369863013698631,0.030162740745296356,652,You think those cupcakes are gluten-free?
2226,9484,4,12,130,146,1.1369863013698631,0.03454288440672902,652,"Don't worry, everything that grows on Isla Dolce is paleo. You won't gain a pound."
4464,9484,2,16,128,146,1.1369863013698631,0.031690128440218124,652,Hey k'nuckles.  Did you ever wonder if candied island is a mirage?
3560,9491,1,17,121,139,1.1366906474820144,0.03097390247691175,652,I wonder if it's the icing on top of a plastic island.
7939,9491,1,17,121,139,1.1366906474820144,0.03097390247691175,652,"Ah, I remember the  willy wonker movie what is your favourite movie?"
9638,9491,6,7,126,139,1.1366906474820144,0.038479926031968946,652,"When I was a kid, we had to walk this over ice and snow."
4271,9491,1,17,121,139,1.1366906474820144,0.03097390247691175,652,"Don't even think about going over there; those deserted desserts are so sweet, they will make you hallucinate for months!"
2650,9495,0,22,139,161,1.1366459627329193,0.02715394119664227,652,This wasn't in the Candy Land vacation brochure!
7625,9495,3,16,142,161,1.1366459627329193,0.031148928989117607,652,The Sugarhill Gang
7194,9497,1,22,153,176,1.1363636363636365,0.027164286575781668,652,"This is worse than Tantalus, kid. At least he stays immortal."
9760,9497,2,17,135,154,1.1363636363636365,0.03065117053233491,652,I would have felt worse if it was gluten free.
8965,9497,1,16,115,132,1.1363636363636365,0.0318536862814387,652,"Sunshine, rainbows and lollipops?
That's my mystery."
7735,9497,5,11,138,154,1.1363636363636365,0.03455635351817548,652,"But we don't know how to swim""...."
7370,9497,4,10,118,132,1.1363636363636365,0.03690038743330635,652,At least we are living a healthy life without sugar.
5218,9497,2,14,116,132,1.1363636363636365,0.033620198552659505,652,I'm allergic to sweets.
4184,9497,1,19,134,154,1.1363636363636365,0.02923374449465312,652,Yeah but the grass is greener on the other side.
3754,9497,4,16,156,176,1.1363636363636365,0.03054019744494765,652,It’s a one-way only trip....there’ll be no coming back!
1078,9497,3,15,136,154,1.1363636363636365,0.03200588528420813,652,"Unluckily, I am on a non-carb diet."
5169,9497,2,14,116,132,1.1363636363636365,0.033620198552659505,652,I'd like to but I'm worried about my sugar
191,9507,2,16,129,147,1.1360544217687074,0.03148760360988697,652,Do you think it is gluten-free?
5881,9507,3,14,130,147,1.1360544217687074,0.03293413337570795,652,It's the perfect diet plan!
6759,9507,1,18,128,147,1.1360544217687074,0.02997133999303024,652,Good thing I'm not a sweet tooth!
8310,9507,1,18,128,147,1.1360544217687074,0.02997133999303024,652,"I don't know, there's that sugar thing you know..."
8527,9507,2,16,129,147,1.1360544217687074,0.03148760360988697,652,I've got dibs on the cake!
2125,9512,3,11,111,125,1.136,0.03653367867351102,652,"Don’t be fooled, that’s a German submarine left from W.W. II."
905,9513,2,15,123,140,1.1357142857142857,0.03239452690903597,652,We're either carb-free or we're not.
1595,9513,0,19,121,140,1.1357142857142857,0.029049191517538663,652,Let's just swim over!
3585,9513,2,15,123,140,1.1357142857142857,0.03239452690903597,652,You think the misfit toys are somewhere around here?
5454,9513,1,17,122,140,1.1357142857142857,0.03076736015230179,652,So near and yet so sugary...\`
3909,9517,1,19,135,155,1.135483870967742,0.029057848424763957,652,"Well, I've always argued against Globalization. I see this as a test."
5328,9517,3,15,137,155,1.135483870967742,0.031810893043096186,652,"I bet none of it's keto, though."
7654,9517,2,17,136,155,1.135483870967742,0.030465484332895996,652,Your speech impediment is playing tricks on you.
8934,9517,1,19,135,155,1.135483870967742,0.029057848424763957,652,I'm not sure where it came from all of a sudden. My mouth is watering just looking at all of that meat.
9607,9521,0,18,115,133,1.1353383458646618,0.02977464321889885,652,We’ll jeopardize our health if we eat that. Now if it were organic and farm raised...
7948,9521,3,12,118,133,1.1353383458646618,0.035047009551043805,652,It's a mirage. Don't bother.
1538,9521,2,14,117,133,1.1353383458646618,0.033382206516619155,652,Sugar is the new Cancer.
5353,9521,1,16,116,133,1.1353383458646618,0.03162989954719213,652,this sugar high is making me see things
1605,9525,2,16,130,148,1.135135135135135,0.03128763392829657,652,"It looks to good to be true, just like Santa Claus proved out."
6527,9525,2,16,130,148,1.135135135135135,0.03128763392829657,652,That whale has seven blow holes
1675,9527,2,18,143,163,1.1349693251533743,0.02953262307080364,652,Would you believe Diabetes?
6337,9527,4,14,145,163,1.1349693251533743,0.03199463313619996,652,How’s that diet going?
1835,9529,0,17,109,126,1.1349206349206349,0.030557101589417508,652,"After reading the Brothers Grimm, the Kraken thought he would try something new"
8370,9529,2,13,111,126,1.1349206349206349,0.034463092019060566,652,"Well,maybe some of the baked stuff is sugar-free,but the canes,never."
7445,9531,2,15,124,141,1.1347517730496455,0.03217835641677086,652,Can you see the sugar plum tree....
5500,9531,3,13,125,141,1.1347517730496455,0.03371592716029705,652,My mind is playing a game with me.
4795,9531,2,15,124,141,1.1347517730496455,0.03217835641677086,652,Heh looks like we made the wrong turn
259,9531,2,15,124,141,1.1347517730496455,0.03217835641677086,652,It is not a mirage.  That's part of the Green New Deal!
5443,9531,4,11,126,141,1.1347517730496455,0.03518637331229484,652,"You go ahead, I'm on the keto diet."
3086,9536,1,19,136,156,1.1346153846153846,0.028884039086324472,652,"Stay tuned, we'll be on ""Dessert Island Discs"" next week."
3496,9537,1,14,104,119,1.134453781512605,0.03359563692901881,652,I think it's a shark illusion.
4214,9538,1,16,117,134,1.1343283582089552,0.0314092107945762,652,"America is not a meritocracy, and no one should think it is."
9231,9538,2,14,118,134,1.1343283582089552,0.03314753947689285,652,"In my last job, all I wanted was a wall."
3918,9540,3,14,132,149,1.1342281879194631,0.03251604986887861,652,"So, what are some, say, swimming distance goals?"
2953,9540,4,12,133,149,1.1342281879194631,0.0338819748633784,652,Looks like they survived The Caine Mutiny pretty well.
568,9540,2,16,131,149,1.1342281879194631,0.031090171718859902,652,It's a living!
101,9540,2,16,131,149,1.1342281879194631,0.031090171718859902,652,"I told you, I’m sticking with paleo if it’s the last thing I ever do."
1268,9540,5,10,134,149,1.1342281879194631,0.035194927790944686,652,I say we discard this place and move over there for the “Spark Joy” of it.
2281,9545,1,20,143,164,1.1341463414634145,0.02806065106077716,652,My doctor said all the sugar in my diet is going to kill me.
5584,9546,2,13,112,127,1.1338582677165354,0.03420715311723022,652,Ship wrecked...on the wrong island.
7869,9547,2,15,125,142,1.1338028169014085,0.03196503377475174,652,"I feel like I’m  on the 
‘GOOD SHIP LOLLIPOP’"
1998,9547,2,15,125,142,1.1338028169014085,0.03196503377475174,652,So you say you have trouble breathing; any other symptoms?
2268,9547,2,15,125,142,1.1338028169014085,0.03196503377475174,652,"Dude, can you please stop humming Alanis Morissette songs?"
3532,9547,4,11,127,142,1.1338028169014085,0.03495058834919824,652,I heard it was the set for a Nicki Minaj music video.
6710,9547,3,13,126,142,1.1338028169014085,0.03349109590754035,652,That tank top contrasts nicely with those jorts.
1696,9552,4,13,140,157,1.1337579617834395,0.03270126864312743,652,I shouldn't have taken that painting class from Wayne Thiebaud.
3024,9552,1,19,137,157,1.1337579617834395,0.028712279931863094,652,"Y’know, as a kid, this game felt easier.”

Barrett Law, Brooklyn, N"
6743,9552,2,17,138,157,1.1337579617834395,0.03010073647294656,652,Do you have any mints left?
7109,9552,4,13,140,157,1.1337579617834395,0.03270126864312743,652,"You have got to be kidding.  Instead of a rescue boat, you asked us to be sent the newest router?"
7254,9552,4,13,140,157,1.1337579617834395,0.03270126864312743,652,"It’s the plastic you have to be aware of, not the sharks."
9432,9552,3,15,139,157,1.1337579617834395,0.03142791201371613,652,Why is the food on that island so big?
7524,9558,2,19,151,172,1.1337209302325582,0.02852058423609758,652,"Sure, it's an easy swim over to that desserted island, but we'd sink on the way back."
8541,9559,0,18,117,135,1.1333333333333333,0.02936587972810687,652,But there's no drive thru.
7697,9559,1,18,131,150,1.1333333333333333,0.029411326048402325,652,I can't find my passport anywhere.
9261,9559,2,14,119,135,1.1333333333333333,0.03291612874006791,652,Im not saying it’s not a decent opportunity. I’m just sayin it’s not exactly the “Good Ship Lollypop.”
8789,9559,2,16,132,150,1.1333333333333333,0.030895170472719592,652,"Do you think that island has life forms? Oh ! I hope not, they might invade."
7475,9559,2,16,132,150,1.1333333333333333,0.030895170472719592,652,It is a mirage; I don´t see sharks around.
1968,9559,3,12,120,135,1.1333333333333333,0.0345547370232544,652,What do you mean it's not allowed on your diet?
5193,9559,2,14,119,135,1.1333333333333333,0.03291612874006791,652,Now's probably a good time to tell you I'm gluten intolerant.
2897,9559,1,18,131,150,1.1333333333333333,0.029411326048402325,652,"You said we should cut the sugar, right?"
2716,9559,1,18,131,150,1.1333333333333333,0.029411326048402325,652,"Somehow, I don't really care that the grass is greener on this side anymore."
7367,9559,2,16,132,150,1.1333333333333333,0.030895170472719592,652,Me neither.
2207,9569,4,13,141,158,1.1329113924050633,0.03250466557069184,652,It's a Fat Morgana.
4859,9569,2,17,139,158,1.1329113924050633,0.029921597111378005,652,Do you think that the island is inhabited by the witch in Hansel and Gretel? Will we end up like them?
5329,9569,1,19,138,158,1.1329113924050633,0.028542535252009008,652,I think you've gone too far with this new diet.
9988,9569,2,17,139,158,1.1329113924050633,0.029921597111378005,652,"I love you, too, but you still haven't commented on the approaching candy submarine swimming our way."
8470,9573,1,17,125,143,1.132867132867133,0.030163810031416292,652,"Let's race to the land of sweets.
Whoever wins gets to eat."
6750,9573,4,11,128,143,1.132867132867133,0.034717929148063764,652,"We may be forced to defend our palm !  This monster, as sweet as it looks,  has huge appetite for coconuts !"
2042,9573,3,13,127,143,1.132867132867133,0.03326922824609011,652,She told me to go left and now I'm dessert-less with you.
3441,9573,2,15,126,143,1.132867132867133,0.0317545034892833,652,Its not Grenada.  Must be Haight-Ashbury Park.
4472,9573,2,15,126,143,1.132867132867133,0.0317545034892833,652,"I bet King Kandy owns it, unless Princess Lolly got it in the divorce."
1788,9578,0,17,111,128,1.1328125,0.030114393430435735,652,"I find it interesting that in a desperate moment, we're both reverting to a childish fantasy."
8401,9579,1,20,145,166,1.1325301204819278,0.027744950992279423,652,Why tempt ourselves with all that gluten?
45,9580,0,20,131,151,1.1324503311258278,0.02767757707489179,652,It's from the first 'land shark-candygram' tests off off off Broadway.
3774,9581,3,12,121,136,1.1323529411764706,0.03431372549019608,652,Do you think we can bribe the sharks?
6678,9581,1,16,119,136,1.1323529411764706,0.030976875782900634,652,"Geez Joe, I told you we shouldn’t have left, you go first."
278,9581,1,16,119,136,1.1323529411764706,0.030976875782900634,652,That island is looking like a snack!
1544,9581,1,16,119,136,1.1323529411764706,0.030976875782900634,652,Yeah my stomach isn't that big either.
202,9585,0,16,105,121,1.1322314049586777,0.030922788320445805,652,"We may be sick of coconuts now, but after the sugar high there'll be nothing left."
2702,9586,4,13,142,159,1.1320754716981132,0.032310401868089825,652,"I'd swim over there but the water's pretty frosty."""
5484,9586,2,17,140,159,1.1320754716981132,0.029744563823956918,652,I TOLD you we should have asked Uncle Milton Bradley for CANDY LAND not STAY ALIVE for Christmas!
8233,9586,1,19,139,159,1.1320754716981132,0.02837477015197548,652,"Looks like a party to
Me. Yahoo!"
817,9589,4,11,129,144,1.1319444444444444,0.03448833425756985,652,I am not swimming to there with you.  I have diabetes.
6010,9589,1,17,126,144,1.1319444444444444,0.029967814543048924,652,so does this mean were on alcatraz
9700,9589,3,13,128,144,1.1319444444444444,0.033050266303568096,652,Too bad I've given up carbs.
6996,9592,4,9,116,129,1.1317829457364341,0.03712644197803879,652,At least we will have low cholesterol.
2542,9593,1,20,146,167,1.1317365269461077,0.02758972900368628,652,Go ahead. Enjoy. I never touch sweets.
2828,9594,1,18,133,152,1.131578947368421,0.029049378230762826,652,"If we wait long enough, will it float all the way here?"
4775,9594,0,20,132,152,1.131578947368421,0.02750868953354996,652,This is going to ruin my diet.
7346,9594,3,14,135,152,1.131578947368421,0.03190835512957805,652,"No thanks, I am watching my cholesterol."
9179,9594,3,14,135,152,1.131578947368421,0.03190835512957805,652,If only we landed in the gum trees.
4337,9598,0,18,119,137,1.1313868613138687,0.02896808004815244,652,Oh my a new game we can play.
5589,9598,2,14,121,137,1.1313868613138687,0.032462810654466094,652,"I hope it's all gluten and dairy free, that's what I ordered."
9455,9598,2,14,121,137,1.1313868613138687,0.032462810654466094,652,"Nah, I’ll pass. Too many carbs..."
9295,9601,6,7,132,145,1.1310344827586207,0.03695183311650232,652,I told you going into gumdrop forest was a trap!
8283,9601,4,11,130,145,1.1310344827586207,0.03426174381790548,652,Losing at Candyland again!
5327,9601,2,15,128,145,1.1310344827586207,0.03134160506766892,652,"Shh.  I think I can hear Shirley Temple sing ""On the Good Ship Lollipop!"""
1908,9601,1,17,127,145,1.1310344827586207,0.02977433068273246,652,Am I dreaming of Shirley  Temple?
2537,9601,2,15,128,145,1.1310344827586207,0.03134160506766892,652,How's that Whole 30 thing going?
3869,9601,2,15,128,145,1.1310344827586207,0.03134160506766892,652,"It is a good thing that we know the government's food guide, otherwise it would be a mirage."
2731,9607,3,11,116,130,1.1307692307692307,0.03519849419866557,652,But do you think it’s all paleo?
5593,9607,1,15,114,130,1.1307692307692307,0.031629303266113316,652,You can't eat it. I will just give you more of a sweet tooth.
6079,9607,2,13,115,130,1.1307692307692307,0.03346152132639265,652,"No, the mental training is exactly why it’s *not* just another fad diet"
5951,9610,3,14,136,153,1.130718954248366,0.031710781364658415,652,"Like I said, butter, not guns."
6798,9610,0,20,133,153,1.130718954248366,0.027341830932486138,652,"I know, my sweet tooth is out of this world."
9962,9610,1,18,134,153,1.130718954248366,0.028871699477969075,652,At least we don't need to worry about diabate.
1359,9613,1,16,121,138,1.1304347826086956,0.030556194937104857,652,"They're talking to me, for sure...as soon as you get a message we'll go for it."
2492,9613,4,10,124,138,1.1304347826086956,0.03537005255050294,652,"Looks like they found their ""Dessert"" island band"
4303,9613,3,12,123,138,1.1304347826086956,0.033841603015051513,652,Don't fall for it! The only giant candy cane around here is right behind us.
7022,9613,2,14,122,138,1.1304347826086956,0.03224077498806981,652,Just my luck I'm diabetic.
7044,9613,1,16,121,138,1.1304347826086956,0.030556194937104857,652,I wonder if anything there is gluten-free.
8224,9613,3,12,123,138,1.1304347826086956,0.033841603015051513,652,Oasis of the sea.
8768,9613,0,21,140,161,1.1304347826086956,0.026624888508512815,652,When I said to aim our flotsam to the right of course I meant that right.
9050,9613,5,11,145,161,1.1304347826086956,0.033122250011958926,652,"Honee, don't worry, you are sweet enough for me."
7336,9621,3,16,150,169,1.1301775147928994,0.0297543802312731,652,Is that really how you want to deal with this diet?
602,9622,1,17,128,146,1.13013698630137,0.02958331090966,652,"I know it's a mirage, but I am still teetering on diabetic shock."
4858,9622,3,13,130,146,1.13013698630137,0.032620835473002985,652,Feh.  I'd never set foot in that synagogue.
7931,9622,3,13,130,146,1.13013698630137,0.032620835473002985,652,Where’s the Big Rock Candy Mountain?
8147,9622,4,11,131,146,1.13013698630137,0.034038099509906404,652,I hope it's duty free and gluten free!
9033,9622,1,17,128,146,1.13013698630137,0.02958331090966,652,I’ve been watching my sugar
735,9627,2,16,136,154,1.12987012987013,0.030138883881871126,652,"Unfortunately, they're off my diet."
2329,9627,4,12,138,154,1.12987012987013,0.0328346950235896,652,We can't go over there. I'm on a diet.
8194,9629,0,17,114,131,1.1297709923664123,0.02947364949690705,652,Is there any easy flight ??
4152,9629,2,13,116,131,1.1297709923664123,0.033220108953149606,652,"Healthy mind, healthy body. No more junk food!"
2212,9629,2,13,116,131,1.1297709923664123,0.033220108953149606,652,I would have crashed landed there but...whole 30.
1815,9629,3,11,117,131,1.1297709923664123,0.03494303150780469,652,That other Island looks sweet and tempting but on the other hand if we go there we'll have no where to sleep!
431,9633,2,17,143,162,1.1296296296296295,0.02922573812237345,652,We can eat it all except the Candy Canes which we will use for floats.
630,9633,2,17,143,162,1.1296296296296295,0.02922573812237345,652,"Absolutely, it would be be bad for our diet!"
1117,9635,3,12,124,139,1.129496402877698,0.03361035814992439,652,I said aavikko.
2632,9635,2,14,123,139,1.129496402877698,0.03202173887237975,652,Doesn’t matter. My cardiologist says that sugar is the worst thing I can eat.
3725,9637,0,19,128,147,1.129251700680272,0.02776438274089806,652,I'd give my left foot to eat that doughnut.
1451,9637,3,13,131,147,1.129251700680272,0.032410258087984076,652,"If a ship passes through, which island do you think they'll choose?"
4793,9637,2,15,130,147,1.129251700680272,0.030939244806785185,652,It's a no for me... I'm diabetic.
563,9637,1,17,129,147,1.129251700680272,0.029394708862287292,652,"Carl, where’s the chocolate boat?"
770,9637,1,17,129,147,1.129251700680272,0.029394708862287292,652,"Tempting, but I'm watching myself."
4213,9642,2,16,137,155,1.1290322580645162,0.02995552829928984,652,Did we land on keto island?
4655,9642,2,16,137,155,1.1290322580645162,0.02995552829928984,652,"""I just don't like that sweet taste in my mouth"""
5644,9642,1,14,109,124,1.1290322580645162,0.03232356319172396,652,"Even if it wasn't a mirage, I'm diabetic."
9063,9642,3,10,111,124,1.1290322580645162,0.036153470435524894,652,"For cartoon from Feb 11, 2019

“Have you noticed any tightness in your chest?”"
9924,9646,2,17,144,163,1.1288343558282208,0.029056770941986526,652,Such nonsense
8606,9647,3,11,118,132,1.128787878787879,0.034691234183268006,652,fdasfsdfsdfsdaf
9653,9647,2,13,117,132,1.128787878787879,0.03298213619756019,652,It's not a mirage. It's just the sugar rush.
2280,9647,2,13,117,132,1.128787878787879,0.03298213619756019,652,Just think what that would do to your blood sugar.
3674,9647,2,13,117,132,1.128787878787879,0.03298213619756019,652,I told you to turn right!
6881,9651,0,18,122,140,1.1285714285714286,0.02839100277060259,652,"I chose Candy Land as my one game for our desert island, not a deserted Candy Land island."
8769,9651,1,16,123,140,1.1285714285714286,0.030146707303438162,652,If only cupcakes and donuts had wings like a Boeing 747 to fly straight into our mouths.
9483,9651,1,16,123,140,1.1285714285714286,0.030146707303438162,652,"In an effort to lower blood sugar levels, the sweets are on a strict 30 day desert island survivor cleanse diet.
Mike Darrington - Spokane, WA"
8772,9654,3,13,132,148,1.1283783783783783,0.032202369339019835,652,Aww.. you really think my eyes look like the ocean? You’re so sweet.
362,9654,2,15,131,148,1.1283783783783783,0.030741892064240453,652,Let’s start a band called Marooned Take 5.”
3252,9654,2,15,131,148,1.1283783783783783,0.030741892064240453,652,Is it a mirage or one of those human luring monster that are hungry?
3996,9654,2,15,131,148,1.1283783783783783,0.030741892064240453,652,I guess this is a good of an excuse as any to start keto.
6430,9658,2,16,138,156,1.1282051282051282,0.029774377266374354,652,"Quite singing MacArthur Park...
I’m seeing too much as it is."
6396,9658,1,18,137,156,1.1282051282051282,0.028351376609639215,652,l'm sorry I forgot the GPS.
4299,9658,1,18,137,156,1.1282051282051282,0.028351376609639215,652,"If those aren't vegan, I'm eating You"
670,9658,2,11,104,117,1.1282051282051282,0.03547177210595492,652,"I never thought that I would see the day, when diabetics are banished to an island."""
2031,9662,3,15,146,164,1.1280487804878048,0.0301568147083894,652,That's where Jeff Probst lives.
5231,9662,3,15,146,164,1.1280487804878048,0.0301568147083894,652,"If I look, do you promise to not try and eat me again?"
1597,9664,1,14,110,125,1.128,0.03208054379717683,652,We could start an alien rumor.
3330,9664,2,12,111,125,1.128,0.034032242776330456,652,"Yup, looks good. But those aren't flooded Brooklyn treats, ya egg. Those are fuckin flooded Portland treats and I'm not risking the ass I have left for fuckin kimchi donuts and sweetbread candy canes. I've got all the sweetbreads I need right here..."
9648,9666,2,13,118,133,1.1278195488721805,0.03274753053009996,652,But I told you I’m trying to avoid sugar.
8999,9666,2,13,118,133,1.1278195488721805,0.03274753053009996,652,"What the hell does an ""s"" have to do with us being stranded"
9634,9666,4,9,120,133,1.1278195488721805,0.036058883633930214,652,"Let's wait for the next one,except for the candy canes there's nothing there that's GF!"
3566,9666,0,17,116,133,1.1278195488721805,0.02906128735473255,652,I always wondered what that would feel like.
8820,9666,1,15,117,133,1.1278195488721805,0.030959321524656892,652,"No, it’s not a mirage, but alas, I don’t have a sweet tooth!"
4382,9671,2,14,125,141,1.127659574468085,0.03159242696788422,652,What do you think?
6894,9671,1,16,124,141,1.127659574468085,0.02994602342761689,652,That reminds me--it's almost pi day.
9433,9671,5,8,128,141,1.127659574468085,0.036083691738820915,652,It would only cause another crash.
1327,9674,2,15,132,149,1.1275167785234899,0.03054702702639284,652,Talk about a sweet tooth.
7477,9674,3,13,133,149,1.1275167785234899,0.03199711833459975,652,Perverts of the sea?
8409,9676,1,18,138,157,1.127388535031847,0.02818204894162055,652,"Mudt be Pierre Hermé's island  --
the famous desert chef."
733,9676,0,20,137,157,1.127388535031847,0.02669397994342149,652,Too bad it's not gluten-free
4445,9676,2,16,139,157,1.127388535031847,0.029595391531047587,652,I don't think it's Jenny Craig.
9728,9679,2,17,146,165,1.1272727272727272,0.028724596879689916,652,Imagine ending up there with our A1C. We sure are lucky.
5292,9679,3,15,147,165,1.1272727272727272,0.029983533746176128,652,Wow. I guess the rumors were true. Moby Dick is now Moby Diane.
5417,9681,3,16,154,173,1.1271676300578035,0.029102675579081777,652,"Did you request the “Keto Island,” too?"
4591,9682,0,17,117,134,1.126865671641791,0.028859365115889903,652,Disney...
4823,9682,2,13,119,134,1.126865671641791,0.03251622143116169,652,"Damn, I'm on a low carb, sugar free diet."
6014,9684,2,14,126,142,1.1267605633802817,0.03138203590531418,652,"It seems like the swim would cancel out the carbs, but you can't out-train a bad diet"
5116,9684,2,14,126,142,1.1267605633802817,0.03138203590531418,652,Forget it. It's either a sugar-coated mirage or a diabetic cesspool.
4923,9684,3,12,127,142,1.1267605633802817,0.03293512256587904,652,"Since he’s been accepting bitcoin, his muffins are selling like hotcakes"
8192,9684,1,16,125,142,1.1267605633802817,0.02974797567390733,652,"So this is what you meant by ""want a date or a tasty cake?"""
2968,9684,3,12,127,142,1.1267605633802817,0.03293512256587904,652,I gave up desserts years ago.
2956,9684,2,14,126,142,1.1267605633802817,0.03138203590531418,652,"I don’t know anout you, but I’m diabetic."
3345,9684,2,14,126,142,1.1267605633802817,0.03138203590531418,652,"Lately, I've cut out sugar from my diet."
8230,9691,0,19,131,150,1.1266666666666667,0.027247587445967624,652,I'm pretty sure there's no candy cane exception on the keto diet.
3308,9692,2,16,140,158,1.1265822784810127,0.0294185327600902,652,I'm sweet on you!
3615,9692,1,18,139,158,1.1265822784810127,0.028014717822477754,652,"Oh, Oh, its the North Korean navy...."
7171,9692,0,20,138,158,1.1265822784810127,0.026536743575457884,652,It would be a blessing if I didn’t have high cholesterol
7396,9695,3,15,148,166,1.1265060240963856,0.02981222326872017,652,Should I call the health department?
2357,9696,0,15,104,119,1.1260504201680672,0.030554440402909097,652,"You go ahead if you want, but my doctor recommended I avoid sweets for a few months."
5730,9696,0,15,104,119,1.1260504201680672,0.030554440402909097,652,Life can be exciting living next to Carnival Island.
8173,9698,0,16,111,127,1.125984251968504,0.0295619097779183,652,"No matter how long we are stuck here, I still don't get why it's the Cherry Pitfall?"
9530,9699,2,13,120,135,1.125925925925926,0.03228814032252351,652,So nice here at candy land
8582,9699,3,11,121,135,1.125925925925926,0.03395706590682581,652,I'm afraid once we get there that they won't have anything gluten-free.
720,9699,1,15,119,135,1.125925925925926,0.030528113043118553,652,I'm on a diet.
5614,9699,0,17,118,135,1.125925925925926,0.02866020527595505,652,the reality of dieting
5808,9699,3,11,121,135,1.125925925925926,0.03395706590682581,652,"I'm not schizo,hallucinating, or delusionary. I know what I see."
5422,9704,2,14,127,143,1.1258741258741258,0.031174413745978975,652,"Who cares about the sharks?  Think of all those calories . . . """
9193,9704,0,18,125,143,1.1258741258741258,0.027836270582217233,652,"I thought about making the swim, but there’s no way that’s gluten-free."
2085,9706,2,15,134,151,1.1258278145695364,0.030164575457022034,652,I’d go with you but my doctor said I can’t have sweets anymore.
7496,9706,2,15,134,151,1.1258278145695364,0.030164575457022034,652,I wonder if I'm still a diabetic?
2127,9708,0,20,139,159,1.1257861635220126,0.026381332653696164,652,"We're gonna call it the ""Pie-er"" festival."
2360,9708,3,14,142,159,1.1257861635220126,0.030574649634705534,652,It had been an inhabited island before the last resident was addicted to regional products.
7519,9710,2,17,148,167,1.125748502994012,0.02839988893550744,652,"Hey, tomorrow everything will be okay."
7864,9711,2,16,142,160,1.125,0.02907104721477233,652,"I can't have gluten.
I'm diabetic."
8402,9711,2,14,128,144,1.125,0.030969506520290797,652,"Damn it, I'm on a sugar free diet."
7765,9711,3,12,129,144,1.125,0.032499775864387605,652,It's the Good Ship Lollipop Submarine.
7433,9711,0,17,119,136,1.125,0.02846375212766555,652,I knew I should have started my diet next week.
7288,9711,4,13,151,168,1.125,0.030660791207653578,652,I knew candyland cheaters—they were toddlers.
7056,9711,4,9,123,136,1.125,0.03529752162234253,652,"My card’s expired, what about your’s?"
6804,9711,4,11,137,152,1.125,0.03275501871938216,652,"So, you’re telling me I’ll notice a real improvement if I go keto?"
6724,9711,2,11,107,120,1.125,0.03462989592644989,652,I moved here when I became pre-diabetic.
832,9711,1,17,134,152,1.125,0.02848641999418402,652,Witches Island.
5543,9711,3,11,122,136,1.125,0.03371917215481573,652,"It’s not a robotic island with candy, is it?"
321,9711,1,15,120,136,1.125,0.03031695312954162,652,And how have we been sleeping lately?
1426,9711,3,13,136,152,1.125,0.0313967016669968,652,Studio budget cuts....Robinson Crusoe meets Mars Attacks
6091,9711,2,14,128,144,1.125,0.030969506520290797,652,I guess there’s always a”greener” oasis somewhere else!
3971,9711,4,10,130,144,1.125,0.0339611620584533,652,"Pay no attention to that 
It’s just that angler fish again"
4717,9711,1,17,134,152,1.125,0.02848641999418402,652,"I'd go with you, but I'm doing Whole30."
3349,9711,2,14,128,144,1.125,0.030969506520290797,652,I think that island has telomeres. It must be rather new.
3729,9727,1,18,142,161,1.124223602484472,0.02752435958822421,652,"I'd love to, but I'm on a low-carb diet."
5351,9727,1,18,142,161,1.124223602484472,0.02752435958822421,652,One chance in a million that’s it’s pastries? So there is a chance!
881,9729,0,18,127,145,1.1241379310344828,0.027478236983636602,652,This channel could be infested with sharks: why don't you go check it out:
6236,9729,1,16,128,145,1.1241379310344828,0.029169143771148327,652,"No, I'm trying this new gluten-free thing."
4560,9731,2,13,122,137,1.1240875912408759,0.0318413970781568,652,It's a mirage...this too will pass.
9174,9731,1,15,121,137,1.1240875912408759,0.030108675841575592,652,How do you know there will be milk and honey on the other side?
149,9733,2,12,115,129,1.124031007751938,0.033031125095076184,652,"Hey, You think this island has postmates?"
1002,9733,0,16,113,129,1.124031007751938,0.029134295306924237,652,Shame that it’s all papier-mache.
2169,9733,2,12,115,129,1.124031007751938,0.033031125095076184,652,"Hmm, looks fairly resource-rich. You up for some preventive-war?"
4819,9736,2,15,137,154,1.1233766233766234,0.02960843129289957,652,Billionaires' tactics don't work for me.
6854,9736,1,17,136,154,1.1233766233766234,0.028138528138528147,652,"I'll race you to the rainbow, Bro"
1243,9738,1,16,129,146,1.1232876712328768,0.028981141489124788,652,Shame I'm not doing carbs this week.
4129,9738,0,18,128,146,1.1232876712328768,0.02730262351355835,652,"oh look there, Bee from the candy store,"
2684,9740,3,11,124,138,1.1231884057971016,0.03325320722623481,652,Bikini bottom isn't so great anymore
2232,9740,3,11,124,138,1.1231884057971016,0.03325320722623481,652,Just when I was trying to stay off carbs!
8128,9742,2,12,116,130,1.123076923076923,0.03278993805442386,652,"I never met Shirley Temple, but I bet she was a spoiled brat."
1839,9743,3,14,146,163,1.1226993865030674,0.029861208062453314,652,What a coincidence. I dreamt of Candy last night too...but the kind that's just earning extra money for college and working through daddy issues.
9468,9743,3,14,146,163,1.1226993865030674,0.029861208062453314,652,I would but I’m on an enedia diet.
1533,9745,3,13,139,155,1.1225806451612903,0.03081831004204023,652,Now that we’re married and thinking about children we may want to move to the burbs
3662,9745,1,17,137,155,1.1225806451612903,0.027967729130634996,652,Is it a merrage or is this our lucky day?
4168,9745,1,17,137,155,1.1225806451612903,0.027967729130634996,652,perhaps we should invest in some metal straws
5973,9745,2,15,138,155,1.1225806451612903,0.02942755601958721,652,"That earworm country song of ""The Big Rock Candy Mountain,"" has new meaning for me now."
638,9749,3,12,132,147,1.1224489795918366,0.03186782995042317,652,To bad i'm diabetic
138,9749,0,18,129,147,1.1224489795918366,0.02712922235159771,652,Want to know what your playing for?
9078,9749,2,14,131,147,1.1224489795918366,0.030370555240784372,652,I know Fyre this year has been pretty lame but look what
2343,9752,0,17,122,139,1.1223021582733812,0.027890097504396423,652,"I'm telling you, Joe, it's 2 sweet 2B 4got10...but ya gotta try."
5905,9752,0,17,122,139,1.1223021582733812,0.027890097504396423,652,Might be art of the Big Rock Candy Mountains chain.
7991,9752,1,15,123,139,1.1223021582733812,0.02970053793048287,652,"It’s tempting, but it is all sugar!"
9141,9755,0,16,115,131,1.1221374045801527,0.028718776889342296,652,"I don't care, Geppetto, if you no longer love me.  At least Pinocchio would lie he could get me there."
9946,9755,1,14,116,131,1.1221374045801527,0.030695406140269943,652,-but I’m on a diet to get sexy abs!
4059,9757,3,9,111,123,1.1219512195121952,0.0357426603008457,652,hey are you holding?
804,9757,1,13,109,123,1.1219512195121952,0.031795875876157974,652,Let's go. I don't see any castaway witch.
8964,9759,2,14,132,148,1.1216216216216217,0.03017599507771777,652,"Hey dude, if you stop at the shore, will you bring me back some snacks?"
4779,9759,0,18,130,148,1.1216216216216217,0.0269579923624883,652,IT LOOKS LIKE A CANDYLAND ISLAND TO ME
8778,9759,2,14,132,148,1.1216216216216217,0.03017599507771777,652,Poseidon may drop by soon.
1704,9762,1,15,124,140,1.1214285714285714,0.029500565505505463,652,"Yeah, but it's not keto."
2460,9762,2,13,125,140,1.1214285714285714,0.031193882221734227,652,"I played ""Candy Land"" as a kid, but too bad we don't have ""Shoots and Ladders""."
7373,9762,2,13,125,140,1.1214285714285714,0.031193882221734227,652,It could be worse--every now and then a sugar bowl does the tootsie roll with a big fat devil's food cake.
9021,9762,0,17,123,140,1.1214285714285714,0.027703942719869513,652,Maybe this is a desert cupcake after all.
1018,9766,2,16,147,165,1.121212121212121,0.02823703751020032,652,"I hear the cops have wooden legs. Oh, and the vaping trees!"
9577,9766,1,14,117,132,1.121212121212121,0.03047602712418407,652,"Actually, I’m on the Whole 30 Diet"
1860,9768,3,13,141,157,1.1210191082802548,0.030444363317797117,652,Life of Riley is right in front of you.
8645,9769,3,12,134,149,1.1208053691275168,0.031459958279611025,652,Better there than here.  I'm trying to cut back on sweets.
1104,9769,2,14,133,149,1.1208053691275168,0.02998389990290892,652,(Sigh$ 2020:  so near and yet so far!
9169,9769,6,6,137,149,1.1208053691275168,0.03552200922887781,652,Dad shits in his pants
3300,9772,2,13,126,141,1.1205673758865249,0.030983829663298712,652,All the world is candy land and we but licorice spaces.
7144,9772,0,17,124,141,1.1205673758865249,0.0275202371976855,652,If  I only could swim?
9681,9772,2,13,126,141,1.1205673758865249,0.030983829663298712,652,And it used to be known as the Island of Misfit Pants.
7293,9775,2,12,119,133,1.1203007518796992,0.03208696385756983,652,And this is why we have to tax the ultra-sweet.
2917,9775,1,14,118,133,1.1203007518796992,0.030259743605064584,652,"Sure they have praline, but we are diabetes free"
7280,9777,2,11,112,125,1.12,0.03331182101529182,652,"Now that I come to think of it, can the Palm tree grow candy?"
7263,9777,1,16,133,150,1.12,0.02825261564577235,652,Thatta a cool whale
6044,9777,1,16,133,150,1.12,0.02825261564577235,652,It’s an out of the way Dylan’s Candy Bar but perhaps they have Creme Brûlée on the top level.
1076,9777,0,21,154,175,1.12,0.024635270482057582,652,Is this the sea of swirly-twirly gumdrops from that one movie... what’s it called?
1918,9777,4,10,136,150,1.12,0.032659863237109045,652,"If this doesn't work,we'll use a laxative."
5754,9777,3,12,135,150,1.12,0.03125989776140817,652,"I think it's paradise island, we should swim for it.""
""No. I think it's a poisonous submersible insect spaceship armed with an arsenal of defensive nuclear armamints."
800,9783,1,15,126,142,1.119718309859155,0.029108545111038938,652,A vegan dreams: longing for intimacy
1840,9783,3,11,128,142,1.119718309859155,0.03235873360030459,652,Too bad we're vegans with gluten allergies.
5018,9783,2,13,127,142,1.119718309859155,0.030776574197730895,652,"I’m telling you it’s not just a mirage—that island is desserted.”
or
“I think it’s a trap—it brings back nightmares I had of the Child Catcher in Chitty Chitty Bang Bang."
2056,9786,3,13,143,159,1.119496855345912,0.03007934717310979,652,Maybe we should have stuck with Keto.
2762,9787,0,16,118,134,1.1194029850746268,0.02811709033036365,652,Actually I'm glad. I'm pre-diabetic.
5188,9787,1,14,119,134,1.1194029850746268,0.03004649096450161,652,I see food things in your future
2164,9789,1,15,127,143,1.118881118881119,0.028916393863853085,652,Captain Ahab was the wrong choice for The Good Ship Lollipop.
3746,9790,0,19,141,160,1.11875,0.025654751481643822,652,I reckon it’s the Ice Crean Sea or the Licorice Lagoon. Wonder if King Kandy would grant us asylum.
1736,9790,2,15,143,160,1.11875,0.028555191786913663,652,"My dentist told me, don't."
1074,9792,2,10,106,118,1.11864406779661,0.03440159483209612,652,"Sugar is not that good for you, you know..."""
6279,9793,1,14,120,135,1.1185185185185185,0.029836206355915173,652,Please stop singing 'Shiny.'
9514,9793,2,12,121,135,1.1185185185185185,0.03163475192294538,652,At midnight ghosts of the Lollipop Kids appear.
1875,9795,1,16,135,152,1.118421052631579,0.027901838537781165,652,Aren't you glad we went keto?
137,9795,0,18,134,152,1.118421052631579,0.026293995855474952,652,Too much added sugar!
3749,9797,1,13,113,127,1.1181102362204725,0.030848868649533775,652,What if the sharks have evolved?
2285,9797,1,13,113,127,1.1181102362204725,0.030848868649533775,652,My heart is dying for those pastries.
877,9799,1,15,128,144,1.1180555555555556,0.028726748608966377,652,Maybe if an insulin needle and syringe float in we can visit.
8404,9799,3,11,130,144,1.1180555555555556,0.03192923863628674,652,The goodies are always more luscious...
2763,9801,1,17,143,161,1.1180124223602483,0.02698470061643287,652,"You realize , after we eat all  that stuff , we will sink to the bottom of the ocean “ !"
6995,9802,1,14,121,136,1.1176470588235294,0.029628828644818663,652,It's the grandchild of the good ship Lollipop.
5480,9802,2,12,122,136,1.1176470588235294,0.031413372132543575,652,"I know, but it would be sooo fattening."
3975,9802,1,14,121,136,1.1176470588235294,0.029628828644818663,652,Trolli’s only come out during low tide
3713,9802,2,12,122,136,1.1176470588235294,0.031413372132543575,652,"Remember the song about ""milk and honey on the other side?"""
2646,9802,1,16,136,153,1.1176470588235294,0.027729677693590093,652,"Together now, 'There is no
Life I know
To compare with pure imagination
Living there
You'll be free
If you truly wish to be . . . '"
3796,9807,2,15,145,162,1.117283950617284,0.028220492044604986,652,Perhaps our
2445,9808,1,15,129,145,1.1172413793103448,0.02853956096077043,652,"Just our luck, to many carbs."
6571,9808,1,15,129,145,1.1172413793103448,0.02853956096077043,652,"True, it looks great.  But you know they say that sugar is poison."
8575,9808,1,15,129,145,1.1172413793103448,0.02853956096077043,652,"how is it that I  make out traffic jams, high rises and power lines?"
1089,9811,1,13,114,128,1.1171875,0.03062081915460164,652,Let's wait for the keto diet to emerge.
6249,9811,0,15,113,128,1.1171875,0.028541252068467964,652,That was a poor investment.
9775,9813,0,16,121,137,1.1167883211678833,0.02753991878200872,652,"oh no, another alien sugar high!"
7595,9813,0,16,121,137,1.1167883211678833,0.02753991878200872,652,"Don't sugar the pill, Larry!"
6597,9815,3,11,132,146,1.1164383561643836,0.031510956582628,652,Desserts are floating to our desert island.
6655,9815,1,15,130,146,1.1164383561643836,0.028354783761706692,652,Oh and Mom says we should arrive early tonight.
4527,9817,2,14,139,155,1.1161290322580646,0.028880579433714592,652,Treeless wouldn't have been all bad!
78,9818,1,14,123,138,1.1159420289855073,0.029222557595695114,652,"Sadness is only a state of mind. Here, in liquid state to be specific."
213,9818,4,8,126,138,1.1159420289855073,0.03422451520218665,652,I’ll have to pass - I’m on the Atkins Diet.
1337,9818,2,12,124,138,1.1159420289855073,0.030979741690832636,652,"Enticing, but I'm still on a low sugar diet."
1867,9821,0,19,145,164,1.1158536585365855,0.025068200023023537,652,"O, boy,  must be Disney Land"
8472,9822,2,13,132,147,1.1156462585034013,0.02978037021850836,652,Why’d it have to be lime flavored jello?
8267,9822,1,15,131,147,1.1156462585034013,0.02817237104391227,652,THEY'RE ALL YOURS 'CAUSE THEY'RE MADE FROM SEA FOAM & SAND
9331,9824,2,11,117,130,1.1153846153846154,0.032090018333411505,652,And you said this is better than the harm reduction method?
8530,9824,0,15,115,130,1.1153846153846154,0.028129132725431827,652,i've got six cavities just looking at that stuff!
5840,9824,1,16,139,156,1.1153846153846154,0.02722564241224031,652,"I know that it's spelled with two S's, but Kelly and I just went gluten-free."
9989,9824,0,18,138,156,1.1153846153846154,0.025661695556225158,652,"Then one day, he said he had to get back to the factory and put to sea in a marzipan boat.  Never saw Willy again."
1897,9824,2,14,140,156,1.1153846153846154,0.028704504710898093,652,Chiam was a good person and he didn't keep kosher.
1826,9824,3,9,118,130,1.1153846153846154,0.03389734297869894,652,"Tides
Do you know when the tide ebbs out so we can walk across again"
995,9824,2,14,140,156,1.1153846153846154,0.028704504710898093,652,All we need is love (but some sweets now and then wouldn't hurt)
2682,9824,1,16,139,156,1.1153846153846154,0.02722564241224031,652,"Looks Good -- Doesn't it. 
BUT
In this close a quarters - 
Eating spoiled food is not pretty"
6800,9832,2,12,125,139,1.1151079136690647,0.03076736699358617,652,"Tantalizing, but all I need for my keto diet is right here on this island..."
9801,9832,1,14,124,139,1.1151079136690647,0.02902355004410562,652,I’m on the Whole 30 right now; it’s the sweetest kind of surrender.
3363,9832,1,14,124,139,1.1151079136690647,0.02902355004410562,652,The last of the Mohegans
9326,9835,2,13,133,148,1.114864864864865,0.029588786567789585,652,"Of all the delusions of grandeur that you had to suffer, it had to be the one that reminds us as children of our failed dreams, and us as adults of our failed waistlines."
4227,9836,3,12,142,157,1.1146496815286624,0.029927443516071437,652,While visions of sugar plums danced in their sweet little heads
7098,9836,1,16,140,157,1.1146496815286624,0.027061656282486333,652,This mirage must be PC - or we would see Judy Garland chased by Munchkins.
1543,9838,1,17,148,166,1.1144578313253013,0.026216514451159318,652,Roll double 6's.
6360,9838,0,19,147,166,1.1144578313253013,0.0247847993705832,652,"That mirage seems more and more delicious every time I look at it.""  Markell Raphaelson West; Laurel, Marylan"
4131,9840,0,16,124,140,1.1142857142857143,0.02698580626068047,652,"Let's end our diet now and go to the candy island""."
8871,9840,0,16,124,140,1.1142857142857143,0.02698580626068047,652,I never did have much of a sweet tooth.
5058,9842,2,13,134,149,1.1140939597315436,0.02939964212737388,652,i feel like this channel is on so many levels of irony that if I asked what it is i would never get a straight answer
3302,9842,0,17,132,149,1.1140939597315436,0.02613330277793542,652,"So, that's how you watch your weight on the Bon Appétit key..."
2075,9844,2,14,142,158,1.1139240506329113,0.028358691701303472,652,Captain Nemo celebrating big 150.
5348,9845,1,13,118,132,1.1136363636363635,0.029741206365695588,652,I prefer the chocolate cake if it’s okay with you.
6341,9845,1,13,118,132,1.1136363636363635,0.029741206365695588,652,"What's this dad?
What's what?"
979,9847,4,8,129,141,1.1134751773049645,0.03352356847833792,652,Good thing we are on a low-carb diet.
5779,9847,0,16,125,141,1.1134751773049645,0.026805990993562213,652,If we could only make it to the other side.
9008,9849,2,13,135,150,1.1133333333333333,0.029212890824184816,652,None of that is keto.
5214,9850,0,14,110,124,1.1129032258064515,0.02853554158249128,652,"Well, I've got some Keto pancakes we can eat."
1311,9850,2,10,112,124,1.1129032258064515,0.032810635783676746,652,GoFundMe was definitely the way to go.
8816,9852,3,9,121,133,1.112781954887218,0.03316338884677568,652,"What is that, a rescue candy?"
1618,9852,2,11,120,133,1.112781954887218,0.0313988724837326,652,"Yes, but I am on the keto diet"
1476,9854,1,14,127,142,1.1126760563380282,0.028442385425839274,652,"Quick, hide under the palm tree. You know I'm on a diet and if they see us, I might not be able to resist."
3075,9854,0,16,126,142,1.1126760563380282,0.02662854047530484,652,It must be Candy Land Abridged.
8331,9854,2,12,128,142,1.1126760563380282,0.030147295228246274,652,"SSS

So near, and yet, so far!"
5475,9857,0,17,134,151,1.1125827814569536,0.025807996018852947,652,Did you lost your eminem's there last winter .
1779,9858,0,18,142,160,1.1125,0.02505889289668534,652,"Man, I keep hearing that kids’ song “The Big Rock Candy Mountain”."
9674,9859,1,13,120,134,1.1119402985074627,0.029319992564782172,652,Did I ever tell you Candyland is my favorite bored game?
1783,9860,2,12,129,143,1.1118881118881119,0.0299461006747373,652,"I'm a salt man, so seeing that much sugar means nothing to me."
8187,9860,3,10,130,143,1.1118881118881119,0.03154777332651287,652,"I went gluten free, how about you?"
8405,9862,1,15,136,152,1.111842105263158,0.02729424453440698,652,The other man's grass is always sweeter...
348,9862,1,15,136,152,1.111842105263158,0.02729424453440698,652,That's where the Lollypop drops off its old stock. I'm not going to risk a tummy ache.
1525,9864,0,15,120,135,1.1111111111111112,0.027148765412512283,652,Next thing you know the whole neighborhood will be commercial and no residential to develop!
2932,9864,2,12,130,144,1.1111111111111112,0.029747563792422035,652,Candy land appears each time you smile....
3508,9864,1,14,129,144,1.1111111111111112,0.02806764069990781,652,"You can go on ahead, but ‘The Island of Soggy Desserts’ just doesn’t sound too appealing to me."
4395,9864,2,13,138,153,1.1111111111111112,0.028666552000687996,652,Are you sure you're not a dentist?
6318,9864,0,17,136,153,1.1111111111111112,0.02549063709672909,652,"Tempting, but I'm on a strict keto diet. It is said to sharpen your mind, especially memory."
6429,9864,1,13,121,135,1.1111111111111112,0.02911380742769943,652,"Actually, the clams, mussels, and seaweed that we eat is much healthier for you than that sugary stuff."
9274,9864,3,12,147,162,1.1111111111111112,0.02904296123188518,652,If only they hadn't made a honey ocean
8743,9871,1,15,138,154,1.1103896103896105,0.026958059570044143,652,"Next time you are MVP at the Super Bowl, shout ""I am going to Disneyland, not anywhere from maddening crowd."""
864,9872,1,14,130,145,1.110344827586207,0.027883929817720005,652,"At least we'll be healthy here when we die.

Geoff. Rytell
Toronto"
495,9872,0,16,129,145,1.110344827586207,0.026109923428966772,652,They call it D-isle-abetes.
381,9874,2,11,123,136,1.1102941176470589,0.030736766494842995,652,"Why result to cannibalism when candy island is just over there?""

""I am on a low carb diet"""
1073,9874,1,13,122,136,1.1102941176470589,0.028910488627570178,652,"Well, it’s not really a mountain though, is it?"
3630,9876,1,12,114,127,1.110236220472441,0.030057118595922142,652,I don't see any Lollipops. Must be the Good Ship Calories.
4289,9877,1,15,139,155,1.1096774193548387,0.0267930390316523,652,"spent all those years prepping for civilizational collapse and not a single one of the cryptoracist bloggers i read accounted for the shit that matters most. maintaining keto next to a magic candy island, and returning the love of a good man."
6725,9877,1,15,139,155,1.1096774193548387,0.0267930390316523,652,"I would rather be rescued, son, than entertained."""
7197,9877,3,11,141,155,1.1096774193548387,0.029756365733644152,652,"Oh Candy Sea, what you’re doing to me!"
8099,9877,2,13,140,155,1.1096774193548387,0.02831349715441414,652,Again and again we end up in this stereotypical situation. And they expect us to say funny things!
5942,9881,1,14,131,146,1.1095890410958904,0.027702597077874012,652,It’s just inside the nine dashed line.
7823,9882,1,13,123,137,1.1094890510948905,0.028709977120488003,652,Too bad I've given up sweets.  I need a South Beach Island!
7398,9883,1,12,115,128,1.109375,0.029833805981314365,652,"You are allergic to sugar, no?"
1500,9884,0,17,139,156,1.108974358974359,0.02502887984302707,652,"Sam: ""I wish I new how to swim"".
Tom: ""nah, that stuffs bad for your teeth""."
9611,9884,0,17,139,156,1.108974358974359,0.02502887984302707,652,"I just love the sulfur dioxide breezes"""
3257,9886,0,14,115,129,1.1085271317829457,0.027492753796726957,652,That stuff  simply isn't on my diet.
4084,9886,0,14,115,129,1.1085271317829457,0.027492753796726957,652,"Oh, I get it, you're say desserted with two s's."
4340,9886,2,10,117,129,1.1085271317829457,0.03159271392810292,652,There were two documentaries about that island and I didn't know which one to watch.
9876,9886,1,12,116,129,1.1085271317829457,0.029613772848713426,652,"No, I think we'd have to be in a different toon to actually see the curvature of the earth effect."
7803,9890,0,18,148,166,1.108433734939759,0.0242056667628675,652,"Actually, I stopped going after that problem with the Triglyce Ride."
9484,9891,0,13,107,120,1.1083333333333334,0.028491075150158016,652,This is perfect for our diet!
2159,9892,1,14,133,148,1.1081081081081081,0.027346884634331752,652,"Oh, right! Just when I'm over the word diet"
5217,9892,2,12,134,148,1.1081081081081081,0.028978971040405917,652,"No, I’m sorry.
There is no rock candy."
2248,9894,0,15,124,139,1.1079136690647482,0.026412051088626265,652,"Sugar's my weakness. Gonna have to pass."""
2498,9894,1,13,125,139,1.1079136690647482,0.028317147760032545,652,"Honey, I said you should limit your sweets, not move away from them forever."
8509,9894,0,15,124,139,1.1079136690647482,0.026412051088626265,652,Imitation of Island Life: Plus-size island besting supermodel island. You go big island. Eat your heart out.
5096,9897,2,13,143,158,1.1075949367088607,0.027799867341442127,652,The long divide between the Republican and Democratic islands is only an age away.
4368,9898,0,16,133,149,1.1073825503355705,0.02544888069261104,652,Can't. I'm on keto.
7494,9899,1,13,126,140,1.1071428571428572,0.02812471961066779,652,My winter day-pass expired last week.
6059,9899,1,13,126,140,1.1071428571428572,0.02812471961066779,652,Let’s not fall for the allure of sugar
2907,9901,3,10,137,150,1.1066666666666667,0.03013269188206816,652,Whatever you say. My WW will kick your whey allergy’s butt!
3025,9901,3,10,137,150,1.1066666666666667,0.03013269188206816,652,"I'm sorry, but this just doesn't inspire me."
7105,9901,1,14,135,150,1.1066666666666667,0.027000151903900572,652,We've turned the planet into a colossal sewer and sooner or later we'll all suffer the consequences of what we've done.
298,9904,1,13,127,141,1.1063829787234043,0.027934878061619952,652,Of all the times to start Whole30...
1698,9904,1,13,127,141,1.1063829787234043,0.027934878061619952,652,?
7670,9904,1,13,127,141,1.1063829787234043,0.027934878061619952,652,"I wouldn't try it Jim, the calories isn't worth the swim"
9178,9904,2,11,128,141,1.1063829787234043,0.02969300481445578,652,"Is that a palm tree or did Gabe get skinnier, either way let's pee on it."
615,9908,3,11,146,160,1.10625,0.028863257910927243,652,Diets are for the birds!
8932,9909,2,11,129,142,1.1056338028169015,0.029492674484594368,652,And then there is the big rock candy mountain on th
9657,9909,1,13,128,142,1.1056338028169015,0.02774757155837601,652,You go ahead. I’m sticking with my Keto diet.
1276,9909,1,13,128,142,1.1056338028169015,0.02774757155837601,652,I didnt want to be dropped over there .thats. The island for my 600 pound life. Hopefuls
8573,9912,0,17,144,161,1.1055900621118013,0.024295164242991246,652,Too bad I'm gluten free
9258,9912,1,15,145,161,1.1055900621118013,0.0258436599023187,652,Do you see that island of sweets?
9676,9912,0,17,144,161,1.1055900621118013,0.024295164242991246,652,"Janice, do you think this is another Billy McFarland stunt?"
3115,9915,1,12,120,133,1.105263157894737,0.028765038157895835,652,"Below the surface, it’s just a pile of sea grass; all show."
409,9916,2,11,130,143,1.1048951048951048,0.02929502070801353,652,All fattening.
8415,9916,1,13,129,143,1.1048951048951048,0.027562749899881295,652,"Diabetics for Climate Change PSA:
2032: Candy Island
2018: Peak of Candy Mountain"
5560,9918,1,14,138,153,1.1045751633986929,0.026496163329967792,652,And they were roommates...
8847,9918,2,12,139,153,1.1045751633986929,0.028072156725371743,652,"She may look sweet, but she's the Nazis' worst nightmare."
1217,9918,0,16,137,153,1.1045751633986929,0.024820301351974477,652,Just keep staring at the palms and thinking candy.
2510,9921,2,10,122,134,1.1044776119402986,0.030461708591563774,652,Let's Swim to Sugar Plum Island!
9426,9922,1,10,104,115,1.1043478260869566,0.031182915591504892,652,The extra-terrestrials still think of us as primitives requiring a sugar hit.
102,9923,3,11,149,163,1.1042944785276074,0.028352603058057826,652,It's only one stop on the L Train
773,9923,2,13,148,163,1.1042944785276074,0.02698387922684319,652,There is candy on that island.
3203,9925,2,10,123,135,1.1037037037037036,0.03024512729614818,652,"It’s not symmetrical. 
Sheila Pennebaker, Alpharetta, Ga"
6330,9925,2,10,123,135,1.1037037037037036,0.03024512729614818,652,"Ha, Look at that lot, bunch of dessert island dicks"
7673,9927,1,13,131,145,1.103448275862069,0.0272003668188488,652,Vanilla again.
8825,9928,0,16,139,155,1.103225806451613,0.024517451952047437,652,And THAT my friend is the real keto-land offering sugarfree-flourfree-glutenfree-carbfree desserts and breads everywhere... all the time!
5160,9929,0,13,113,126,1.1031746031746033,0.027207293791829613,652,"Fake Chews.""  Leslie Chain, Tigress@KatrinasKritters.or"
1974,9929,1,11,114,126,1.1031746031746033,0.029448615628906178,652,"No drinkable water, no food... how are we still alive?"
3837,9931,0,15,131,146,1.1027397260273972,0.025214155127245026,652,He was a former Disney animator.
8329,9931,2,11,133,146,1.1027397260273972,0.028717594630468236,652,"Sorry.  I just don't believe in Candy Crush.  Or Kandy Krush, either."
889,9933,2,11,134,147,1.1020408163265305,0.02853012976982037,652,Told you keto island would become a drag.
5554,9933,1,13,133,147,1.1020408163265305,0.026847352654726264,652,I guess this makes us bosom buddies!
3170,9935,0,16,141,157,1.1019108280254777,0.024221865936909896,652,"I’ve heard of a Candy Mountain, guess there’s a Candy Island,too!"
6857,9936,1,10,107,118,1.1016949152542372,0.030424659927313576,652,"If we spell out the name 'Cockaygne' in pieces of candy, do you think Rand McNally will put the name on their new maps?"
1965,9937,1,11,116,128,1.1015625,0.029008898796741775,652,"Well, they say the sugar is always sweeter."
4507,9937,2,9,117,128,1.1015625,0.031057168342632245,652,Looks simpler than a wall.
1071,9937,2,9,117,128,1.1015625,0.031057168342632245,652,We could swim to the dessert island but it would mess with our diet
1865,9940,0,14,124,138,1.1014492753623188,0.025794997519150625,652,"Ya just couldn’t ask directions, right? Annnnddd. I always win at Candyland—too petty to let me win this time, hmmm?"
4745,9940,2,10,126,138,1.1014492753623188,0.029613425040122904,652,"Sure, that works for dessert, but what should we have for an appetizer and dessert?"
7720,9940,1,12,125,138,1.1014492753623188,0.027769919333876045,652,"Those Yanks keep falling for Trump’s lies
It’s all such a mirage!!!"
6714,9943,2,14,162,178,1.101123595505618,0.025308215772613926,652,My girlfriend just went sugar-free. What's your story?
2721,9944,1,11,117,129,1.1007751937984496,0.028793910771518667,652,i'm going with Democrats
3023,9945,0,14,125,139,1.1007194244604317,0.025619147899709333,652,"hey man, remember that cartoon marvelous misadventures of flapjack?"""
274,9946,2,11,136,149,1.1006711409395973,0.028162427037778062,652,And you wonder why I suffer from islans  envy.
8031,9946,1,13,135,149,1.1006711409395973,0.026503350261636135,652,Oasis on the waves?
4558,9948,0,17,152,169,1.1005917159763314,0.02320624693365227,652,Are you sure it’s a Flying Saucer... yes after the sugar rush I suddenly was having an anal probe.
1630,9949,1,13,136,150,1.1,0.02633462177914388,652,"Tempting yes, but I'm on this no-carbs diet now."
1473,9949,0,15,135,150,1.1,0.024576957615571212,652,Hey man!  It's just plastic.
5997,9951,2,13,156,171,1.0994152046783625,0.025773177418601297,652,You known that i'm on a sugar free diet
1762,9952,2,11,138,151,1.099337748344371,0.027804055618249526,652,Gimme Gimme Gimme dat ding
2825,9952,1,13,137,151,1.099337748344371,0.026168020331545166,652,I think I'm starting to hallucinate. There's no way that Maroon 5's performance could have been deemed less than professional.
8963,9952,1,13,137,151,1.099337748344371,0.026168020331545166,652,At the time the choice would seem obvious to anyone who saw themselves as overweight.
9301,9955,1,12,128,141,1.099290780141844,0.027205109588850147,652,We're in luck! The Isle of Misfit Sugar Plums!
9108,9956,1,14,147,162,1.0987654320987654,0.025090705083242598,652,As a loyal Liberal I can’t believe what I see
7489,9957,1,12,129,142,1.0985915492957747,0.027021893244312114,652,Did you say there's a fast track to the seven-step program?
9501,9957,2,10,130,142,1.0985915492957747,0.02881098463041565,652,"There’s a lot of candy on that island. Maybe we should call it Candy Isle. Our island has no candy, so far as I can tell, Glen."
3695,9957,1,12,129,142,1.0985915492957747,0.027021893244312114,652,"No, it’s not fishy."
6369,9960,1,12,130,143,1.097902097902098,0.026841119799177582,652,"It sure looks tempting, but I’ll have to pass since my doctor told me that I have to cut out all sweets."
8631,9960,1,12,130,143,1.097902097902098,0.026841119799177582,652,"What with my low carb diet, it's an approach avoidance issue."
8157,9962,2,11,142,155,1.096774193548387,0.027113925188344715,652,Looks like AOC has been around here.
4015,9963,3,8,134,145,1.096551724137931,0.02988505747126437,652,We missed deadline for last week as mail delivery was slow-we had a blizzard
8287,9964,1,13,142,156,1.0961538461538463,0.025365559180572123,652,"By Emma, I will always love you, but I choose a Platonic love there."
3981,9965,1,12,133,146,1.095890410958904,0.026312979645168558,652,Would you rather die of inanition or diabetes?
898,9966,2,9,125,136,1.0955882352941178,0.02929579533392265,652,We got a palm tree and they got Paul Hollywood?
643,9967,0,15,142,157,1.0955414012738853,0.02353573958740901,652,The fun looks tempting on the other side.
6038,9968,2,10,135,147,1.0952380952380953,0.027866939808602508,652,"Yeah, it’s the new season; ‘Survivor: Cake Wars island’"
2185,9968,0,14,133,147,1.0952380952380953,0.0242938348982858,652,"No, we won't have to buy tickets. We'll just say we're parents after the kids show up."
1070,9968,1,12,134,147,1.0952380952380953,0.02614150673126402,652,"We almost died on 'deert' island, so I say keep going."
5568,9971,3,9,146,158,1.0949367088607596,0.02809202503916298,652,I 'd like to be there dentist.
1284,9972,2,10,136,148,1.0945945945945945,0.02768548875714151,652,Are you in for a swim? I’m hungry.
794,9973,2,8,118,128,1.09375,0.030249739700838815,652,Lucky me that I’m on a sugar-free diet!
8268,9973,2,11,147,160,1.09375,0.026297874881260657,652,I hear Harry McClintock is buried there.
3269,9975,0,12,117,129,1.0930232558139534,0.02567372344862746,652,Everyone is doing so well.
3882,9975,3,6,120,129,1.0930232558139534,0.03197674418604651,652,"Who can take a sunrise?
Sprinkle it with dew
Cover it with chocolate and a miracle or two
The Candy Man
The Candy Man can!"
9912,9977,0,13,127,140,1.0928571428571427,0.024617168641515773,652,all that glitters is not gold
3250,9977,1,11,128,140,1.0928571428571427,0.026622920854850532,652,Don't look. Thin of your glycemic index.
1021,9979,2,10,139,151,1.0927152317880795,0.0271550098272526,652,I’ d say thst’s Better
5142,9979,0,14,137,151,1.0927152317880795,0.023681091976872213,652,What did you say was the name of that Dharma Station? The Sweet Tooth?
2287,9981,0,15,148,163,1.0920245398773005,0.022710744715688718,652,Let's not try and swim. It's too risky.
1370,9982,1,11,130,142,1.091549295774648,0.02626279212253335,652,"Did you ever hear of that series of paintings called ""The Voyage of Life"" by Thomas Cole?"
9006,9982,1,11,130,142,1.091549295774648,0.02626279212253335,652,Off-brand? I vote cannibalism.
3366,9984,0,14,139,153,1.091503267973856,0.023386121042072775,652,Kids in Africa v.s kids in the U.s
4439,9985,1,11,131,143,1.0909090909090908,0.026086346610308456,652,Damn you Pelosi!
1667,9985,1,12,141,154,1.0909090909090908,0.025000868100769392,652,Why did you land us on this “Keto” island for ?
6897,9985,1,11,131,143,1.0909090909090908,0.026086346610308456,652,The meal was so dry they even served desert as dessert
7759,9988,0,13,133,146,1.0890410958904109,0.02365160621986643,652,Did you see the Sugar Bowl do the Tootsie Roll....
5425,9989,0,11,113,124,1.0887096774193548,0.025636652900944128,652,I guess it’s good I ‘m sucrose intolerant!
981,9990,3,6,127,136,1.088235294117647,0.030376339970254247,652,I hosey  the strawberry
7173,9991,0,12,125,137,1.0875912408759123,0.024241283363323787,652,"Double “s” sweetie, we’ll get there next time."
3435,9992,0,12,126,138,1.0869565217391304,0.024073349753745327,652,"It's the Democrats, once they get your vote they'll crap you out."
5683,9993,0,13,137,150,1.0866666666666667,0.023048760038210964,652,"If it weren't for the shark infested waters, I'd swim right over there to Candy Cane Island."
7884,9994,1,9,117,127,1.0866141732283465,0.027438269780990916,652,Your turn. Is the icing is always sweeter on the other isle? Or is Leviathan’s Legendary Lure real?
912,9995,2,8,129,139,1.0863309352517985,0.027930410843921536,652,So this is where King Kandy's been hiding.
1768,9996,2,9,141,152,1.0855263157894737,0.026310342761533632,652,"Out a sight, isn t it?"
9037,9997,0,14,151,165,1.084848484848485,0.021759385340835883,652,I've decided to cut back on sugar
1310,9998,0,12,130,142,1.0845070422535212,0.023424180096928756,652,Rub-A-Dub-Dub he took the tub.
2679,9999,1,11,143,155,1.0838709677419356,0.024139725075960912,652,I really don't feel like dessert now anyway
8686,9999,1,11,143,155,1.0838709677419356,0.024139725075960912,652,"Yeah, but to get over there we have to swim across this sea of cum."
6495,10001,1,10,133,144,1.0833333333333333,0.025125945381480302,652,"If they really wanted to tempt us, they’d say they could explain how there can be a second season of “Russian Doll”."
7393,10002,0,12,134,146,1.082191780821918,0.022808995803567718,652,"Weird flex, but okay."
9323,10003,1,12,160,173,1.0809248554913296,0.022352451207430346,652,"I said, bitch, I'm Dirt McGirt, fresh out and back on the scene,
and don't you ever in your life turn ya back on the king"
933,10004,3,5,128,136,1.0808823529411764,0.02962206947314527,652,Well now we know Valhalla when we see it.
2073,10004,0,11,125,136,1.0808823529411764,0.023466350680302422,652,"Aah, an “Optimist”...thought you said he was an “Optometrist”?"
6479,10006,2,8,139,149,1.080536912751678,0.02611000067541677,652,I’m guess a whole lot of gluten
2233,10006,1,10,138,149,1.080536912751678,0.02431126104715795,652,We have probably come close to the island of the marine hockey Playground. The game will start soon with Mr.Trump and  other side wonderfull Journalists
7669,10008,1,10,141,152,1.0789473684210527,0.023847275682254896,652,"It is doubly ironic: My favorite rock band is, 'They Might Be Giants...'"
834,10009,0,10,117,127,1.078740157480315,0.023994070874804894,652,"I wished to have a boat, not Habro."
8376,10010,2,7,133,142,1.0774647887323943,0.026582270170191283,652,island gaga
9597,10011,0,12,145,157,1.0764331210191083,0.021272212980002373,652,If that is fantasy island where the he'll is da  plane daughter plane
7506,10012,1,8,126,135,1.0740740740740742,0.024947993733675337,652,"They always said to add a second ""s"", but they also beware the mirages"
7551,10013,0,11,138,149,1.0738255033557047,0.021494074986537614,652,Sugar sure is addictive
2103,10014,0,10,127,137,1.072992700729927,0.02230549364705501,652,"i'm so hungry  let's go to that candyland'
Kevin Sanchez-Romero,Annadale,V"
9102,10015,0,10,130,140,1.0714285714285714,0.021844204837443242,652,Okay I guess Keto isn't the worst diet out there.
86,10015,1,8,131,140,1.0714285714285714,0.024082030809277413,652,I have diabetes!
6536,10017,1,7,122,130,1.0692307692307692,0.024875267940140926,652,This don't need no @#$&!! caption.
6457,10018,1,7,127,135,1.0666666666666667,0.02397714039393409,652,That what left of dinosaurs dinner
3810,10019,0,10,142,152,1.0657894736842106,0.02017493344016283,652,I dreamed it’s just a sugar and gluten free tease.
2610,10020,0,9,132,141,1.0638297872340425,0.020659751328834557,652,"Just remember, if you end up needing a dentist, we don't have any ice skates."
4887,10021,1,7,137,145,1.0620689655172413,0.022362156848670926,652,Dont tell me the sharks made Frank a star.  Reality tv sucks.
7526,10022,1,7,146,154,1.0584415584415585,0.021083890277925243,652,"I want an appetizer, a main dish, and a dessert, in this order."
7486,10023,0,8,129,137,1.0583941605839415,0.020107118031718507,652,"I'm afraid what God's keep doing is not so Christian! It's been years we're giving him our weakness, and he's still showing off his weekends!"
6916,10024,1,6,133,140,1.0571428571428572,0.022144597617504112,652,"I swam all the way to candy land, the gingerbread pawns  
guarding the island, kept pushing back into the sea, like I was a bum drop!"
9896,10025,1,5,123,129,1.054263565891473,0.022848500237503094,652,"""That's island  there, is  just an illusion
to us. It's  not  real."""
